Date,Season,home,visitor,FT,hgoal,vgoal,division,tier,totgoal,goaldif,result
1953-08-19,1953,Birmingham City,Hull City,2-0,2,0,2,2,2,2,H
1953-08-19,1953,Leeds United,Notts County,6-0,6,0,2,2,6,6,H
1953-08-19,1953,Leicester City,Derby County,2-2,2,2,2,2,4,0,D
1953-08-19,1953,Luton Town,Oldham Athletic,4-4,4,4,2,2,8,0,D
1953-08-19,1953,Nottingham Forest,Everton,3-3,3,3,2,2,6,0,D
1953-08-19,1953,Plymouth Argyle,Bury,1-1,1,1,2,2,2,0,D
1953-08-19,1953,Stoke City,Brentford,1-1,1,1,2,2,2,0,D
1953-08-19,1953,Swansea City,Doncaster Rovers,0-1,0,1,2,2,1,-1,A
1953-08-19,1953,West Ham United,Lincoln City,5-0,5,0,2,2,5,5,H
1953-08-20,1953,Fulham,Bristol Rovers,4-4,4,4,2,2,8,0,D
1953-08-20,1953,Rotherham United,Blackburn Rovers,1-4,1,4,2,2,5,-3,A
1953-08-22,1953,Birmingham City,Swansea City,6-0,6,0,2,2,6,6,H
1953-08-22,1953,Blackburn Rovers,Bristol Rovers,1-1,1,1,2,2,2,0,D
1953-08-22,1953,Bury,Notts County,3-3,3,3,2,2,6,0,D
1953-08-22,1953,Derby County,Brentford,4-1,4,1,2,2,5,3,H
1953-08-22,1953,Doncaster Rovers,Lincoln City,1-1,1,1,2,2,2,0,D
1953-08-22,1953,Fulham,Stoke City,0-1,0,1,2,2,1,-1,A
1953-08-22,1953,Leeds United,Rotherham United,4-2,4,2,2,2,6,2,H
1953-08-22,1953,Luton Town,Everton,1-1,1,1,2,2,2,0,D
1953-08-22,1953,Nottingham Forest,Plymouth Argyle,3-0,3,0,2,2,3,3,H
1953-08-22,1953,Oldham Athletic,Hull City,0-0,0,0,2,2,0,0,D
1953-08-22,1953,West Ham United,Leicester City,4-1,4,1,2,2,5,3,H
1953-08-24,1953,Bristol Rovers,Doncaster Rovers,0-1,0,1,2,2,1,-1,A
1953-08-24,1953,Hull City,Everton,1-3,1,3,2,2,4,-2,A
1953-08-24,1953,Leicester City,Fulham,2-2,2,2,2,2,4,0,D
1953-08-24,1953,Plymouth Argyle,Birmingham City,2-2,2,2,2,2,4,0,D
1953-08-24,1953,Rotherham United,West Ham United,5-0,5,0,2,2,5,5,H
1953-08-24,1953,Stoke City,Derby County,2-2,2,2,2,2,4,0,D
1953-08-26,1953,Lincoln City,Bury,0-0,0,0,2,2,0,0,D
1953-08-26,1953,Luton Town,Nottingham Forest,0-1,0,1,2,2,1,-1,A
1953-08-27,1953,Brentford,Blackburn Rovers,1-4,1,4,2,2,5,-3,A
1953-08-27,1953,Notts County,Oldham Athletic,2-0,2,0,2,2,2,2,H
1953-08-27,1953,Swansea City,Leeds United,4-3,4,3,2,2,7,1,H
1953-08-29,1953,Brentford,Fulham,2-1,2,1,2,2,3,1,H
1953-08-29,1953,Bristol Rovers,Derby County,3-0,3,0,2,2,3,3,H
1953-08-29,1953,Everton,Oldham Athletic,3-1,3,1,2,2,4,2,H
1953-08-29,1953,Hull City,Bury,3-0,3,0,2,2,3,3,H
1953-08-29,1953,Leicester City,Leeds United,5-0,5,0,2,2,5,5,H
1953-08-29,1953,Lincoln City,Blackburn Rovers,8-0,8,0,2,2,8,8,H
1953-08-29,1953,Notts County,Doncaster Rovers,1-5,1,5,2,2,6,-4,A
1953-08-29,1953,Plymouth Argyle,Luton Town,2-2,2,2,2,2,4,0,D
1953-08-29,1953,Rotherham United,Birmingham City,1-0,1,0,2,2,1,1,H
1953-08-29,1953,Stoke City,West Ham United,1-1,1,1,2,2,2,0,D
1953-08-29,1953,Swansea City,Nottingham Forest,2-1,2,1,2,2,3,1,H
1953-08-31,1953,Blackburn Rovers,Brentford,2-2,2,2,2,2,4,0,D
1953-08-31,1953,West Ham United,Rotherham United,3-0,3,0,2,2,3,3,H
1953-09-01,1953,Oldham Athletic,Notts County,1-3,1,3,2,2,4,-2,A
1953-09-02,1953,Birmingham City,Plymouth Argyle,3-0,3,0,2,2,3,3,H
1953-09-02,1953,Bury,Lincoln City,1-1,1,1,2,2,2,0,D
1953-09-02,1953,Derby County,Stoke City,1-1,1,1,2,2,2,0,D
1953-09-02,1953,Doncaster Rovers,Bristol Rovers,1-0,1,0,2,2,1,1,H
1953-09-02,1953,Everton,Hull City,2-0,2,0,2,2,2,2,H
1953-09-02,1953,Fulham,Leicester City,1-1,1,1,2,2,2,0,D
1953-09-02,1953,Leeds United,Swansea City,3-2,3,2,2,2,5,1,H
1953-09-02,1953,Nottingham Forest,Luton Town,2-1,2,1,2,2,3,1,H
1953-09-05,1953,Birmingham City,Leicester City,1-2,1,2,2,2,3,-1,A
1953-09-05,1953,Blackburn Rovers,Notts County,2-0,2,0,2,2,2,2,H
1953-09-05,1953,Brentford,Bristol Rovers,0-3,0,3,2,2,3,-3,A
1953-09-05,1953,Bury,Everton,2-2,2,2,2,2,4,0,D
1953-09-05,1953,Derby County,Lincoln City,2-0,2,0,2,2,2,2,H
1953-09-05,1953,Doncaster Rovers,Hull City,4-1,4,1,2,2,5,3,H
1953-09-05,1953,Leeds United,Stoke City,1-1,1,1,2,2,2,0,D
1953-09-05,1953,Luton Town,Swansea City,2-0,2,0,2,2,2,2,H
1953-09-05,1953,Nottingham Forest,Rotherham United,4-1,4,1,2,2,5,3,H
1953-09-05,1953,Oldham Athletic,Plymouth Argyle,1-1,1,1,2,2,2,0,D
1953-09-05,1953,West Ham United,Fulham,3-1,3,1,2,2,4,2,H
1953-09-07,1953,Bristol Rovers,Bury,2-0,2,0,2,2,2,2,H
1953-09-07,1953,Hull City,Nottingham Forest,3-0,3,0,2,2,3,3,H
1953-09-07,1953,Leicester City,Stoke City,4-0,4,0,2,2,4,4,H
1953-09-07,1953,Plymouth Argyle,Leeds United,1-1,1,1,2,2,2,0,D
1953-09-07,1953,Rotherham United,Fulham,3-2,3,2,2,2,5,1,H
1953-09-09,1953,Birmingham City,Luton Town,5-1,5,1,2,2,6,4,H
1953-09-09,1953,Derby County,Blackburn Rovers,2-2,2,2,2,2,4,0,D
1953-09-09,1953,Lincoln City,Oldham Athletic,3-1,3,1,2,2,4,2,H
1953-09-10,1953,Brentford,Doncaster Rovers,1-4,1,4,2,2,5,-3,A
1953-09-10,1953,Notts County,Everton,0-2,0,2,2,2,2,-2,A
1953-09-10,1953,Swansea City,West Ham United,1-1,1,1,2,2,2,0,D
1953-09-12,1953,Bristol Rovers,West Ham United,2-2,2,2,2,2,4,0,D
1953-09-12,1953,Everton,Doncaster Rovers,4-1,4,1,2,2,5,3,H
1953-09-12,1953,Fulham,Leeds United,1-3,1,3,2,2,4,-2,A
1953-09-12,1953,Hull City,Blackburn Rovers,0-2,0,2,2,2,2,-2,A
1953-09-12,1953,Leicester City,Nottingham Forest,1-0,1,0,2,2,1,1,H
1953-09-12,1953,Lincoln City,Brentford,2-1,2,1,2,2,3,1,H
1953-09-12,1953,Notts County,Derby County,0-1,0,1,2,2,1,-1,A
1953-09-12,1953,Oldham Athletic,Bury,0-0,0,0,2,2,0,0,D
1953-09-12,1953,Rotherham United,Luton Town,2-1,2,1,2,2,3,1,H
1953-09-12,1953,Stoke City,Birmingham City,3-2,3,2,2,2,5,1,H
1953-09-12,1953,Swansea City,Plymouth Argyle,0-1,0,1,2,2,1,-1,A
1953-09-14,1953,Oldham Athletic,Lincoln City,1-0,1,0,2,2,1,1,H
1953-09-14,1953,Stoke City,Leicester City,2-2,2,2,2,2,4,0,D
1953-09-14,1953,West Ham United,Swansea City,4-1,4,1,2,2,5,3,H
1953-09-16,1953,Bury,Bristol Rovers,3-1,3,1,2,2,4,2,H
1953-09-16,1953,Doncaster Rovers,Brentford,3-0,3,0,2,2,3,3,H
1953-09-16,1953,Fulham,Rotherham United,2-4,2,4,2,2,6,-2,A
1953-09-16,1953,Leeds United,Plymouth Argyle,1-1,1,1,2,2,2,0,D
1953-09-16,1953,Luton Town,Birmingham City,2-0,2,0,2,2,2,2,H
1953-09-16,1953,Nottingham Forest,Hull City,2-0,2,0,2,2,2,2,H
1953-09-19,1953,Birmingham City,Fulham,2-2,2,2,2,2,4,0,D
1953-09-19,1953,Blackburn Rovers,Everton,0-0,0,0,2,2,0,0,D
1953-09-19,1953,Brentford,Notts County,0-0,0,0,2,2,0,0,D
1953-09-19,1953,Bristol Rovers,Lincoln City,0-1,0,1,2,2,1,-1,A
1953-09-19,1953,Bury,Swansea City,1-2,1,2,2,2,3,-1,A
1953-09-19,1953,Derby County,Hull City,2-0,2,0,2,2,2,2,H
1953-09-19,1953,Doncaster Rovers,Oldham Athletic,1-0,1,0,2,2,1,1,H
1953-09-19,1953,Leeds United,West Ham United,1-2,1,2,2,2,3,-1,A
1953-09-19,1953,Luton Town,Leicester City,2-2,2,2,2,2,4,0,D
1953-09-19,1953,Nottingham Forest,Stoke City,5-4,5,4,2,2,9,1,H
1953-09-19,1953,Plymouth Argyle,Rotherham United,0-2,0,2,2,2,2,-2,A
1953-09-21,1953,Rotherham United,Stoke City,2-2,2,2,2,2,4,0,D
1953-09-23,1953,Everton,Notts County,3-2,3,2,2,2,5,1,H
1953-09-26,1953,Bury,Doncaster Rovers,2-1,2,1,2,2,3,1,H
1953-09-26,1953,Everton,Derby County,3-2,3,2,2,2,5,1,H
1953-09-26,1953,Fulham,Nottingham Forest,3-1,3,1,2,2,4,2,H
1953-09-26,1953,Hull City,Brentford,2-0,2,0,2,2,2,2,H
1953-09-26,1953,Leicester City,Plymouth Argyle,4-2,4,2,2,2,6,2,H
1953-09-26,1953,Lincoln City,Leeds United,2-0,2,0,2,2,2,2,H
1953-09-26,1953,Notts County,Bristol Rovers,1-5,1,5,2,2,6,-4,A
1953-09-26,1953,Oldham Athletic,Blackburn Rovers,1-0,1,0,2,2,1,1,H
1953-09-26,1953,Rotherham United,Swansea City,2-1,2,1,2,2,3,1,H
1953-09-26,1953,Stoke City,Luton Town,1-1,1,1,2,2,2,0,D
1953-09-26,1953,West Ham United,Birmingham City,1-2,1,2,2,2,3,-1,A
1953-10-03,1953,Birmingham City,Leeds United,3-3,3,3,2,2,6,0,D
1953-10-03,1953,Blackburn Rovers,Bury,4-2,4,2,2,2,6,2,H
1953-10-03,1953,Brentford,Everton,1-0,1,0,2,2,1,1,H
1953-10-03,1953,Bristol Rovers,Hull City,4-2,4,2,2,2,6,2,H
1953-10-03,1953,Derby County,Oldham Athletic,3-1,3,1,2,2,4,2,H
1953-10-03,1953,Doncaster Rovers,Rotherham United,1-2,1,2,2,2,3,-1,A
1953-10-03,1953,Lincoln City,Notts County,3-0,3,0,2,2,3,3,H
1953-10-03,1953,Luton Town,Fulham,1-2,1,2,2,2,3,-1,A
1953-10-03,1953,Nottingham Forest,West Ham United,4-0,4,0,2,2,4,4,H
1953-10-03,1953,Plymouth Argyle,Stoke City,1-1,1,1,2,2,2,0,D
1953-10-03,1953,Swansea City,Leicester City,0-0,0,0,2,2,0,0,D
1953-10-10,1953,Birmingham City,Lincoln City,1-0,1,0,2,2,1,1,H
1953-10-10,1953,Fulham,Derby County,5-2,5,2,2,2,7,3,H
1953-10-10,1953,Leeds United,Bristol Rovers,3-3,3,3,2,2,6,0,D
1953-10-10,1953,Leicester City,Doncaster Rovers,2-0,2,0,2,2,2,2,H
1953-10-10,1953,Luton Town,Hull City,3-1,3,1,2,2,4,2,H
1953-10-10,1953,Nottingham Forest,Notts County,5-0,5,0,2,2,5,5,H
1953-10-10,1953,Plymouth Argyle,Everton,4-0,4,0,2,2,4,4,H
1953-10-10,1953,Rotherham United,Bury,1-0,1,0,2,2,1,1,H
1953-10-10,1953,Stoke City,Blackburn Rovers,3-0,3,0,2,2,3,3,H
1953-10-10,1953,Swansea City,Oldham Athletic,4-0,4,0,2,2,4,4,H
1953-10-10,1953,West Ham United,Brentford,0-1,0,1,2,2,1,-1,A
1953-10-17,1953,Blackburn Rovers,Fulham,5-1,5,1,2,2,6,4,H
1953-10-17,1953,Brentford,Leeds United,2-1,2,1,2,2,3,1,H
1953-10-17,1953,Bristol Rovers,Birmingham City,1-1,1,1,2,2,2,0,D
1953-10-17,1953,Bury,Leicester City,2-5,2,5,2,2,7,-3,A
1953-10-17,1953,Derby County,West Ham United,2-1,2,1,2,2,3,1,H
1953-10-17,1953,Doncaster Rovers,Stoke City,1-0,1,0,2,2,1,1,H
1953-10-17,1953,Everton,Swansea City,2-2,2,2,2,2,4,0,D
1953-10-17,1953,Hull City,Plymouth Argyle,2-0,2,0,2,2,2,2,H
1953-10-17,1953,Lincoln City,Nottingham Forest,2-2,2,2,2,2,4,0,D
1953-10-17,1953,Notts County,Luton Town,1-2,1,2,2,2,3,-1,A
1953-10-17,1953,Oldham Athletic,Rotherham United,2-3,2,3,2,2,5,-1,A
1953-10-24,1953,Birmingham City,Brentford,5-1,5,1,2,2,6,4,H
1953-10-24,1953,Fulham,Doncaster Rovers,1-2,1,2,2,2,3,-1,A
1953-10-24,1953,Leeds United,Derby County,3-1,3,1,2,2,4,2,H
1953-10-24,1953,Leicester City,Oldham Athletic,1-0,1,0,2,2,1,1,H
1953-10-24,1953,Luton Town,Lincoln City,1-0,1,0,2,2,1,1,H
1953-10-24,1953,Nottingham Forest,Bristol Rovers,3-1,3,1,2,2,4,2,H
1953-10-24,1953,Plymouth Argyle,Notts County,3-3,3,3,2,2,6,0,D
1953-10-24,1953,Rotherham United,Everton,1-2,1,2,2,2,3,-1,A
1953-10-24,1953,Stoke City,Bury,4-0,4,0,2,2,4,4,H
1953-10-24,1953,Swansea City,Hull City,1-0,1,0,2,2,1,1,H
1953-10-24,1953,West Ham United,Blackburn Rovers,2-1,2,1,2,2,3,1,H
1953-10-31,1953,Blackburn Rovers,Leeds United,2-2,2,2,2,2,4,0,D
1953-10-31,1953,Brentford,Nottingham Forest,1-1,1,1,2,2,2,0,D
1953-10-31,1953,Bristol Rovers,Luton Town,3-3,3,3,2,2,6,0,D
1953-10-31,1953,Bury,Fulham,1-3,1,3,2,2,4,-2,A
1953-10-31,1953,Derby County,Birmingham City,2-4,2,4,2,2,6,-2,A
1953-10-31,1953,Doncaster Rovers,West Ham United,2-0,2,0,2,2,2,2,H
1953-10-31,1953,Everton,Leicester City,1-2,1,2,2,2,3,-1,A
1953-10-31,1953,Hull City,Rotherham United,1-0,1,0,2,2,1,1,H
1953-10-31,1953,Lincoln City,Plymouth Argyle,2-0,2,0,2,2,2,2,H
1953-10-31,1953,Notts County,Swansea City,3-0,3,0,2,2,3,3,H
1953-10-31,1953,Oldham Athletic,Stoke City,1-0,1,0,2,2,1,1,H
1953-11-07,1953,Birmingham City,Blackburn Rovers,0-0,0,0,2,2,0,0,D
1953-11-07,1953,Fulham,Oldham Athletic,3-1,3,1,2,2,4,2,H
1953-11-07,1953,Leeds United,Doncaster Rovers,3-1,3,1,2,2,4,2,H
1953-11-07,1953,Leicester City,Hull City,1-3,1,3,2,2,4,-2,A
1953-11-07,1953,Luton Town,Brentford,1-1,1,1,2,2,2,0,D
1953-11-07,1953,Nottingham Forest,Derby County,4-2,4,2,2,2,6,2,H
1953-11-07,1953,Plymouth Argyle,Bristol Rovers,3-3,3,3,2,2,6,0,D
1953-11-07,1953,Rotherham United,Notts County,0-1,0,1,2,2,1,-1,A
1953-11-07,1953,Stoke City,Everton,2-4,2,4,2,2,6,-2,A
1953-11-07,1953,Swansea City,Lincoln City,4-2,4,2,2,2,6,2,H
1953-11-07,1953,West Ham United,Bury,5-0,5,0,2,2,5,5,H
1953-11-14,1953,Blackburn Rovers,Nottingham Forest,2-0,2,0,2,2,2,2,H
1953-11-14,1953,Brentford,Plymouth Argyle,1-0,1,0,2,2,1,1,H
1953-11-14,1953,Bristol Rovers,Swansea City,0-1,0,1,2,2,1,-1,A
1953-11-14,1953,Bury,Leeds United,4-4,4,4,2,2,8,0,D
1953-11-14,1953,Derby County,Luton Town,1-2,1,2,2,2,3,-1,A
1953-11-14,1953,Doncaster Rovers,Birmingham City,3-1,3,1,2,2,4,2,H
1953-11-14,1953,Everton,Fulham,2-2,2,2,2,2,4,0,D
1953-11-14,1953,Hull City,Stoke City,1-2,1,2,2,2,3,-1,A
1953-11-14,1953,Lincoln City,Rotherham United,4-3,4,3,2,2,7,1,H
1953-11-14,1953,Notts County,Leicester City,1-1,1,1,2,2,2,0,D
1953-11-14,1953,Oldham Athletic,West Ham United,3-1,3,1,2,2,4,2,H
1953-11-21,1953,Birmingham City,Bury,0-0,0,0,2,2,0,0,D
1953-11-21,1953,Fulham,Hull City,5-1,5,1,2,2,6,4,H
1953-11-21,1953,Leeds United,Oldham Athletic,2-1,2,1,2,2,3,1,H
1953-11-21,1953,Leicester City,Lincoln City,9-2,9,2,2,2,11,7,H
1953-11-21,1953,Luton Town,Blackburn Rovers,2-1,2,1,2,2,3,1,H
1953-11-21,1953,Nottingham Forest,Doncaster Rovers,2-2,2,2,2,2,4,0,D
1953-11-21,1953,Plymouth Argyle,Derby County,3-2,3,2,2,2,5,1,H
1953-11-21,1953,Rotherham United,Bristol Rovers,1-1,1,1,2,2,2,0,D
1953-11-21,1953,Stoke City,Notts County,0-1,0,1,2,2,1,-1,A
1953-11-21,1953,Swansea City,Brentford,1-0,1,0,2,2,1,1,H
1953-11-21,1953,West Ham United,Everton,1-1,1,1,2,2,2,0,D
1953-11-28,1953,Blackburn Rovers,Plymouth Argyle,2-3,2,3,2,2,5,-1,A
1953-11-28,1953,Brentford,Rotherham United,0-1,0,1,2,2,1,-1,A
1953-11-28,1953,Bristol Rovers,Leicester City,3-0,3,0,2,2,3,3,H
1953-11-28,1953,Bury,Nottingham Forest,2-1,2,1,2,2,3,1,H
1953-11-28,1953,Derby County,Swansea City,4-2,4,2,2,2,6,2,H
1953-11-28,1953,Doncaster Rovers,Luton Town,1-3,1,3,2,2,4,-2,A
1953-11-28,1953,Everton,Leeds United,2-1,2,1,2,2,3,1,H
1953-11-28,1953,Hull City,West Ham United,2-1,2,1,2,2,3,1,H
1953-11-28,1953,Lincoln City,Stoke City,1-1,1,1,2,2,2,0,D
1953-11-28,1953,Notts County,Fulham,0-0,0,0,2,2,0,0,D
1953-11-28,1953,Oldham Athletic,Birmingham City,2-3,2,3,2,2,5,-1,A
1953-12-05,1953,Birmingham City,Everton,5-1,5,1,2,2,6,4,H
1953-12-05,1953,Fulham,Lincoln City,4-1,4,1,2,2,5,3,H
1953-12-05,1953,Leeds United,Hull City,0-0,0,0,2,2,0,0,D
1953-12-05,1953,Leicester City,Brentford,6-0,6,0,2,2,6,6,H
1953-12-05,1953,Luton Town,Bury,3-2,3,2,2,2,5,1,H
1953-12-05,1953,Nottingham Forest,Oldham Athletic,1-1,1,1,2,2,2,0,D
1953-12-05,1953,Plymouth Argyle,Doncaster Rovers,0-0,0,0,2,2,0,0,D
1953-12-05,1953,Rotherham United,Derby County,5-2,5,2,2,2,7,3,H
1953-12-05,1953,Stoke City,Bristol Rovers,3-2,3,2,2,2,5,1,H
1953-12-05,1953,Swansea City,Blackburn Rovers,2-1,2,1,2,2,3,1,H
1953-12-05,1953,West Ham United,Notts County,1-2,1,2,2,2,3,-1,A
1953-12-12,1953,Blackburn Rovers,Rotherham United,3-0,3,0,2,2,3,3,H
1953-12-12,1953,Brentford,Stoke City,0-0,0,0,2,2,0,0,D
1953-12-12,1953,Bristol Rovers,Fulham,2-1,2,1,2,2,3,1,H
1953-12-12,1953,Bury,Plymouth Argyle,3-0,3,0,2,2,3,3,H
1953-12-12,1953,Derby County,Leicester City,2-1,2,1,2,2,3,1,H
1953-12-12,1953,Doncaster Rovers,Swansea City,1-0,1,0,2,2,1,1,H
1953-12-12,1953,Everton,Nottingham Forest,3-3,3,3,2,2,6,0,D
1953-12-12,1953,Hull City,Birmingham City,3-0,3,0,2,2,3,3,H
1953-12-12,1953,Lincoln City,West Ham United,1-2,1,2,2,2,3,-1,A
1953-12-12,1953,Notts County,Leeds United,2-0,2,0,2,2,2,2,H
1953-12-12,1953,Oldham Athletic,Luton Town,1-2,1,2,2,2,3,-1,A
1953-12-19,1953,Brentford,Derby County,0-0,0,0,2,2,0,0,D
1953-12-19,1953,Bristol Rovers,Blackburn Rovers,1-2,1,2,2,2,3,-1,A
1953-12-19,1953,Everton,Luton Town,2-1,2,1,2,2,3,1,H
1953-12-19,1953,Hull City,Oldham Athletic,8-0,8,0,2,2,8,8,H
1953-12-19,1953,Leicester City,West Ham United,2-1,2,1,2,2,3,1,H
1953-12-19,1953,Lincoln City,Doncaster Rovers,0-2,0,2,2,2,2,-2,A
1953-12-19,1953,Notts County,Bury,0-0,0,0,2,2,0,0,D
1953-12-19,1953,Plymouth Argyle,Nottingham Forest,1-0,1,0,2,2,1,1,H
1953-12-19,1953,Rotherham United,Leeds United,2-4,2,4,2,2,6,-2,A
1953-12-19,1953,Stoke City,Fulham,1-3,1,3,2,2,4,-2,A
1953-12-19,1953,Swansea City,Birmingham City,1-3,1,3,2,2,4,-2,A
1953-12-25,1953,Birmingham City,Notts County,3-0,3,0,2,2,3,3,H
1953-12-25,1953,Blackburn Rovers,Doncaster Rovers,2-0,2,0,2,2,2,2,H
1953-12-25,1953,Brentford,Oldham Athletic,3-1,3,1,2,2,4,2,H
1953-12-25,1953,Bury,Derby County,4-0,4,0,2,2,4,4,H
1953-12-25,1953,Everton,Bristol Rovers,4-0,4,0,2,2,4,4,H
1953-12-25,1953,Fulham,Plymouth Argyle,3-1,3,1,2,2,4,2,H
1953-12-25,1953,Leicester City,Rotherham United,4-1,4,1,2,2,5,3,H
1953-12-25,1953,Nottingham Forest,Leeds United,5-2,5,2,2,2,7,3,H
1953-12-25,1953,West Ham United,Luton Town,1-0,1,0,2,2,1,1,H
1953-12-26,1953,Derby County,Bury,3-1,3,1,2,2,4,2,H
1953-12-26,1953,Doncaster Rovers,Blackburn Rovers,0-2,0,2,2,2,2,-2,A
1953-12-26,1953,Hull City,Lincoln City,3-0,3,0,2,2,3,3,H
1953-12-26,1953,Leeds United,Nottingham Forest,0-2,0,2,2,2,2,-2,A
1953-12-26,1953,Luton Town,West Ham United,3-1,3,1,2,2,4,2,H
1953-12-26,1953,Notts County,Birmingham City,2-1,2,1,2,2,3,1,H
1953-12-26,1953,Oldham Athletic,Brentford,2-0,2,0,2,2,2,2,H
1953-12-26,1953,Plymouth Argyle,Fulham,2-2,2,2,2,2,4,0,D
1953-12-26,1953,Rotherham United,Leicester City,1-1,1,1,2,2,2,0,D
1953-12-26,1953,Swansea City,Stoke City,2-2,2,2,2,2,4,0,D
1953-12-28,1953,Bristol Rovers,Everton,0-0,0,0,2,2,0,0,D
1953-12-28,1953,Lincoln City,Hull City,3-0,3,0,2,2,3,3,H
1953-12-28,1953,Stoke City,Swansea City,5-0,5,0,2,2,5,5,H
1954-01-01,1953,Blackburn Rovers,Derby County,0-3,0,3,2,2,3,-3,A
1954-01-02,1953,Birmingham City,Rotherham United,2-3,2,3,2,2,5,-1,A
1954-01-02,1953,Blackburn Rovers,Lincoln City,6-0,6,0,2,2,6,6,H
1954-01-02,1953,Derby County,Bristol Rovers,0-1,0,1,2,2,1,-1,A
1954-01-02,1953,Doncaster Rovers,Notts County,4-2,4,2,2,2,6,2,H
1954-01-02,1953,Fulham,Brentford,4-1,4,1,2,2,5,3,H
1954-01-02,1953,Leeds United,Leicester City,7-1,7,1,2,2,8,6,H
1954-01-02,1953,Luton Town,Plymouth Argyle,2-1,2,1,2,2,3,1,H
1954-01-02,1953,Nottingham Forest,Swansea City,2-1,2,1,2,2,3,1,H
1954-01-16,1953,Bristol Rovers,Brentford,0-0,0,0,2,2,0,0,D
1954-01-16,1953,Everton,Bury,0-0,0,0,2,2,0,0,D
1954-01-16,1953,Fulham,West Ham United,3-4,3,4,2,2,7,-1,A
1954-01-16,1953,Hull City,Doncaster Rovers,3-1,3,1,2,2,4,2,H
1954-01-16,1953,Leicester City,Birmingham City,3-4,3,4,2,2,7,-1,A
1954-01-16,1953,Lincoln City,Derby County,2-2,2,2,2,2,4,0,D
1954-01-16,1953,Notts County,Blackburn Rovers,0-5,0,5,2,2,5,-5,A
1954-01-16,1953,Plymouth Argyle,Oldham Athletic,5-0,5,0,2,2,5,5,H
1954-01-16,1953,Rotherham United,Nottingham Forest,3-0,3,0,2,2,3,3,H
1954-01-16,1953,Stoke City,Leeds United,4-0,4,0,2,2,4,4,H
1954-01-16,1953,Swansea City,Luton Town,1-1,1,1,2,2,2,0,D
1954-01-23,1953,Birmingham City,Stoke City,1-0,1,0,2,2,1,1,H
1954-01-23,1953,Blackburn Rovers,Hull City,3-1,3,1,2,2,4,2,H
1954-01-23,1953,Brentford,Lincoln City,0-1,0,1,2,2,1,-1,A
1954-01-23,1953,Bury,Oldham Athletic,1-0,1,0,2,2,1,1,H
1954-01-23,1953,Derby County,Notts County,0-0,0,0,2,2,0,0,D
1954-01-23,1953,Doncaster Rovers,Everton,2-2,2,2,2,2,4,0,D
1954-01-23,1953,Leeds United,Fulham,1-2,1,2,2,2,3,-1,A
1954-01-23,1953,Luton Town,Rotherham United,1-1,1,1,2,2,2,0,D
1954-01-23,1953,Nottingham Forest,Leicester City,3-1,3,1,2,2,4,2,H
1954-01-23,1953,Plymouth Argyle,Swansea City,1-1,1,1,2,2,2,0,D
1954-01-23,1953,West Ham United,Bristol Rovers,1-1,1,1,2,2,2,0,D
1954-01-30,1953,Bury,Brentford,1-1,1,1,2,2,2,0,D
1954-02-06,1953,Everton,Blackburn Rovers,1-1,1,1,2,2,2,0,D
1954-02-06,1953,Fulham,Birmingham City,5-2,5,2,2,2,7,3,H
1954-02-06,1953,Hull City,Derby County,3-0,3,0,2,2,3,3,H
1954-02-06,1953,Leicester City,Luton Town,2-1,2,1,2,2,3,1,H
1954-02-06,1953,Lincoln City,Bristol Rovers,1-2,1,2,2,2,3,-1,A
1954-02-06,1953,Notts County,Brentford,2-0,2,0,2,2,2,2,H
1954-02-06,1953,Oldham Athletic,Doncaster Rovers,2-2,2,2,2,2,4,0,D
1954-02-06,1953,Rotherham United,Plymouth Argyle,2-1,2,1,2,2,3,1,H
1954-02-06,1953,Stoke City,Nottingham Forest,1-1,1,1,2,2,2,0,D
1954-02-06,1953,Swansea City,Bury,2-1,2,1,2,2,3,1,H
1954-02-06,1953,West Ham United,Leeds United,5-2,5,2,2,2,7,3,H
1954-02-13,1953,Birmingham City,West Ham United,2-0,2,0,2,2,2,2,H
1954-02-13,1953,Blackburn Rovers,Oldham Athletic,4-0,4,0,2,2,4,4,H
1954-02-13,1953,Brentford,Hull City,2-2,2,2,2,2,4,0,D
1954-02-13,1953,Bristol Rovers,Notts County,1-1,1,1,2,2,2,0,D
1954-02-13,1953,Derby County,Everton,2-6,2,6,2,2,8,-4,A
1954-02-13,1953,Doncaster Rovers,Bury,0-1,0,1,2,2,1,-1,A
1954-02-13,1953,Leeds United,Lincoln City,5-2,5,2,2,2,7,3,H
1954-02-13,1953,Luton Town,Stoke City,0-1,0,1,2,2,1,-1,A
1954-02-13,1953,Nottingham Forest,Fulham,4-1,4,1,2,2,5,3,H
1954-02-13,1953,Plymouth Argyle,Leicester City,0-3,0,3,2,2,3,-3,A
1954-02-13,1953,Swansea City,Rotherham United,0-2,0,2,2,2,2,-2,A
1954-02-20,1953,Bury,Blackburn Rovers,0-0,0,0,2,2,0,0,D
1954-02-20,1953,Fulham,Luton Town,5-1,5,1,2,2,6,4,H
1954-02-20,1953,Leeds United,Birmingham City,1-1,1,1,2,2,2,0,D
1954-02-20,1953,Notts County,Lincoln City,1-1,1,1,2,2,2,0,D
1954-02-20,1953,Oldham Athletic,Derby County,0-0,0,0,2,2,0,0,D
1954-02-20,1953,West Ham United,Nottingham Forest,1-1,1,1,2,2,2,0,D
1954-02-23,1953,Leicester City,Swansea City,4-1,4,1,2,2,5,3,H
1954-02-24,1953,Everton,Brentford,6-1,6,1,2,2,7,5,H
1954-02-27,1953,Blackburn Rovers,Stoke City,3-0,3,0,2,2,3,3,H
1954-02-27,1953,Brentford,West Ham United,3-1,3,1,2,2,4,2,H
1954-02-27,1953,Bristol Rovers,Leeds United,1-1,1,1,2,2,2,0,D
1954-02-27,1953,Bury,Rotherham United,3-0,3,0,2,2,3,3,H
1954-02-27,1953,Derby County,Fulham,3-3,3,3,2,2,6,0,D
1954-02-27,1953,Doncaster Rovers,Leicester City,0-2,0,2,2,2,2,-2,A
1954-02-27,1953,Everton,Plymouth Argyle,8-4,8,4,2,2,12,4,H
1954-02-27,1953,Hull City,Luton Town,1-2,1,2,2,2,3,-1,A
1954-02-27,1953,Lincoln City,Birmingham City,0-1,0,1,2,2,1,-1,A
1954-02-27,1953,Notts County,Nottingham Forest,1-1,1,1,2,2,2,0,D
1954-02-27,1953,Oldham Athletic,Swansea City,2-2,2,2,2,2,4,0,D
1954-03-06,1953,Birmingham City,Bristol Rovers,1-1,1,1,2,2,2,0,D
1954-03-06,1953,Fulham,Blackburn Rovers,2-3,2,3,2,2,5,-1,A
1954-03-06,1953,Leeds United,Brentford,4-0,4,0,2,2,4,4,H
1954-03-06,1953,Leicester City,Bury,2-0,2,0,2,2,2,2,H
1954-03-06,1953,Luton Town,Notts County,2-1,2,1,2,2,3,1,H
1954-03-06,1953,Nottingham Forest,Lincoln City,4-2,4,2,2,2,6,2,H
1954-03-06,1953,Plymouth Argyle,Hull City,2-2,2,2,2,2,4,0,D
1954-03-06,1953,Rotherham United,Oldham Athletic,7-0,7,0,2,2,7,7,H
1954-03-06,1953,Stoke City,Doncaster Rovers,2-2,2,2,2,2,4,0,D
1954-03-06,1953,Swansea City,Everton,0-2,0,2,2,2,2,-2,A
1954-03-06,1953,West Ham United,Derby County,0-0,0,0,2,2,0,0,D
1954-03-13,1953,Blackburn Rovers,West Ham United,4-1,4,1,2,2,5,3,H
1954-03-13,1953,Brentford,Birmingham City,2-0,2,0,2,2,2,2,H
1954-03-13,1953,Bristol Rovers,Nottingham Forest,1-0,1,0,2,2,1,1,H
1954-03-13,1953,Bury,Stoke City,0-6,0,6,2,2,6,-6,A
1954-03-13,1953,Derby County,Leeds United,0-2,0,2,2,2,2,-2,A
1954-03-13,1953,Doncaster Rovers,Fulham,2-2,2,2,2,2,4,0,D
1954-03-13,1953,Everton,Rotherham United,3-0,3,0,2,2,3,3,H
1954-03-13,1953,Hull City,Swansea City,4-3,4,3,2,2,7,1,H
1954-03-13,1953,Lincoln City,Luton Town,1-1,1,1,2,2,2,0,D
1954-03-13,1953,Notts County,Plymouth Argyle,2-0,2,0,2,2,2,2,H
1954-03-20,1953,Birmingham City,Derby County,3-0,3,0,2,2,3,3,H
1954-03-20,1953,Fulham,Bury,3-0,3,0,2,2,3,3,H
1954-03-20,1953,Leeds United,Blackburn Rovers,3-2,3,2,2,2,5,1,H
1954-03-20,1953,Leicester City,Everton,2-2,2,2,2,2,4,0,D
1954-03-20,1953,Luton Town,Bristol Rovers,1-1,1,1,2,2,2,0,D
1954-03-20,1953,Nottingham Forest,Brentford,2-1,2,1,2,2,3,1,H
1954-03-20,1953,Plymouth Argyle,Lincoln City,1-2,1,2,2,2,3,-1,A
1954-03-20,1953,Rotherham United,Hull City,3-2,3,2,2,2,5,1,H
1954-03-20,1953,Stoke City,Oldham Athletic,0-1,0,1,2,2,1,-1,A
1954-03-20,1953,Swansea City,Notts County,2-2,2,2,2,2,4,0,D
1954-03-20,1953,West Ham United,Doncaster Rovers,2-1,2,1,2,2,3,1,H
1954-03-27,1953,Blackburn Rovers,Luton Town,2-0,2,0,2,2,2,2,H
1954-03-27,1953,Brentford,Swansea City,3-1,3,1,2,2,4,2,H
1954-03-27,1953,Bristol Rovers,Rotherham United,1-0,1,0,2,2,1,1,H
1954-03-27,1953,Bury,Birmingham City,1-1,1,1,2,2,2,0,D
1954-03-27,1953,Derby County,Plymouth Argyle,1-4,1,4,2,2,5,-3,A
1954-03-27,1953,Doncaster Rovers,Nottingham Forest,1-3,1,3,2,2,4,-2,A
1954-03-27,1953,Everton,West Ham United,1-2,1,2,2,2,3,-1,A
1954-03-27,1953,Hull City,Fulham,2-1,2,1,2,2,3,1,H
1954-03-27,1953,Lincoln City,Leicester City,3-1,3,1,2,2,4,2,H
1954-03-27,1953,Notts County,Stoke City,2-1,2,1,2,2,3,1,H
1954-03-27,1953,Oldham Athletic,Leeds United,4-2,4,2,2,2,6,2,H
1954-04-03,1953,Birmingham City,Oldham Athletic,2-1,2,1,2,2,3,1,H
1954-04-03,1953,Fulham,Notts County,4-3,4,3,2,2,7,1,H
1954-04-03,1953,Leeds United,Everton,3-1,3,1,2,2,4,2,H
1954-04-03,1953,Leicester City,Bristol Rovers,1-0,1,0,2,2,1,1,H
1954-04-03,1953,Luton Town,Doncaster Rovers,2-0,2,0,2,2,2,2,H
1954-04-03,1953,Nottingham Forest,Bury,2-2,2,2,2,2,4,0,D
1954-04-03,1953,Plymouth Argyle,Blackburn Rovers,1-1,1,1,2,2,2,0,D
1954-04-03,1953,Rotherham United,Brentford,1-1,1,1,2,2,2,0,D
1954-04-03,1953,Stoke City,Lincoln City,4-1,4,1,2,2,5,3,H
1954-04-03,1953,Swansea City,Derby County,2-1,2,1,2,2,3,1,H
1954-04-03,1953,West Ham United,Hull City,1-0,1,0,2,2,1,1,H
1954-04-06,1953,Oldham Athletic,Leicester City,0-2,0,2,2,2,2,-2,A
1954-04-07,1953,Bury,Hull City,3-0,3,0,2,2,3,3,H
1954-04-10,1953,Blackburn Rovers,Birmingham City,3-0,3,0,2,2,3,3,H
1954-04-10,1953,Brentford,Luton Town,0-1,0,1,2,2,1,-1,A
1954-04-10,1953,Bristol Rovers,Plymouth Argyle,3-1,3,1,2,2,4,2,H
1954-04-10,1953,Bury,West Ham United,2-0,2,0,2,2,2,2,H
1954-04-10,1953,Derby County,Nottingham Forest,1-2,1,2,2,2,3,-1,A
1954-04-10,1953,Doncaster Rovers,Leeds United,0-0,0,0,2,2,0,0,D
1954-04-10,1953,Everton,Stoke City,1-1,1,1,2,2,2,0,D
1954-04-10,1953,Hull City,Leicester City,0-3,0,3,2,2,3,-3,A
1954-04-10,1953,Lincoln City,Swansea City,3-1,3,1,2,2,4,2,H
1954-04-10,1953,Notts County,Rotherham United,1-2,1,2,2,2,3,-1,A
1954-04-10,1953,Oldham Athletic,Fulham,2-3,2,3,2,2,5,-1,A
1954-04-12,1953,Hull City,Bristol Rovers,4-1,4,1,2,2,5,3,H
1954-04-12,1953,West Ham United,Stoke City,2-2,2,2,2,2,4,0,D
1954-04-16,1953,Blackburn Rovers,Leicester City,3-0,3,0,2,2,3,3,H
1954-04-16,1953,Brentford,Bury,2-1,2,1,2,2,3,1,H
1954-04-16,1953,Bristol Rovers,Oldham Athletic,1-0,1,0,2,2,1,1,H
1954-04-16,1953,Doncaster Rovers,Derby County,1-3,1,3,2,2,4,-2,A
1954-04-16,1953,Everton,Lincoln City,3-1,3,1,2,2,4,2,H
1954-04-16,1953,Hull City,Notts County,0-2,0,2,2,2,2,-2,A
1954-04-16,1953,Luton Town,Leeds United,1-1,1,1,2,2,2,0,D
1954-04-16,1953,Nottingham Forest,Birmingham City,1-1,1,1,2,2,2,0,D
1954-04-16,1953,Swansea City,Fulham,2-0,2,0,2,2,2,2,H
1954-04-16,1953,West Ham United,Plymouth Argyle,2-2,2,2,2,2,4,0,D
1954-04-17,1953,Birmingham City,Doncaster Rovers,0-1,0,1,2,2,1,-1,A
1954-04-17,1953,Fulham,Everton,0-0,0,0,2,2,0,0,D
1954-04-17,1953,Leeds United,Bury,3-4,3,4,2,2,7,-1,A
1954-04-17,1953,Leicester City,Notts County,2-2,2,2,2,2,4,0,D
1954-04-17,1953,Luton Town,Derby County,2-1,2,1,2,2,3,1,H
1954-04-17,1953,Nottingham Forest,Blackburn Rovers,0-1,0,1,2,2,1,-1,A
1954-04-17,1953,Plymouth Argyle,Brentford,3-2,3,2,2,2,5,1,H
1954-04-17,1953,Rotherham United,Lincoln City,4-1,4,1,2,2,5,3,H
1954-04-17,1953,Stoke City,Hull City,0-1,0,1,2,2,1,-1,A
1954-04-17,1953,Swansea City,Bristol Rovers,3-1,3,1,2,2,4,2,H
1954-04-17,1953,West Ham United,Oldham Athletic,0-1,0,1,2,2,1,-1,A
1954-04-19,1953,Birmingham City,Nottingham Forest,2-2,2,2,2,2,4,0,D
1954-04-19,1953,Derby County,Doncaster Rovers,2-0,2,0,2,2,2,2,H
1954-04-19,1953,Fulham,Swansea City,4-3,4,3,2,2,7,1,H
1954-04-19,1953,Leeds United,Luton Town,2-1,2,1,2,2,3,1,H
1954-04-19,1953,Leicester City,Blackburn Rovers,4-0,4,0,2,2,4,4,H
1954-04-19,1953,Lincoln City,Everton,1-1,1,1,2,2,2,0,D
1954-04-19,1953,Notts County,Hull City,1-1,1,1,2,2,2,0,D
1954-04-19,1953,Oldham Athletic,Bristol Rovers,0-0,0,0,2,2,0,0,D
1954-04-19,1953,Plymouth Argyle,West Ham United,2-1,2,1,2,2,3,1,H
1954-04-19,1953,Stoke City,Rotherham United,1-1,1,1,2,2,2,0,D
1954-04-24,1953,Blackburn Rovers,Swansea City,1-0,1,0,2,2,1,1,H
1954-04-24,1953,Brentford,Leicester City,1-3,1,3,2,2,4,-2,A
1954-04-24,1953,Bristol Rovers,Stoke City,3-2,3,2,2,2,5,1,H
1954-04-24,1953,Bury,Luton Town,0-1,0,1,2,2,1,-1,A
1954-04-24,1953,Derby County,Rotherham United,1-1,1,1,2,2,2,0,D
1954-04-24,1953,Doncaster Rovers,Plymouth Argyle,3-3,3,3,2,2,6,0,D
1954-04-24,1953,Everton,Birmingham City,1-0,1,0,2,2,1,1,H
1954-04-24,1953,Hull City,Leeds United,1-1,1,1,2,2,2,0,D
1954-04-24,1953,Lincoln City,Fulham,4-2,4,2,2,2,6,2,H
1954-04-24,1953,Notts County,West Ham United,3-1,3,1,2,2,4,2,H
1954-04-24,1953,Oldham Athletic,Nottingham Forest,1-3,1,3,2,2,4,-2,A
1954-04-26,1953,Stoke City,Plymouth Argyle,3-2,3,2,2,2,5,1,H
1954-04-29,1953,Oldham Athletic,Everton,0-4,0,4,2,2,4,-4,A
1954-04-29,1953,Rotherham United,Doncaster Rovers,4-0,4,0,2,2,4,4,H
1954-08-21,1954,Bristol Rovers,Port Vale,1-0,1,0,2,2,1,1,H
1954-08-21,1954,Fulham,Blackburn Rovers,5-1,5,1,2,2,6,4,H
1954-08-21,1954,Hull City,Leeds United,0-2,0,2,2,2,2,-2,A
1954-08-21,1954,Lincoln City,Bury,3-2,3,2,2,2,5,1,H
1954-08-21,1954,Liverpool,Doncaster Rovers,3-2,3,2,2,2,5,1,H
1954-08-21,1954,Luton Town,Nottingham Forest,3-0,3,0,2,2,3,3,H
1954-08-21,1954,Notts County,Derby County,2-3,2,3,2,2,5,-1,A
1954-08-21,1954,Plymouth Argyle,Middlesbrough,2-2,2,2,2,2,4,0,D
1954-08-21,1954,Rotherham United,Ipswich Town,3-2,3,2,2,2,5,1,H
1954-08-21,1954,Stoke City,Birmingham City,2-1,2,1,2,2,3,1,H
1954-08-21,1954,Swansea City,West Ham United,5-2,5,2,2,2,7,3,H
1954-08-23,1954,Blackburn Rovers,West Ham United,5-2,5,2,2,2,7,3,H
1954-08-23,1954,Plymouth Argyle,Liverpool,1-0,1,0,2,2,1,1,H
1954-08-23,1954,Port Vale,Notts County,1-1,1,1,2,2,2,0,D
1954-08-24,1954,Bury,Luton Town,2-1,2,1,2,2,3,1,H
1954-08-25,1954,Birmingham City,Bristol Rovers,2-1,2,1,2,2,3,1,H
1954-08-25,1954,Derby County,Fulham,3-4,3,4,2,2,7,-1,A
1954-08-25,1954,Doncaster Rovers,Swansea City,2-1,2,1,2,2,3,1,H
1954-08-25,1954,Leeds United,Rotherham United,2-4,2,4,2,2,6,-2,A
1954-08-25,1954,Lincoln City,Hull City,0-1,0,1,2,2,1,-1,A
1954-08-25,1954,Middlesbrough,Ipswich Town,0-1,0,1,2,2,1,-1,A
1954-08-25,1954,Nottingham Forest,Stoke City,0-3,0,3,2,2,3,-3,A
1954-08-28,1954,Birmingham City,Rotherham United,3-1,3,1,2,2,4,2,H
1954-08-28,1954,Blackburn Rovers,Swansea City,4-1,4,1,2,2,5,3,H
1954-08-28,1954,Bury,Fulham,1-3,1,3,2,2,4,-2,A
1954-08-28,1954,Derby County,Liverpool,3-2,3,2,2,2,5,1,H
1954-08-28,1954,Doncaster Rovers,Bristol Rovers,2-2,2,2,2,2,4,0,D
1954-08-28,1954,Ipswich Town,Luton Town,3-1,3,1,2,2,4,2,H
1954-08-28,1954,Leeds United,Lincoln City,2-3,2,3,2,2,5,-1,A
1954-08-28,1954,Middlesbrough,Stoke City,1-2,1,2,2,2,3,-1,A
1954-08-28,1954,Nottingham Forest,Hull City,0-1,0,1,2,2,1,-1,A
1954-08-28,1954,Port Vale,Plymouth Argyle,1-0,1,0,2,2,1,1,H
1954-08-28,1954,West Ham United,Notts County,3-0,3,0,2,2,3,3,H
1954-08-30,1954,Bristol Rovers,Birmingham City,1-1,1,1,2,2,2,0,D
1954-08-30,1954,Hull City,Lincoln City,4-0,4,0,2,2,4,4,H
1954-08-30,1954,Rotherham United,Leeds United,3-0,3,0,2,2,3,3,H
1954-08-30,1954,Stoke City,Nottingham Forest,2-0,2,0,2,2,2,2,H
1954-08-30,1954,West Ham United,Blackburn Rovers,2-5,2,5,2,2,7,-3,A
1954-09-01,1954,Fulham,Derby County,2-0,2,0,2,2,2,2,H
1954-09-01,1954,Ipswich Town,Middlesbrough,6-1,6,1,2,2,7,5,H
1954-09-01,1954,Liverpool,Plymouth Argyle,3-3,3,3,2,2,6,0,D
1954-09-01,1954,Luton Town,Bury,3-2,3,2,2,2,5,1,H
1954-09-02,1954,Notts County,Port Vale,1-1,1,1,2,2,2,0,D
1954-09-02,1954,Swansea City,Doncaster Rovers,3-0,3,0,2,2,3,3,H
1954-09-04,1954,Bristol Rovers,Derby County,4-1,4,1,2,2,5,3,H
1954-09-04,1954,Bury,Leeds United,5-3,5,3,2,2,8,2,H
1954-09-04,1954,Hull City,Ipswich Town,4-2,4,2,2,2,6,2,H
1954-09-04,1954,Lincoln City,Nottingham Forest,2-1,2,1,2,2,3,1,H
1954-09-04,1954,Liverpool,West Ham United,1-2,1,2,2,2,3,-1,A
1954-09-04,1954,Luton Town,Birmingham City,1-0,1,0,2,2,1,1,H
1954-09-04,1954,Notts County,Blackburn Rovers,3-1,3,1,2,2,4,2,H
1954-09-04,1954,Plymouth Argyle,Doncaster Rovers,1-2,1,2,2,2,3,-1,A
1954-09-04,1954,Rotherham United,Middlesbrough,3-0,3,0,2,2,3,3,H
1954-09-04,1954,Stoke City,Port Vale,0-0,0,0,2,2,0,0,D
1954-09-04,1954,Swansea City,Fulham,2-2,2,2,2,2,4,0,D
1954-09-06,1954,Bristol Rovers,Liverpool,3-0,3,0,2,2,3,3,H
1954-09-06,1954,Port Vale,Swansea City,1-0,1,0,2,2,1,1,H
1954-09-06,1954,Rotherham United,Bury,4-2,4,2,2,2,6,2,H
1954-09-06,1954,West Ham United,Hull City,1-1,1,1,2,2,2,0,D
1954-09-08,1954,Birmingham City,Ipswich Town,4-0,4,0,2,2,4,4,H
1954-09-08,1954,Derby County,Blackburn Rovers,0-3,0,3,2,2,3,-3,A
1954-09-08,1954,Fulham,Doncaster Rovers,5-2,5,2,2,2,7,3,H
1954-09-08,1954,Leeds United,Stoke City,0-1,0,1,2,2,1,-1,A
1954-09-08,1954,Lincoln City,Luton Town,1-2,1,2,2,2,3,-1,A
1954-09-08,1954,Middlesbrough,Nottingham Forest,1-4,1,4,2,2,5,-3,A
1954-09-09,1954,Notts County,Plymouth Argyle,2-0,2,0,2,2,2,2,H
1954-09-11,1954,Birmingham City,Hull City,0-0,0,0,2,2,0,0,D
1954-09-11,1954,Blackburn Rovers,Liverpool,4-3,4,3,2,2,7,1,H
1954-09-11,1954,Derby County,Plymouth Argyle,2-2,2,2,2,2,4,0,D
1954-09-11,1954,Fulham,Notts County,3-1,3,1,2,2,4,2,H
1954-09-11,1954,Ipswich Town,Lincoln City,1-2,1,2,2,2,3,-1,A
1954-09-11,1954,Leeds United,Swansea City,5-2,5,2,2,2,7,3,H
1954-09-11,1954,Middlesbrough,Luton Town,0-2,0,2,2,2,2,-2,A
1954-09-11,1954,Nottingham Forest,Bury,2-3,2,3,2,2,5,-1,A
1954-09-11,1954,Stoke City,Rotherham United,1-2,1,2,2,2,3,-1,A
1954-09-11,1954,West Ham United,Bristol Rovers,5-2,5,2,2,2,7,3,H
1954-09-13,1954,Blackburn Rovers,Derby County,5-2,5,2,2,2,7,3,H
1954-09-13,1954,Hull City,West Ham United,0-1,0,1,2,2,1,-1,A
1954-09-13,1954,Stoke City,Leeds United,0-1,0,1,2,2,1,-1,A
1954-09-15,1954,Doncaster Rovers,Fulham,4-0,4,0,2,2,4,4,H
1954-09-15,1954,Ipswich Town,Birmingham City,1-2,1,2,2,2,3,-1,A
1954-09-15,1954,Liverpool,Bristol Rovers,5-3,5,3,2,2,8,2,H
1954-09-15,1954,Luton Town,Lincoln City,2-1,2,1,2,2,3,1,H
1954-09-15,1954,Nottingham Forest,Middlesbrough,4-2,4,2,2,2,6,2,H
1954-09-15,1954,Plymouth Argyle,Notts County,1-3,1,3,2,2,4,-2,A
1954-09-16,1954,Swansea City,Port Vale,7-1,7,1,2,2,8,6,H
1954-09-18,1954,Bristol Rovers,Blackburn Rovers,2-1,2,1,2,2,3,1,H
1954-09-18,1954,Bury,Ipswich Town,2-1,2,1,2,2,3,1,H
1954-09-18,1954,Hull City,Middlesbrough,1-0,1,0,2,2,1,1,H
1954-09-18,1954,Leeds United,Nottingham Forest,1-1,1,1,2,2,2,0,D
1954-09-18,1954,Lincoln City,Birmingham City,1-1,1,1,2,2,2,0,D
1954-09-18,1954,Liverpool,Fulham,4-1,4,1,2,2,5,3,H
1954-09-18,1954,Luton Town,Stoke City,3-1,3,1,2,2,4,2,H
1954-09-18,1954,Notts County,Swansea City,2-1,2,1,2,2,3,1,H
1954-09-18,1954,Plymouth Argyle,West Ham United,1-1,1,1,2,2,2,0,D
1954-09-18,1954,Port Vale,Derby County,3-0,3,0,2,2,3,3,H
1954-09-18,1954,Rotherham United,Doncaster Rovers,2-3,2,3,2,2,5,-1,A
1954-09-20,1954,Bury,Rotherham United,2-2,2,2,2,2,4,0,D
1954-09-22,1954,Ipswich Town,Stoke City,0-1,0,1,2,2,1,-1,A
1954-09-25,1954,Birmingham City,Bury,1-3,1,3,2,2,4,-2,A
1954-09-25,1954,Blackburn Rovers,Plymouth Argyle,2-2,2,2,2,2,4,0,D
1954-09-25,1954,Derby County,Doncaster Rovers,5-0,5,0,2,2,5,5,H
1954-09-25,1954,Fulham,Bristol Rovers,2-3,2,3,2,2,5,-1,A
1954-09-25,1954,Ipswich Town,Leeds United,1-2,1,2,2,2,3,-1,A
1954-09-25,1954,Middlesbrough,Lincoln City,2-1,2,1,2,2,3,1,H
1954-09-25,1954,Nottingham Forest,Notts County,0-1,0,1,2,2,1,-1,A
1954-09-25,1954,Rotherham United,Luton Town,2-0,2,0,2,2,2,2,H
1954-09-25,1954,Stoke City,Hull City,0-0,0,0,2,2,0,0,D
1954-09-25,1954,Swansea City,Liverpool,3-2,3,2,2,2,5,1,H
1954-09-25,1954,West Ham United,Port Vale,2-0,2,0,2,2,2,2,H
1954-09-27,1954,Doncaster Rovers,Port Vale,1-0,1,0,2,2,1,1,H
1954-10-02,1954,Bristol Rovers,Swansea City,7-0,7,0,2,2,7,7,H
1954-10-02,1954,Bury,Middlesbrough,0-1,0,1,2,2,1,-1,A
1954-10-02,1954,Doncaster Rovers,West Ham United,2-1,2,1,2,2,3,1,H
1954-10-02,1954,Hull City,Rotherham United,1-2,1,2,2,2,3,-1,A
1954-10-02,1954,Leeds United,Birmingham City,1-0,1,0,2,2,1,1,H
1954-10-02,1954,Lincoln City,Stoke City,1-4,1,4,2,2,5,-3,A
1954-10-02,1954,Liverpool,Notts County,3-1,3,1,2,2,4,2,H
1954-10-02,1954,Luton Town,Derby County,2-0,2,0,2,2,2,2,H
1954-10-02,1954,Nottingham Forest,Ipswich Town,2-0,2,0,2,2,2,2,H
1954-10-02,1954,Plymouth Argyle,Fulham,3-2,3,2,2,2,5,1,H
1954-10-02,1954,Port Vale,Blackburn Rovers,0-3,0,3,2,2,3,-3,A
1954-10-09,1954,Blackburn Rovers,Ipswich Town,4-1,4,1,2,2,5,3,H
1954-10-09,1954,Bristol Rovers,Luton Town,3-2,3,2,2,2,5,1,H
1954-10-09,1954,Derby County,Leeds United,2-4,2,4,2,2,6,-2,A
1954-10-09,1954,Doncaster Rovers,Bury,1-0,1,0,2,2,1,1,H
1954-10-09,1954,Fulham,Birmingham City,2-1,2,1,2,2,3,1,H
1954-10-09,1954,Liverpool,Rotherham United,3-1,3,1,2,2,4,2,H
1954-10-09,1954,Notts County,Stoke City,1-0,1,0,2,2,1,1,H
1954-10-09,1954,Plymouth Argyle,Hull City,1-2,1,2,2,2,3,-1,A
1954-10-09,1954,Port Vale,Lincoln City,1-3,1,3,2,2,4,-2,A
1954-10-09,1954,Swansea City,Middlesbrough,2-0,2,0,2,2,2,2,H
1954-10-09,1954,West Ham United,Nottingham Forest,2-0,2,0,2,2,2,2,H
1954-10-16,1954,Birmingham City,Swansea City,2-0,2,0,2,2,2,2,H
1954-10-16,1954,Bury,Derby County,2-2,2,2,2,2,4,0,D
1954-10-16,1954,Hull City,Port Vale,2-1,2,1,2,2,3,1,H
1954-10-16,1954,Ipswich Town,Fulham,2-4,2,4,2,2,6,-2,A
1954-10-16,1954,Leeds United,West Ham United,2-1,2,1,2,2,3,1,H
1954-10-16,1954,Lincoln City,Doncaster Rovers,5-1,5,1,2,2,6,4,H
1954-10-16,1954,Luton Town,Plymouth Argyle,3-1,3,1,2,2,4,2,H
1954-10-16,1954,Middlesbrough,Notts County,2-0,2,0,2,2,2,2,H
1954-10-16,1954,Nottingham Forest,Blackburn Rovers,1-2,1,2,2,2,3,-1,A
1954-10-16,1954,Rotherham United,Bristol Rovers,6-2,6,2,2,2,8,4,H
1954-10-16,1954,Stoke City,Liverpool,2-0,2,0,2,2,2,2,H
1954-10-23,1954,Blackburn Rovers,Rotherham United,4-1,4,1,2,2,5,3,H
1954-10-23,1954,Bristol Rovers,Leeds United,5-1,5,1,2,2,6,4,H
1954-10-23,1954,Derby County,Middlesbrough,1-2,1,2,2,2,3,-1,A
1954-10-23,1954,Fulham,Luton Town,3-1,3,1,2,2,4,2,H
1954-10-23,1954,Liverpool,Bury,1-1,1,1,2,2,2,0,D
1954-10-23,1954,Notts County,Lincoln City,2-1,2,1,2,2,3,1,H
1954-10-23,1954,Plymouth Argyle,Nottingham Forest,1-2,1,2,2,2,3,-1,A
1954-10-23,1954,Port Vale,Ipswich Town,3-3,3,3,2,2,6,0,D
1954-10-23,1954,Swansea City,Hull City,1-0,1,0,2,2,1,1,H
1954-10-23,1954,West Ham United,Stoke City,3-0,3,0,2,2,3,3,H
1954-10-30,1954,Birmingham City,Derby County,1-1,1,1,2,2,2,0,D
1954-10-30,1954,Bury,Bristol Rovers,3-1,3,1,2,2,4,2,H
1954-10-30,1954,Hull City,Notts County,5-2,5,2,2,2,7,3,H
1954-10-30,1954,Ipswich Town,Doncaster Rovers,5-1,5,1,2,2,6,4,H
1954-10-30,1954,Leeds United,Plymouth Argyle,3-2,3,2,2,2,5,1,H
1954-10-30,1954,Lincoln City,Liverpool,3-3,3,3,2,2,6,0,D
1954-10-30,1954,Luton Town,Swansea City,1-2,1,2,2,2,3,-1,A
1954-10-30,1954,Middlesbrough,West Ham United,6-0,6,0,2,2,6,6,H
1954-10-30,1954,Nottingham Forest,Port Vale,2-3,2,3,2,2,5,-1,A
1954-10-30,1954,Rotherham United,Fulham,2-3,2,3,2,2,5,-1,A
1954-10-30,1954,Stoke City,Blackburn Rovers,1-1,1,1,2,2,2,0,D
1954-11-06,1954,Blackburn Rovers,Middlesbrough,9-0,9,0,2,2,9,9,H
1954-11-06,1954,Bristol Rovers,Lincoln City,2-2,2,2,2,2,4,0,D
1954-11-06,1954,Derby County,Ipswich Town,2-0,2,0,2,2,2,2,H
1954-11-06,1954,Doncaster Rovers,Nottingham Forest,0-3,0,3,2,2,3,-3,A
1954-11-06,1954,Fulham,Stoke City,2-2,2,2,2,2,4,0,D
1954-11-06,1954,Liverpool,Hull City,2-1,2,1,2,2,3,1,H
1954-11-06,1954,Notts County,Luton Town,3-3,3,3,2,2,6,0,D
1954-11-06,1954,Plymouth Argyle,Bury,2-4,2,4,2,2,6,-2,A
1954-11-06,1954,Port Vale,Leeds United,0-1,0,1,2,2,1,-1,A
1954-11-06,1954,Swansea City,Rotherham United,2-1,2,1,2,2,3,1,H
1954-11-06,1954,West Ham United,Birmingham City,2-2,2,2,2,2,4,0,D
1954-11-13,1954,Birmingham City,Blackburn Rovers,3-1,3,1,2,2,4,2,H
1954-11-13,1954,Bury,Port Vale,2-2,2,2,2,2,4,0,D
1954-11-13,1954,Hull City,Bristol Rovers,0-1,0,1,2,2,1,-1,A
1954-11-13,1954,Ipswich Town,West Ham United,0-3,0,3,2,2,3,-3,A
1954-11-13,1954,Leeds United,Doncaster Rovers,1-0,1,0,2,2,1,1,H
1954-11-13,1954,Lincoln City,Plymouth Argyle,3-2,3,2,2,2,5,1,H
1954-11-13,1954,Luton Town,Liverpool,3-2,3,2,2,2,5,1,H
1954-11-13,1954,Middlesbrough,Fulham,4-2,4,2,2,2,6,2,H
1954-11-13,1954,Nottingham Forest,Derby County,3-0,3,0,2,2,3,3,H
1954-11-13,1954,Rotherham United,Notts County,2-0,2,0,2,2,2,2,H
1954-11-13,1954,Stoke City,Swansea City,4-1,4,1,2,2,5,3,H
1954-11-20,1954,Blackburn Rovers,Hull City,4-0,4,0,2,2,4,4,H
1954-11-20,1954,Bristol Rovers,Ipswich Town,4-0,4,0,2,2,4,4,H
1954-11-20,1954,Derby County,Rotherham United,2-3,2,3,2,2,5,-1,A
1954-11-20,1954,Fulham,Lincoln City,3-2,3,2,2,2,5,1,H
1954-11-20,1954,Liverpool,Nottingham Forest,1-0,1,0,2,2,1,1,H
1954-11-20,1954,Notts County,Leeds United,1-2,1,2,2,2,3,-1,A
1954-11-20,1954,Plymouth Argyle,Birmingham City,1-0,1,0,2,2,1,1,H
1954-11-20,1954,Port Vale,Middlesbrough,1-1,1,1,2,2,2,0,D
1954-11-20,1954,Swansea City,Bury,1-1,1,1,2,2,2,0,D
1954-11-20,1954,West Ham United,Luton Town,2-1,2,1,2,2,3,1,H
1954-11-27,1954,Birmingham City,Port Vale,7-2,7,2,2,2,9,5,H
1954-11-27,1954,Bury,Notts County,1-2,1,2,2,2,3,-1,A
1954-11-27,1954,Hull City,Fulham,0-0,0,0,2,2,0,0,D
1954-11-27,1954,Ipswich Town,Plymouth Argyle,2-1,2,1,2,2,3,1,H
1954-11-27,1954,Leeds United,Liverpool,2-2,2,2,2,2,4,0,D
1954-11-27,1954,Lincoln City,Swansea City,2-2,2,2,2,2,4,0,D
1954-11-27,1954,Luton Town,Blackburn Rovers,7-3,7,3,2,2,10,4,H
1954-11-27,1954,Middlesbrough,Doncaster Rovers,3-1,3,1,2,2,4,2,H
1954-11-27,1954,Nottingham Forest,Bristol Rovers,1-0,1,0,2,2,1,1,H
1954-11-27,1954,Rotherham United,West Ham United,2-2,2,2,2,2,4,0,D
1954-11-27,1954,Stoke City,Derby County,3-1,3,1,2,2,4,2,H
1954-12-04,1954,Blackburn Rovers,Leeds United,1-2,1,2,2,2,3,-1,A
1954-12-04,1954,Bristol Rovers,Stoke City,1-1,1,1,2,2,2,0,D
1954-12-04,1954,Derby County,Lincoln City,3-0,3,0,2,2,3,3,H
1954-12-04,1954,Doncaster Rovers,Hull City,2-2,2,2,2,2,4,0,D
1954-12-04,1954,Fulham,Nottingham Forest,1-1,1,1,2,2,2,0,D
1954-12-04,1954,Liverpool,Middlesbrough,3-1,3,1,2,2,4,2,H
1954-12-04,1954,Notts County,Birmingham City,3-2,3,2,2,2,5,1,H
1954-12-04,1954,Plymouth Argyle,Rotherham United,2-1,2,1,2,2,3,1,H
1954-12-04,1954,Port Vale,Luton Town,1-1,1,1,2,2,2,0,D
1954-12-04,1954,Swansea City,Ipswich Town,6-1,6,1,2,2,7,5,H
1954-12-04,1954,West Ham United,Bury,3-3,3,3,2,2,6,0,D
1954-12-11,1954,Birmingham City,Liverpool,9-1,9,1,2,2,10,8,H
1954-12-11,1954,Bury,Blackburn Rovers,2-1,2,1,2,2,3,1,H
1954-12-11,1954,Hull City,Derby County,1-1,1,1,2,2,2,0,D
1954-12-11,1954,Ipswich Town,Notts County,0-1,0,1,2,2,1,-1,A
1954-12-11,1954,Leeds United,Fulham,1-1,1,1,2,2,2,0,D
1954-12-11,1954,Lincoln City,West Ham United,2-1,2,1,2,2,3,1,H
1954-12-11,1954,Luton Town,Doncaster Rovers,3-0,3,0,2,2,3,3,H
1954-12-11,1954,Middlesbrough,Bristol Rovers,1-0,1,0,2,2,1,1,H
1954-12-11,1954,Nottingham Forest,Swansea City,0-0,0,0,2,2,0,0,D
1954-12-11,1954,Rotherham United,Port Vale,3-0,3,0,2,2,3,3,H
1954-12-11,1954,Stoke City,Plymouth Argyle,3-1,3,1,2,2,4,2,H
1954-12-18,1954,Birmingham City,Stoke City,2-0,2,0,2,2,2,2,H
1954-12-18,1954,Blackburn Rovers,Fulham,3-1,3,1,2,2,4,2,H
1954-12-18,1954,Bury,Lincoln City,3-1,3,1,2,2,4,2,H
1954-12-18,1954,Derby County,Notts County,1-1,1,1,2,2,2,0,D
1954-12-18,1954,Doncaster Rovers,Liverpool,4-1,4,1,2,2,5,3,H
1954-12-18,1954,Ipswich Town,Rotherham United,2-2,2,2,2,2,4,0,D
1954-12-18,1954,Leeds United,Hull City,3-0,3,0,2,2,3,3,H
1954-12-18,1954,Middlesbrough,Plymouth Argyle,4-1,4,1,2,2,5,3,H
1954-12-18,1954,Nottingham Forest,Luton Town,1-5,1,5,2,2,6,-4,A
1954-12-18,1954,Port Vale,Bristol Rovers,1-0,1,0,2,2,1,1,H
1954-12-18,1954,West Ham United,Swansea City,3-3,3,3,2,2,6,0,D
1954-12-25,1954,Birmingham City,Nottingham Forest,0-1,0,1,2,2,1,-1,A
1954-12-25,1954,Doncaster Rovers,Blackburn Rovers,1-3,1,3,2,2,4,-2,A
1954-12-25,1954,Fulham,Port Vale,3-1,3,1,2,2,4,2,H
1954-12-25,1954,Leeds United,Middlesbrough,1-1,1,1,2,2,2,0,D
1954-12-25,1954,Liverpool,Ipswich Town,6-2,6,2,2,2,8,4,H
1954-12-25,1954,Luton Town,Hull City,1-1,1,1,2,2,2,0,D
1954-12-25,1954,Notts County,Bristol Rovers,2-0,2,0,2,2,2,2,H
1954-12-25,1954,Plymouth Argyle,Swansea City,2-2,2,2,2,2,4,0,D
1954-12-25,1954,Rotherham United,Lincoln City,3-0,3,0,2,2,3,3,H
1954-12-25,1954,Stoke City,Bury,3-2,3,2,2,2,5,1,H
1954-12-25,1954,West Ham United,Derby County,1-0,1,0,2,2,1,1,H
1954-12-27,1954,Blackburn Rovers,Doncaster Rovers,7-2,7,2,2,2,9,5,H
1954-12-27,1954,Bristol Rovers,Notts County,1-4,1,4,2,2,5,-3,A
1954-12-27,1954,Bury,Stoke City,1-1,1,1,2,2,2,0,D
1954-12-27,1954,Derby County,West Ham United,0-0,0,0,2,2,0,0,D
1954-12-27,1954,Hull City,Luton Town,0-4,0,4,2,2,4,-4,A
1954-12-27,1954,Ipswich Town,Liverpool,2-0,2,0,2,2,2,2,H
1954-12-27,1954,Lincoln City,Rotherham United,2-3,2,3,2,2,5,-1,A
1954-12-27,1954,Middlesbrough,Leeds United,1-0,1,0,2,2,1,1,H
1954-12-27,1954,Nottingham Forest,Birmingham City,0-2,0,2,2,2,2,-2,A
1954-12-27,1954,Port Vale,Fulham,4-0,4,0,2,2,4,4,H
1954-12-27,1954,Swansea City,Plymouth Argyle,4-2,4,2,2,2,6,2,H
1955-01-01,1954,Bristol Rovers,Doncaster Rovers,1-0,1,0,2,2,1,1,H
1955-01-01,1954,Fulham,Bury,0-0,0,0,2,2,0,0,D
1955-01-01,1954,Hull City,Nottingham Forest,2-3,2,3,2,2,5,-1,A
1955-01-01,1954,Lincoln City,Leeds United,2-0,2,0,2,2,2,2,H
1955-01-01,1954,Liverpool,Derby County,2-0,2,0,2,2,2,2,H
1955-01-01,1954,Luton Town,Ipswich Town,3-2,3,2,2,2,5,1,H
1955-01-01,1954,Notts County,West Ham United,5-1,5,1,2,2,6,4,H
1955-01-01,1954,Plymouth Argyle,Port Vale,0-0,0,0,2,2,0,0,D
1955-01-01,1954,Rotherham United,Birmingham City,0-2,0,2,2,2,2,-2,A
1955-01-01,1954,Stoke City,Middlesbrough,1-2,1,2,2,2,3,-1,A
1955-01-01,1954,Swansea City,Blackburn Rovers,2-3,2,3,2,2,5,-1,A
1955-01-15,1954,Blackburn Rovers,Notts County,4-5,4,5,2,2,9,-1,A
1955-01-15,1954,Doncaster Rovers,Plymouth Argyle,3-2,3,2,2,2,5,1,H
1955-01-15,1954,Leeds United,Bury,1-0,1,0,2,2,1,1,H
1955-01-15,1954,Middlesbrough,Rotherham United,5-1,5,1,2,2,6,4,H
1955-01-15,1954,Nottingham Forest,Lincoln City,1-1,1,1,2,2,2,0,D
1955-01-22,1954,Bristol Rovers,West Ham United,2-4,2,4,2,2,6,-2,A
1955-01-22,1954,Liverpool,Blackburn Rovers,4-1,4,1,2,2,5,3,H
1955-01-22,1954,Luton Town,Middlesbrough,2-0,2,0,2,2,2,2,H
1955-01-22,1954,Plymouth Argyle,Derby County,1-0,1,0,2,2,1,1,H
1955-01-22,1954,Port Vale,Doncaster Rovers,1-1,1,1,2,2,2,0,D
1955-01-22,1954,Swansea City,Leeds United,2-0,2,0,2,2,2,2,H
1955-02-05,1954,Birmingham City,Lincoln City,3-3,3,3,2,2,6,0,D
1955-02-05,1954,Blackburn Rovers,Bristol Rovers,8-3,8,3,2,2,11,5,H
1955-02-05,1954,Derby County,Port Vale,6-1,6,1,2,2,7,5,H
1955-02-05,1954,Doncaster Rovers,Rotherham United,0-4,0,4,2,2,4,-4,A
1955-02-05,1954,Fulham,Liverpool,1-2,1,2,2,2,3,-1,A
1955-02-05,1954,Ipswich Town,Bury,2-3,2,3,2,2,5,-1,A
1955-02-05,1954,Middlesbrough,Hull City,1-2,1,2,2,2,3,-1,A
1955-02-05,1954,Nottingham Forest,Leeds United,1-1,1,1,2,2,2,0,D
1955-02-05,1954,Stoke City,Luton Town,0-0,0,0,2,2,0,0,D
1955-02-05,1954,Swansea City,Notts County,3-0,3,0,2,2,3,3,H
1955-02-05,1954,West Ham United,Plymouth Argyle,6-1,6,1,2,2,7,5,H
1955-02-12,1954,Bristol Rovers,Fulham,4-1,4,1,2,2,5,3,H
1955-02-12,1954,Bury,Birmingham City,0-1,0,1,2,2,1,-1,A
1955-02-12,1954,Doncaster Rovers,Derby County,2-0,2,0,2,2,2,2,H
1955-02-12,1954,Hull City,Stoke City,1-1,1,1,2,2,2,0,D
1955-02-12,1954,Leeds United,Ipswich Town,4-1,4,1,2,2,5,3,H
1955-02-12,1954,Lincoln City,Middlesbrough,3-3,3,3,2,2,6,0,D
1955-02-12,1954,Liverpool,Swansea City,1-1,1,1,2,2,2,0,D
1955-02-12,1954,Luton Town,Rotherham United,4-0,4,0,2,2,4,4,H
1955-02-12,1954,Notts County,Nottingham Forest,4-1,4,1,2,2,5,3,H
1955-02-12,1954,Plymouth Argyle,Blackburn Rovers,0-2,0,2,2,2,2,-2,A
1955-02-12,1954,Port Vale,West Ham United,1-1,1,1,2,2,2,0,D
1955-02-19,1954,Blackburn Rovers,Port Vale,2-1,2,1,2,2,3,1,H
1955-02-19,1954,Derby County,Bristol Rovers,1-1,1,1,2,2,2,0,D
1955-02-19,1954,Fulham,Plymouth Argyle,2-3,2,3,2,2,5,-1,A
1955-02-19,1954,Rotherham United,Hull City,2-0,2,0,2,2,2,2,H
1955-02-19,1954,Stoke City,Lincoln City,4-2,4,2,2,2,6,2,H
1955-02-24,1954,West Ham United,Doncaster Rovers,0-1,0,1,2,2,1,-1,A
1955-02-26,1954,Bury,Doncaster Rovers,1-4,1,4,2,2,5,-3,A
1955-02-26,1954,Hull City,Plymouth Argyle,0-2,0,2,2,2,2,-2,A
1955-02-26,1954,Ipswich Town,Blackburn Rovers,1-1,1,1,2,2,2,0,D
1955-02-26,1954,Leeds United,Derby County,1-0,1,0,2,2,1,1,H
1955-02-26,1954,Middlesbrough,Swansea City,4-2,4,2,2,2,6,2,H
1955-03-02,1954,Birmingham City,Leeds United,2-0,2,0,2,2,2,2,H
1955-03-02,1954,Derby County,Luton Town,0-0,0,0,2,2,0,0,D
1955-03-03,1954,Notts County,Liverpool,0-3,0,3,2,2,3,-3,A
1955-03-05,1954,Blackburn Rovers,Nottingham Forest,0-1,0,1,2,2,1,-1,A
1955-03-05,1954,Bristol Rovers,Rotherham United,1-0,1,0,2,2,1,1,H
1955-03-05,1954,Derby County,Bury,2-3,2,3,2,2,5,-1,A
1955-03-05,1954,Doncaster Rovers,Lincoln City,1-1,1,1,2,2,2,0,D
1955-03-05,1954,Fulham,Ipswich Town,4-1,4,1,2,2,5,3,H
1955-03-05,1954,Liverpool,Stoke City,2-4,2,4,2,2,6,-2,A
1955-03-05,1954,Notts County,Middlesbrough,1-3,1,3,2,2,4,-2,A
1955-03-05,1954,Plymouth Argyle,Luton Town,2-1,2,1,2,2,3,1,H
1955-03-05,1954,Port Vale,Hull City,3-0,3,0,2,2,3,3,H
1955-03-05,1954,Swansea City,Birmingham City,0-3,0,3,2,2,3,-3,A
1955-03-05,1954,West Ham United,Leeds United,2-1,2,1,2,2,3,1,H
1955-03-09,1954,Ipswich Town,Nottingham Forest,2-1,2,1,2,2,3,1,H
1955-03-12,1954,Bury,Liverpool,3-4,3,4,2,2,7,-1,A
1955-03-12,1954,Hull City,Swansea City,4-3,4,3,2,2,7,1,H
1955-03-12,1954,Ipswich Town,Port Vale,1-0,1,0,2,2,1,1,H
1955-03-12,1954,Leeds United,Bristol Rovers,2-0,2,0,2,2,2,2,H
1955-03-12,1954,Luton Town,Fulham,3-0,3,0,2,2,3,3,H
1955-03-12,1954,Middlesbrough,Derby County,3-1,3,1,2,2,4,2,H
1955-03-12,1954,Nottingham Forest,Plymouth Argyle,2-0,2,0,2,2,2,2,H
1955-03-12,1954,Rotherham United,Blackburn Rovers,5-1,5,1,2,2,6,4,H
1955-03-12,1954,Stoke City,West Ham United,0-2,0,2,2,2,2,-2,A
1955-03-16,1954,Birmingham City,Doncaster Rovers,4-1,4,1,2,2,5,3,H
1955-03-16,1954,Lincoln City,Notts County,1-2,1,2,2,2,3,-1,A
1955-03-19,1954,Blackburn Rovers,Stoke City,2-0,2,0,2,2,2,2,H
1955-03-19,1954,Bristol Rovers,Bury,2-1,2,1,2,2,3,1,H
1955-03-19,1954,Derby County,Birmingham City,0-0,0,0,2,2,0,0,D
1955-03-19,1954,Doncaster Rovers,Ipswich Town,1-1,1,1,2,2,2,0,D
1955-03-19,1954,Fulham,Rotherham United,1-1,1,1,2,2,2,0,D
1955-03-19,1954,Liverpool,Lincoln City,2-4,2,4,2,2,6,-2,A
1955-03-19,1954,Notts County,Hull City,3-1,3,1,2,2,4,2,H
1955-03-19,1954,Plymouth Argyle,Leeds United,3-1,3,1,2,2,4,2,H
1955-03-19,1954,Port Vale,Nottingham Forest,1-2,1,2,2,2,3,-1,A
1955-03-19,1954,Swansea City,Luton Town,2-1,2,1,2,2,3,1,H
1955-03-19,1954,West Ham United,Middlesbrough,2-1,2,1,2,2,3,1,H
1955-03-26,1954,Birmingham City,West Ham United,1-2,1,2,2,2,3,-1,A
1955-03-26,1954,Bury,Plymouth Argyle,3-1,3,1,2,2,4,2,H
1955-03-26,1954,Hull City,Liverpool,2-2,2,2,2,2,4,0,D
1955-03-26,1954,Ipswich Town,Derby County,2-1,2,1,2,2,3,1,H
1955-03-26,1954,Leeds United,Port Vale,3-0,3,0,2,2,3,3,H
1955-03-26,1954,Lincoln City,Bristol Rovers,0-2,0,2,2,2,2,-2,A
1955-03-26,1954,Luton Town,Notts County,3-1,3,1,2,2,4,2,H
1955-03-26,1954,Middlesbrough,Blackburn Rovers,4-3,4,3,2,2,7,1,H
1955-03-26,1954,Nottingham Forest,Doncaster Rovers,3-1,3,1,2,2,4,2,H
1955-03-26,1954,Stoke City,Fulham,1-1,1,1,2,2,2,0,D
1955-03-28,1954,Stoke City,Notts County,3-0,3,0,2,2,3,3,H
1955-03-30,1954,Birmingham City,Fulham,3-2,3,2,2,2,5,1,H
1955-03-31,1954,Swansea City,Bristol Rovers,1-1,1,1,2,2,2,0,D
1955-04-02,1954,Blackburn Rovers,Birmingham City,3-3,3,3,2,2,6,0,D
1955-04-02,1954,Bristol Rovers,Hull City,1-0,1,0,2,2,1,1,H
1955-04-02,1954,Derby County,Nottingham Forest,1-2,1,2,2,2,3,-1,A
1955-04-02,1954,Doncaster Rovers,Leeds United,0-1,0,1,2,2,1,-1,A
1955-04-02,1954,Fulham,Middlesbrough,1-2,1,2,2,2,3,-1,A
1955-04-02,1954,Liverpool,Luton Town,4-4,4,4,2,2,8,0,D
1955-04-02,1954,Notts County,Rotherham United,3-2,3,2,2,2,5,1,H
1955-04-02,1954,Plymouth Argyle,Lincoln City,1-0,1,0,2,2,1,1,H
1955-04-02,1954,Port Vale,Bury,1-0,1,0,2,2,1,1,H
1955-04-02,1954,Swansea City,Stoke City,3-5,3,5,2,2,8,-2,A
1955-04-02,1954,West Ham United,Ipswich Town,4-0,4,0,2,2,4,4,H
1955-04-08,1954,Blackburn Rovers,Lincoln City,1-0,1,0,2,2,1,1,H
1955-04-08,1954,Bristol Rovers,Plymouth Argyle,3-1,3,1,2,2,4,2,H
1955-04-08,1954,Bury,Hull City,4-1,4,1,2,2,5,3,H
1955-04-08,1954,Derby County,Swansea City,1-4,1,4,2,2,5,-3,A
1955-04-08,1954,Doncaster Rovers,Notts County,4-2,4,2,2,2,6,2,H
1955-04-08,1954,Luton Town,Leeds United,0-0,0,0,2,2,0,0,D
1955-04-08,1954,Middlesbrough,Birmingham City,2-5,2,5,2,2,7,-3,A
1955-04-08,1954,Nottingham Forest,Rotherham United,0-2,0,2,2,2,2,-2,A
1955-04-08,1954,Port Vale,Liverpool,4-3,4,3,2,2,7,1,H
1955-04-08,1954,West Ham United,Fulham,2-1,2,1,2,2,3,1,H
1955-04-09,1954,Birmingham City,Plymouth Argyle,3-1,3,1,2,2,4,2,H
1955-04-09,1954,Bury,Swansea City,2-1,2,1,2,2,3,1,H
1955-04-09,1954,Hull City,Blackburn Rovers,1-4,1,4,2,2,5,-3,A
1955-04-09,1954,Ipswich Town,Bristol Rovers,1-0,1,0,2,2,1,1,H
1955-04-09,1954,Leeds United,Notts County,2-0,2,0,2,2,2,2,H
1955-04-09,1954,Lincoln City,Fulham,2-2,2,2,2,2,4,0,D
1955-04-09,1954,Luton Town,West Ham United,2-0,2,0,2,2,2,2,H
1955-04-09,1954,Middlesbrough,Port Vale,2-0,2,0,2,2,2,2,H
1955-04-09,1954,Nottingham Forest,Liverpool,3-1,3,1,2,2,4,2,H
1955-04-09,1954,Rotherham United,Derby County,2-1,2,1,2,2,3,1,H
1955-04-09,1954,Stoke City,Doncaster Rovers,3-0,3,0,2,2,3,3,H
1955-04-11,1954,Birmingham City,Middlesbrough,3-0,3,0,2,2,3,3,H
1955-04-11,1954,Fulham,West Ham United,0-0,0,0,2,2,0,0,D
1955-04-11,1954,Hull City,Bury,1-0,1,0,2,2,1,1,H
1955-04-11,1954,Leeds United,Luton Town,4-0,4,0,2,2,4,4,H
1955-04-11,1954,Lincoln City,Blackburn Rovers,2-1,2,1,2,2,3,1,H
1955-04-11,1954,Liverpool,Port Vale,1-1,1,1,2,2,2,0,D
1955-04-11,1954,Notts County,Doncaster Rovers,4-0,4,0,2,2,4,4,H
1955-04-11,1954,Plymouth Argyle,Bristol Rovers,0-1,0,1,2,2,1,-1,A
1955-04-11,1954,Rotherham United,Nottingham Forest,3-2,3,2,2,2,5,1,H
1955-04-11,1954,Stoke City,Ipswich Town,3-0,3,0,2,2,3,3,H
1955-04-11,1954,Swansea City,Derby County,3-0,3,0,2,2,3,3,H
1955-04-16,1954,Blackburn Rovers,Luton Town,0-0,0,0,2,2,0,0,D
1955-04-16,1954,Bristol Rovers,Nottingham Forest,2-1,2,1,2,2,3,1,H
1955-04-16,1954,Derby County,Stoke City,1-2,1,2,2,2,3,-1,A
1955-04-16,1954,Doncaster Rovers,Middlesbrough,3-1,3,1,2,2,4,2,H
1955-04-16,1954,Fulham,Hull City,0-1,0,1,2,2,1,-1,A
1955-04-16,1954,Liverpool,Leeds United,2-2,2,2,2,2,4,0,D
1955-04-16,1954,Notts County,Bury,2-1,2,1,2,2,3,1,H
1955-04-16,1954,Plymouth Argyle,Ipswich Town,2-0,2,0,2,2,2,2,H
1955-04-16,1954,Port Vale,Birmingham City,2-0,2,0,2,2,2,2,H
1955-04-16,1954,Swansea City,Lincoln City,3-1,3,1,2,2,4,2,H
1955-04-16,1954,West Ham United,Rotherham United,1-2,1,2,2,2,3,-1,A
1955-04-18,1954,Ipswich Town,Hull City,2-0,2,0,2,2,2,2,H
1955-04-18,1954,Rotherham United,Stoke City,2-1,2,1,2,2,3,1,H
1955-04-20,1954,Birmingham City,Luton Town,2-1,2,1,2,2,3,1,H
1955-04-20,1954,Bury,Nottingham Forest,1-1,1,1,2,2,2,0,D
1955-04-20,1954,Doncaster Rovers,Stoke City,1-1,1,1,2,2,2,0,D
1955-04-20,1954,Fulham,Swansea City,5-1,5,1,2,2,6,4,H
1955-04-23,1954,Birmingham City,Notts County,1-1,1,1,2,2,2,0,D
1955-04-23,1954,Bury,West Ham United,4-1,4,1,2,2,5,3,H
1955-04-23,1954,Hull City,Doncaster Rovers,1-1,1,1,2,2,2,0,D
1955-04-23,1954,Ipswich Town,Swansea City,1-1,1,1,2,2,2,0,D
1955-04-23,1954,Leeds United,Blackburn Rovers,2-0,2,0,2,2,2,2,H
1955-04-23,1954,Lincoln City,Derby County,3-0,3,0,2,2,3,3,H
1955-04-23,1954,Luton Town,Port Vale,4-2,4,2,2,2,6,2,H
1955-04-23,1954,Middlesbrough,Liverpool,1-2,1,2,2,2,3,-1,A
1955-04-23,1954,Nottingham Forest,Fulham,2-0,2,0,2,2,2,2,H
1955-04-23,1954,Rotherham United,Plymouth Argyle,2-0,2,0,2,2,2,2,H
1955-04-23,1954,Stoke City,Bristol Rovers,2-0,2,0,2,2,2,2,H
1955-04-25,1954,Hull City,Birmingham City,0-3,0,3,2,2,3,-3,A
1955-04-25,1954,Port Vale,Stoke City,0-1,0,1,2,2,1,-1,A
1955-04-25,1954,Rotherham United,Swansea City,2-0,2,0,2,2,2,2,H
1955-04-26,1954,West Ham United,Liverpool,0-3,0,3,2,2,3,-3,A
1955-04-27,1954,Lincoln City,Ipswich Town,1-1,1,1,2,2,2,0,D
1955-04-27,1954,Luton Town,Bristol Rovers,2-0,2,0,2,2,2,2,H
1955-04-27,1954,Middlesbrough,Bury,1-1,1,1,2,2,2,0,D
1955-04-27,1954,Notts County,Fulham,0-0,0,0,2,2,0,0,D
1955-04-30,1954,Blackburn Rovers,Bury,1-1,1,1,2,2,2,0,D
1955-04-30,1954,Bristol Rovers,Middlesbrough,2-2,2,2,2,2,4,0,D
1955-04-30,1954,Derby County,Hull City,3-0,3,0,2,2,3,3,H
1955-04-30,1954,Doncaster Rovers,Luton Town,0-3,0,3,2,2,3,-3,A
1955-04-30,1954,Fulham,Leeds United,1-3,1,3,2,2,4,-2,A
1955-04-30,1954,Liverpool,Birmingham City,2-2,2,2,2,2,4,0,D
1955-04-30,1954,Notts County,Ipswich Town,2-1,2,1,2,2,3,1,H
1955-04-30,1954,Plymouth Argyle,Stoke City,2-0,2,0,2,2,2,2,H
1955-04-30,1954,Port Vale,Rotherham United,1-0,1,0,2,2,1,1,H
1955-04-30,1954,Swansea City,Nottingham Forest,3-2,3,2,2,2,5,1,H
1955-04-30,1954,West Ham United,Lincoln City,0-1,0,1,2,2,1,-1,A
1955-05-02,1954,Nottingham Forest,West Ham United,1-1,1,1,2,2,2,0,D
1955-05-02,1954,Rotherham United,Liverpool,6-1,6,1,2,2,7,5,H
1955-05-04,1954,Doncaster Rovers,Birmingham City,1-5,1,5,2,2,6,-4,A
1955-05-04,1954,Lincoln City,Port Vale,0-1,0,1,2,2,1,-1,A
1955-08-20,1955,Barnsley,Leeds United,2-1,2,1,2,2,3,1,H
1955-08-20,1955,Blackburn Rovers,Lincoln City,0-2,0,2,2,2,2,-2,A
1955-08-20,1955,Bristol City,Swansea City,2-1,2,1,2,2,3,1,H
1955-08-20,1955,Bury,Fulham,1-5,1,5,2,2,6,-4,A
1955-08-20,1955,Doncaster Rovers,Stoke City,2-4,2,4,2,2,6,-2,A
1955-08-20,1955,Hull City,Leicester City,2-4,2,4,2,2,6,-2,A
1955-08-20,1955,Middlesbrough,Notts County,3-0,3,0,2,2,3,3,H
1955-08-20,1955,Nottingham Forest,Liverpool,1-3,1,3,2,2,4,-2,A
1955-08-20,1955,Port Vale,Bristol Rovers,1-1,1,1,2,2,2,0,D
1955-08-20,1955,Sheffield Wednesday,Plymouth Argyle,5-2,5,2,2,2,7,3,H
1955-08-20,1955,West Ham United,Rotherham United,1-1,1,1,2,2,2,0,D
1955-08-22,1955,Bristol Rovers,Stoke City,4-2,4,2,2,2,6,2,H
1955-08-22,1955,Leeds United,Bury,1-0,1,0,2,2,1,1,H
1955-08-22,1955,Leicester City,Nottingham Forest,5-2,5,2,2,2,7,3,H
1955-08-22,1955,Plymouth Argyle,Doncaster Rovers,2-2,2,2,2,2,4,0,D
1955-08-22,1955,Port Vale,West Ham United,2-1,2,1,2,2,3,1,H
1955-08-22,1955,Rotherham United,Bristol City,1-3,1,3,2,2,4,-2,A
1955-08-24,1955,Fulham,Blackburn Rovers,3-0,3,0,2,2,3,3,H
1955-08-24,1955,Lincoln City,Hull City,2-0,2,0,2,2,2,2,H
1955-08-24,1955,Liverpool,Sheffield Wednesday,0-3,0,3,2,2,3,-3,A
1955-08-25,1955,Notts County,Barnsley,2-2,2,2,2,2,4,0,D
1955-08-25,1955,Swansea City,Middlesbrough,2-1,2,1,2,2,3,1,H
1955-08-27,1955,Bristol Rovers,Doncaster Rovers,4-2,4,2,2,2,6,2,H
1955-08-27,1955,Fulham,Barnsley,5-1,5,1,2,2,6,4,H
1955-08-27,1955,Leeds United,Middlesbrough,2-0,2,0,2,2,2,2,H
1955-08-27,1955,Leicester City,Blackburn Rovers,0-2,0,2,2,2,2,-2,A
1955-08-27,1955,Lincoln City,Bury,4-2,4,2,2,2,6,2,H
1955-08-27,1955,Liverpool,Hull City,3-0,3,0,2,2,3,3,H
1955-08-27,1955,Notts County,Bristol City,3-2,3,2,2,2,5,1,H
1955-08-27,1955,Plymouth Argyle,Nottingham Forest,1-2,1,2,2,2,3,-1,A
1955-08-27,1955,Rotherham United,Port Vale,1-0,1,0,2,2,1,1,H
1955-08-27,1955,Stoke City,Sheffield Wednesday,2-0,2,0,2,2,2,2,H
1955-08-27,1955,Swansea City,West Ham United,4-2,4,2,2,2,6,2,H
1955-08-29,1955,Blackburn Rovers,Fulham,1-0,1,0,2,2,1,1,H
1955-08-29,1955,Hull City,Lincoln City,2-1,2,1,2,2,3,1,H
1955-08-29,1955,Stoke City,Bristol Rovers,1-2,1,2,2,2,3,-1,A
1955-08-29,1955,West Ham United,Port Vale,0-2,0,2,2,2,2,-2,A
1955-08-30,1955,Bristol City,Rotherham United,5-2,5,2,2,2,7,3,H
1955-08-30,1955,Bury,Leeds United,1-0,1,0,2,2,1,1,H
1955-08-31,1955,Barnsley,Notts County,3-1,3,1,2,2,4,2,H
1955-08-31,1955,Middlesbrough,Swansea City,4-1,4,1,2,2,5,3,H
1955-08-31,1955,Nottingham Forest,Leicester City,2-0,2,0,2,2,2,2,H
1955-08-31,1955,Sheffield Wednesday,Liverpool,1-1,1,1,2,2,2,0,D
1955-09-01,1955,Doncaster Rovers,Plymouth Argyle,3-1,3,1,2,2,4,2,H
1955-09-03,1955,Barnsley,Bury,3-3,3,3,2,2,6,0,D
1955-09-03,1955,Blackburn Rovers,Liverpool,3-3,3,3,2,2,6,0,D
1955-09-03,1955,Bristol City,Leeds United,0-1,0,1,2,2,1,-1,A
1955-09-03,1955,Doncaster Rovers,Rotherham United,1-1,1,1,2,2,2,0,D
1955-09-03,1955,Hull City,Plymouth Argyle,0-1,0,1,2,2,1,-1,A
1955-09-03,1955,Lincoln City,Leicester City,7-1,7,1,2,2,8,6,H
1955-09-03,1955,Middlesbrough,Fulham,1-1,1,1,2,2,2,0,D
1955-09-03,1955,Nottingham Forest,Stoke City,2-3,2,3,2,2,5,-1,A
1955-09-03,1955,Port Vale,Swansea City,3-0,3,0,2,2,3,3,H
1955-09-03,1955,Sheffield Wednesday,Bristol Rovers,4-2,4,2,2,2,6,2,H
1955-09-03,1955,West Ham United,Notts County,6-1,6,1,2,2,7,5,H
1955-09-05,1955,Doncaster Rovers,Leicester City,6-2,6,2,2,2,8,4,H
1955-09-05,1955,Leeds United,Hull City,1-0,1,0,2,2,1,1,H
1955-09-05,1955,Plymouth Argyle,Stoke City,0-1,0,1,2,2,1,-1,A
1955-09-05,1955,Rotherham United,Barnsley,0-0,0,0,2,2,0,0,D
1955-09-06,1955,Bristol City,West Ham United,3-1,3,1,2,2,4,2,H
1955-09-07,1955,Fulham,Notts County,1-1,1,1,2,2,2,0,D
1955-09-07,1955,Lincoln City,Sheffield Wednesday,2-2,2,2,2,2,4,0,D
1955-09-07,1955,Liverpool,Bristol Rovers,0-2,0,2,2,2,2,-2,A
1955-09-08,1955,Swansea City,Bury,5-3,5,3,2,2,8,2,H
1955-09-10,1955,Bristol Rovers,Nottingham Forest,4-1,4,1,2,2,5,3,H
1955-09-10,1955,Bury,Middlesbrough,1-1,1,1,2,2,2,0,D
1955-09-10,1955,Doncaster Rovers,Sheffield Wednesday,2-2,2,2,2,2,4,0,D
1955-09-10,1955,Fulham,Bristol City,3-0,3,0,2,2,3,3,H
1955-09-10,1955,Leeds United,West Ham United,3-3,3,3,2,2,6,0,D
1955-09-10,1955,Leicester City,Barnsley,0-0,0,0,2,2,0,0,D
1955-09-10,1955,Liverpool,Lincoln City,2-1,2,1,2,2,3,1,H
1955-09-10,1955,Notts County,Port Vale,0-0,0,0,2,2,0,0,D
1955-09-10,1955,Plymouth Argyle,Blackburn Rovers,1-0,1,0,2,2,1,1,H
1955-09-10,1955,Stoke City,Hull City,4-1,4,1,2,2,5,3,H
1955-09-10,1955,Swansea City,Rotherham United,4-1,4,1,2,2,5,3,H
1955-09-12,1955,Sheffield Wednesday,Leicester City,1-1,1,1,2,2,2,0,D
1955-09-12,1955,Stoke City,Plymouth Argyle,4-1,4,1,2,2,5,3,H
1955-09-14,1955,Barnsley,Rotherham United,3-2,3,2,2,2,5,1,H
1955-09-15,1955,Notts County,Fulham,3-4,3,4,2,2,7,-1,A
1955-09-17,1955,Blackburn Rovers,Stoke City,3-0,3,0,2,2,3,3,H
1955-09-17,1955,Bristol City,Bury,3-1,3,1,2,2,4,2,H
1955-09-17,1955,Hull City,Bristol Rovers,1-2,1,2,2,2,3,-1,A
1955-09-17,1955,Leicester City,Liverpool,3-1,3,1,2,2,4,2,H
1955-09-17,1955,Lincoln City,Plymouth Argyle,1-0,1,0,2,2,1,1,H
1955-09-17,1955,Middlesbrough,Barnsley,1-1,1,1,2,2,2,0,D
1955-09-17,1955,Nottingham Forest,Doncaster Rovers,5-0,5,0,2,2,5,5,H
1955-09-17,1955,Port Vale,Leeds United,2-0,2,0,2,2,2,2,H
1955-09-17,1955,Rotherham United,Notts County,1-1,1,1,2,2,2,0,D
1955-09-17,1955,Sheffield Wednesday,Swansea City,2-2,2,2,2,2,4,0,D
1955-09-17,1955,West Ham United,Fulham,2-1,2,1,2,2,3,1,H
1955-09-19,1955,Bury,Swansea City,2-4,2,4,2,2,6,-2,A
1955-09-24,1955,Barnsley,Bristol City,0-0,0,0,2,2,0,0,D
1955-09-24,1955,Bristol Rovers,Blackburn Rovers,1-0,1,0,2,2,1,1,H
1955-09-24,1955,Bury,West Ham United,1-1,1,1,2,2,2,0,D
1955-09-24,1955,Doncaster Rovers,Hull City,3-0,3,0,2,2,3,3,H
1955-09-24,1955,Fulham,Port Vale,1-4,1,4,2,2,5,-3,A
1955-09-24,1955,Leeds United,Rotherham United,4-1,4,1,2,2,5,3,H
1955-09-24,1955,Liverpool,Middlesbrough,1-1,1,1,2,2,2,0,D
1955-09-24,1955,Notts County,Swansea City,1-5,1,5,2,2,6,-4,A
1955-09-24,1955,Plymouth Argyle,Leicester City,0-1,0,1,2,2,1,-1,A
1955-09-24,1955,Sheffield Wednesday,Nottingham Forest,1-2,1,2,2,2,3,-1,A
1955-09-24,1955,Stoke City,Lincoln City,3-0,3,0,2,2,3,3,H
1955-10-01,1955,Blackburn Rovers,Doncaster Rovers,1-1,1,1,2,2,2,0,D
1955-10-01,1955,Bristol City,Middlesbrough,2-0,2,0,2,2,2,2,H
1955-10-01,1955,Hull City,Sheffield Wednesday,2-2,2,2,2,2,4,0,D
1955-10-01,1955,Leicester City,Stoke City,3-1,3,1,2,2,4,2,H
1955-10-01,1955,Lincoln City,Bristol Rovers,2-0,2,0,2,2,2,2,H
1955-10-01,1955,Liverpool,Plymouth Argyle,4-1,4,1,2,2,5,3,H
1955-10-01,1955,Nottingham Forest,Notts County,0-2,0,2,2,2,2,-2,A
1955-10-01,1955,Port Vale,Bury,1-1,1,1,2,2,2,0,D
1955-10-01,1955,Rotherham United,Fulham,2-3,2,3,2,2,5,-1,A
1955-10-01,1955,Swansea City,Leeds United,1-1,1,1,2,2,2,0,D
1955-10-01,1955,West Ham United,Barnsley,4-0,4,0,2,2,4,4,H
1955-10-08,1955,Barnsley,Lincoln City,1-0,1,0,2,2,1,1,H
1955-10-08,1955,Bristol City,Liverpool,2-1,2,1,2,2,3,1,H
1955-10-08,1955,Bury,Blackburn Rovers,0-4,0,4,2,2,4,-4,A
1955-10-08,1955,Fulham,Hull City,5-0,5,0,2,2,5,5,H
1955-10-08,1955,Leeds United,Nottingham Forest,3-0,3,0,2,2,3,3,H
1955-10-08,1955,Middlesbrough,Leicester City,4-3,4,3,2,2,7,1,H
1955-10-08,1955,Notts County,Sheffield Wednesday,1-1,1,1,2,2,2,0,D
1955-10-08,1955,Port Vale,Stoke City,1-0,1,0,2,2,1,1,H
1955-10-08,1955,Rotherham United,Bristol Rovers,1-0,1,0,2,2,1,1,H
1955-10-08,1955,Swansea City,Doncaster Rovers,2-0,2,0,2,2,2,2,H
1955-10-08,1955,West Ham United,Plymouth Argyle,4-0,4,0,2,2,4,4,H
1955-10-15,1955,Blackburn Rovers,Barnsley,5-1,5,1,2,2,6,4,H
1955-10-15,1955,Bristol Rovers,Swansea City,1-2,1,2,2,2,3,-1,A
1955-10-15,1955,Doncaster Rovers,Notts County,1-1,1,1,2,2,2,0,D
1955-10-15,1955,Hull City,Bury,2-3,2,3,2,2,5,-1,A
1955-10-15,1955,Leicester City,Bristol City,2-2,2,2,2,2,4,0,D
1955-10-15,1955,Lincoln City,Middlesbrough,1-2,1,2,2,2,3,-1,A
1955-10-15,1955,Liverpool,West Ham United,3-1,3,1,2,2,4,2,H
1955-10-15,1955,Nottingham Forest,Fulham,1-0,1,0,2,2,1,1,H
1955-10-15,1955,Plymouth Argyle,Port Vale,1-1,1,1,2,2,2,0,D
1955-10-15,1955,Sheffield Wednesday,Leeds United,4-0,4,0,2,2,4,4,H
1955-10-15,1955,Stoke City,Rotherham United,1-0,1,0,2,2,1,1,H
1955-10-22,1955,Barnsley,Plymouth Argyle,1-2,1,2,2,2,3,-1,A
1955-10-22,1955,Bristol City,Bristol Rovers,1-1,1,1,2,2,2,0,D
1955-10-22,1955,Bury,Liverpool,1-4,1,4,2,2,5,-3,A
1955-10-22,1955,Fulham,Leicester City,3-2,3,2,2,2,5,1,H
1955-10-22,1955,Leeds United,Lincoln City,1-0,1,0,2,2,1,1,H
1955-10-22,1955,Middlesbrough,Stoke City,1-3,1,3,2,2,4,-2,A
1955-10-22,1955,Notts County,Blackburn Rovers,1-2,1,2,2,2,3,-1,A
1955-10-22,1955,Port Vale,Sheffield Wednesday,0-1,0,1,2,2,1,-1,A
1955-10-22,1955,Rotherham United,Nottingham Forest,2-1,2,1,2,2,3,1,H
1955-10-22,1955,Swansea City,Hull City,4-1,4,1,2,2,5,3,H
1955-10-22,1955,West Ham United,Doncaster Rovers,6-1,6,1,2,2,7,5,H
1955-10-29,1955,Blackburn Rovers,Bristol City,4-6,4,6,2,2,10,-2,A
1955-10-29,1955,Bristol Rovers,Leeds United,4-1,4,1,2,2,5,3,H
1955-10-29,1955,Doncaster Rovers,Fulham,4-2,4,2,2,2,6,2,H
1955-10-29,1955,Hull City,Middlesbrough,2-2,2,2,2,2,4,0,D
1955-10-29,1955,Leicester City,Port Vale,4-1,4,1,2,2,5,3,H
1955-10-29,1955,Lincoln City,West Ham United,1-1,1,1,2,2,2,0,D
1955-10-29,1955,Liverpool,Rotherham United,2-0,2,0,2,2,2,2,H
1955-10-29,1955,Nottingham Forest,Barnsley,1-0,1,0,2,2,1,1,H
1955-10-29,1955,Plymouth Argyle,Swansea City,0-1,0,1,2,2,1,-1,A
1955-10-29,1955,Sheffield Wednesday,Bury,3-3,3,3,2,2,6,0,D
1955-10-29,1955,Stoke City,Notts County,0-2,0,2,2,2,2,-2,A
1955-11-05,1955,Barnsley,Sheffield Wednesday,0-3,0,3,2,2,3,-3,A
1955-11-05,1955,Bristol City,Hull City,5-2,5,2,2,2,7,3,H
1955-11-05,1955,Bury,Doncaster Rovers,5-1,5,1,2,2,6,4,H
1955-11-05,1955,Fulham,Bristol Rovers,3-5,3,5,2,2,8,-2,A
1955-11-05,1955,Leeds United,Stoke City,1-0,1,0,2,2,1,1,H
1955-11-05,1955,Middlesbrough,Nottingham Forest,3-2,3,2,2,2,5,1,H
1955-11-05,1955,Notts County,Plymouth Argyle,3-0,3,0,2,2,3,3,H
1955-11-05,1955,Port Vale,Lincoln City,1-1,1,1,2,2,2,0,D
1955-11-05,1955,Rotherham United,Leicester City,3-1,3,1,2,2,4,2,H
1955-11-05,1955,Swansea City,Liverpool,2-1,2,1,2,2,3,1,H
1955-11-05,1955,West Ham United,Blackburn Rovers,2-3,2,3,2,2,5,-1,A
1955-11-12,1955,Blackburn Rovers,Port Vale,7-1,7,1,2,2,8,6,H
1955-11-12,1955,Bristol Rovers,Bury,4-2,4,2,2,2,6,2,H
1955-11-12,1955,Doncaster Rovers,Barnsley,1-1,1,1,2,2,2,0,D
1955-11-12,1955,Hull City,West Ham United,3-1,3,1,2,2,4,2,H
1955-11-12,1955,Leicester City,Swansea City,6-1,6,1,2,2,7,5,H
1955-11-12,1955,Lincoln City,Rotherham United,1-1,1,1,2,2,2,0,D
1955-11-12,1955,Liverpool,Notts County,2-1,2,1,2,2,3,1,H
1955-11-12,1955,Nottingham Forest,Bristol City,0-2,0,2,2,2,2,-2,A
1955-11-12,1955,Plymouth Argyle,Leeds United,4-3,4,3,2,2,7,1,H
1955-11-12,1955,Sheffield Wednesday,Middlesbrough,3-1,3,1,2,2,4,2,H
1955-11-12,1955,Stoke City,Fulham,1-2,1,2,2,2,3,-1,A
1955-11-19,1955,Barnsley,Bristol Rovers,4-3,4,3,2,2,7,1,H
1955-11-19,1955,Bristol City,Sheffield Wednesday,3-2,3,2,2,2,5,1,H
1955-11-19,1955,Bury,Stoke City,1-0,1,0,2,2,1,1,H
1955-11-19,1955,Fulham,Plymouth Argyle,2-1,2,1,2,2,3,1,H
1955-11-19,1955,Leeds United,Liverpool,4-2,4,2,2,2,6,2,H
1955-11-19,1955,Middlesbrough,Doncaster Rovers,4-1,4,1,2,2,5,3,H
1955-11-19,1955,Notts County,Leicester City,1-1,1,1,2,2,2,0,D
1955-11-19,1955,Port Vale,Hull City,0-1,0,1,2,2,1,-1,A
1955-11-19,1955,Rotherham United,Blackburn Rovers,3-2,3,2,2,2,5,1,H
1955-11-19,1955,Swansea City,Lincoln City,0-2,0,2,2,2,2,-2,A
1955-11-19,1955,West Ham United,Nottingham Forest,1-2,1,2,2,2,3,-1,A
1955-11-26,1955,Blackburn Rovers,Swansea City,3-0,3,0,2,2,3,3,H
1955-11-26,1955,Bristol Rovers,Middlesbrough,7-2,7,2,2,2,9,5,H
1955-11-26,1955,Doncaster Rovers,Bristol City,3-2,3,2,2,2,5,1,H
1955-11-26,1955,Hull City,Rotherham United,0-3,0,3,2,2,3,-3,A
1955-11-26,1955,Leicester City,Leeds United,5-2,5,2,2,2,7,3,H
1955-11-26,1955,Lincoln City,Notts County,2-0,2,0,2,2,2,2,H
1955-11-26,1955,Liverpool,Fulham,7-0,7,0,2,2,7,7,H
1955-11-26,1955,Nottingham Forest,Port Vale,2-2,2,2,2,2,4,0,D
1955-11-26,1955,Plymouth Argyle,Bury,1-4,1,4,2,2,5,-3,A
1955-11-26,1955,Sheffield Wednesday,West Ham United,1-1,1,1,2,2,2,0,D
1955-11-26,1955,Stoke City,Barnsley,2-1,2,1,2,2,3,1,H
1955-12-03,1955,Barnsley,Hull City,2-1,2,1,2,2,3,1,H
1955-12-03,1955,Bristol City,Lincoln City,5-1,5,1,2,2,6,4,H
1955-12-03,1955,Bury,Nottingham Forest,1-2,1,2,2,2,3,-1,A
1955-12-03,1955,Fulham,Sheffield Wednesday,1-2,1,2,2,2,3,-1,A
1955-12-03,1955,Leeds United,Doncaster Rovers,3-0,3,0,2,2,3,3,H
1955-12-03,1955,Middlesbrough,Blackburn Rovers,1-0,1,0,2,2,1,1,H
1955-12-03,1955,Notts County,Bristol Rovers,5-2,5,2,2,2,7,3,H
1955-12-03,1955,Port Vale,Liverpool,1-1,1,1,2,2,2,0,D
1955-12-03,1955,Rotherham United,Plymouth Argyle,0-0,0,0,2,2,0,0,D
1955-12-03,1955,Swansea City,Stoke City,0-0,0,0,2,2,0,0,D
1955-12-03,1955,West Ham United,Leicester City,1-3,1,3,2,2,4,-2,A
1955-12-10,1955,Blackburn Rovers,Leeds United,2-3,2,3,2,2,5,-1,A
1955-12-10,1955,Bristol Rovers,West Ham United,1-1,1,1,2,2,2,0,D
1955-12-10,1955,Doncaster Rovers,Port Vale,3-0,3,0,2,2,3,3,H
1955-12-10,1955,Hull City,Notts County,2-0,2,0,2,2,2,2,H
1955-12-10,1955,Leicester City,Bury,5-0,5,0,2,2,5,5,H
1955-12-10,1955,Lincoln City,Fulham,6-1,6,1,2,2,7,5,H
1955-12-10,1955,Liverpool,Barnsley,1-1,1,1,2,2,2,0,D
1955-12-10,1955,Nottingham Forest,Swansea City,2-1,2,1,2,2,3,1,H
1955-12-10,1955,Plymouth Argyle,Middlesbrough,4-0,4,0,2,2,4,4,H
1955-12-10,1955,Sheffield Wednesday,Rotherham United,0-2,0,2,2,2,2,-2,A
1955-12-10,1955,Stoke City,Bristol City,4-2,4,2,2,2,6,2,H
1955-12-17,1955,Bristol Rovers,Port Vale,1-2,1,2,2,2,3,-1,A
1955-12-17,1955,Fulham,Bury,3-1,3,1,2,2,4,2,H
1955-12-17,1955,Leeds United,Barnsley,3-1,3,1,2,2,4,2,H
1955-12-17,1955,Leicester City,Hull City,1-2,1,2,2,2,3,-1,A
1955-12-17,1955,Lincoln City,Blackburn Rovers,3-0,3,0,2,2,3,3,H
1955-12-17,1955,Liverpool,Nottingham Forest,5-2,5,2,2,2,7,3,H
1955-12-17,1955,Notts County,Middlesbrough,5-0,5,0,2,2,5,5,H
1955-12-17,1955,Plymouth Argyle,Sheffield Wednesday,1-1,1,1,2,2,2,0,D
1955-12-17,1955,Rotherham United,West Ham United,3-2,3,2,2,2,5,1,H
1955-12-17,1955,Stoke City,Doncaster Rovers,5-2,5,2,2,2,7,3,H
1955-12-17,1955,Swansea City,Bristol City,2-1,2,1,2,2,3,1,H
1955-12-24,1955,Barnsley,Fulham,3-0,3,0,2,2,3,3,H
1955-12-24,1955,Blackburn Rovers,Leicester City,2-3,2,3,2,2,5,-1,A
1955-12-24,1955,Bristol City,Notts County,1-3,1,3,2,2,4,-2,A
1955-12-24,1955,Bury,Lincoln City,3-3,3,3,2,2,6,0,D
1955-12-24,1955,Doncaster Rovers,Bristol Rovers,2-1,2,1,2,2,3,1,H
1955-12-24,1955,Hull City,Liverpool,1-2,1,2,2,2,3,-1,A
1955-12-24,1955,Middlesbrough,Leeds United,5-3,5,3,2,2,8,2,H
1955-12-24,1955,Nottingham Forest,Plymouth Argyle,3-1,3,1,2,2,4,2,H
1955-12-24,1955,Port Vale,Rotherham United,4-1,4,1,2,2,5,3,H
1955-12-24,1955,Sheffield Wednesday,Stoke City,4-0,4,0,2,2,4,4,H
1955-12-24,1955,West Ham United,Swansea City,5-1,5,1,2,2,6,4,H
1955-12-26,1955,Blackburn Rovers,Sheffield Wednesday,2-2,2,2,2,2,4,0,D
1955-12-26,1955,Bristol Rovers,Leicester City,2-1,2,1,2,2,3,1,H
1955-12-26,1955,Fulham,Swansea City,4-1,4,1,2,2,5,3,H
1955-12-26,1955,Leeds United,Notts County,1-0,1,0,2,2,1,1,H
1955-12-26,1955,Lincoln City,Doncaster Rovers,1-1,1,1,2,2,2,0,D
1955-12-26,1955,Liverpool,Stoke City,2-2,2,2,2,2,4,0,D
1955-12-26,1955,Middlesbrough,West Ham United,2-0,2,0,2,2,2,2,H
1955-12-26,1955,Nottingham Forest,Hull City,2-1,2,1,2,2,3,1,H
1955-12-26,1955,Plymouth Argyle,Bristol City,5-0,5,0,2,2,5,5,H
1955-12-26,1955,Port Vale,Barnsley,1-2,1,2,2,2,3,-1,A
1955-12-26,1955,Rotherham United,Bury,1-3,1,3,2,2,4,-2,A
1955-12-27,1955,Barnsley,Port Vale,1-2,1,2,2,2,3,-1,A
1955-12-27,1955,Bristol City,Plymouth Argyle,6-0,6,0,2,2,6,6,H
1955-12-27,1955,Bury,Rotherham United,2-1,2,1,2,2,3,1,H
1955-12-27,1955,Doncaster Rovers,Lincoln City,2-0,2,0,2,2,2,2,H
1955-12-27,1955,Hull City,Nottingham Forest,0-3,0,3,2,2,3,-3,A
1955-12-27,1955,Leicester City,Bristol Rovers,4-2,4,2,2,2,6,2,H
1955-12-27,1955,Notts County,Leeds United,2-1,2,1,2,2,3,1,H
1955-12-27,1955,Sheffield Wednesday,Blackburn Rovers,5-1,5,1,2,2,6,4,H
1955-12-27,1955,Stoke City,Liverpool,3-2,3,2,2,2,5,1,H
1955-12-27,1955,Swansea City,Fulham,2-0,2,0,2,2,2,2,H
1955-12-27,1955,West Ham United,Middlesbrough,1-0,1,0,2,2,1,1,H
1955-12-31,1955,Bristol Rovers,Sheffield Wednesday,4-2,4,2,2,2,6,2,H
1955-12-31,1955,Bury,Barnsley,3-0,3,0,2,2,3,3,H
1955-12-31,1955,Fulham,Middlesbrough,4-1,4,1,2,2,5,3,H
1955-12-31,1955,Leeds United,Bristol City,2-1,2,1,2,2,3,1,H
1955-12-31,1955,Leicester City,Lincoln City,4-0,4,0,2,2,4,4,H
1955-12-31,1955,Liverpool,Blackburn Rovers,1-2,1,2,2,2,3,-1,A
1955-12-31,1955,Notts County,West Ham United,0-1,0,1,2,2,1,-1,A
1955-12-31,1955,Plymouth Argyle,Hull City,1-1,1,1,2,2,2,0,D
1955-12-31,1955,Rotherham United,Doncaster Rovers,3-3,3,3,2,2,6,0,D
1955-12-31,1955,Stoke City,Nottingham Forest,1-1,1,1,2,2,2,0,D
1955-12-31,1955,Swansea City,Port Vale,0-0,0,0,2,2,0,0,D
1956-01-02,1955,Blackburn Rovers,Nottingham Forest,2-2,2,2,2,2,4,0,D
1956-01-02,1955,Middlesbrough,Port Vale,1-1,1,1,2,2,2,0,D
1956-01-14,1955,Barnsley,Leicester City,0-1,0,1,2,2,1,-1,A
1956-01-14,1955,Blackburn Rovers,Plymouth Argyle,2-1,2,1,2,2,3,1,H
1956-01-14,1955,Bristol City,Fulham,2-1,2,1,2,2,3,1,H
1956-01-14,1955,Middlesbrough,Bury,1-3,1,3,2,2,4,-2,A
1956-01-14,1955,Nottingham Forest,Bristol Rovers,1-1,1,1,2,2,2,0,D
1956-01-14,1955,Port Vale,Notts County,3-1,3,1,2,2,4,2,H
1956-01-14,1955,Sheffield Wednesday,Doncaster Rovers,5-2,5,2,2,2,7,3,H
1956-01-14,1955,West Ham United,Leeds United,1-1,1,1,2,2,2,0,D
1956-01-21,1955,Barnsley,Middlesbrough,0-4,0,4,2,2,4,-4,A
1956-01-21,1955,Bristol Rovers,Hull City,4-2,4,2,2,2,6,2,H
1956-01-21,1955,Bury,Bristol City,1-1,1,1,2,2,2,0,D
1956-01-21,1955,Doncaster Rovers,Nottingham Forest,1-3,1,3,2,2,4,-2,A
1956-01-21,1955,Fulham,West Ham United,3-1,3,1,2,2,4,2,H
1956-01-21,1955,Leeds United,Port Vale,1-1,1,1,2,2,2,0,D
1956-01-21,1955,Liverpool,Leicester City,3-1,3,1,2,2,4,2,H
1956-01-21,1955,Notts County,Rotherham United,1-2,1,2,2,2,3,-1,A
1956-01-21,1955,Plymouth Argyle,Lincoln City,1-4,1,4,2,2,5,-3,A
1956-01-21,1955,Stoke City,Blackburn Rovers,1-2,1,2,2,2,3,-1,A
1956-01-21,1955,Swansea City,Sheffield Wednesday,2-1,2,1,2,2,3,1,H
1956-02-04,1955,Blackburn Rovers,Bristol Rovers,2-0,2,0,2,2,2,2,H
1956-02-04,1955,Bristol City,Barnsley,2-0,2,0,2,2,2,2,H
1956-02-04,1955,Leicester City,Plymouth Argyle,5-1,5,1,2,2,6,4,H
1956-02-04,1955,Middlesbrough,Liverpool,1-2,1,2,2,2,3,-1,A
1956-02-04,1955,Nottingham Forest,Sheffield Wednesday,0-1,0,1,2,2,1,-1,A
1956-02-04,1955,Port Vale,Fulham,2-1,2,1,2,2,3,1,H
1956-02-04,1955,Swansea City,Notts County,5-1,5,1,2,2,6,4,H
1956-02-11,1955,Barnsley,West Ham United,1-1,1,1,2,2,2,0,D
1956-02-11,1955,Bristol Rovers,Lincoln City,3-0,3,0,2,2,3,3,H
1956-02-11,1955,Bury,Port Vale,2-2,2,2,2,2,4,0,D
1956-02-11,1955,Doncaster Rovers,Blackburn Rovers,2-2,2,2,2,2,4,0,D
1956-02-11,1955,Fulham,Rotherham United,1-1,1,1,2,2,2,0,D
1956-02-11,1955,Leeds United,Swansea City,2-2,2,2,2,2,4,0,D
1956-02-11,1955,Middlesbrough,Bristol City,2-1,2,1,2,2,3,1,H
1956-02-11,1955,Notts County,Nottingham Forest,1-3,1,3,2,2,4,-2,A
1956-02-11,1955,Plymouth Argyle,Liverpool,4-0,4,0,2,2,4,4,H
1956-02-11,1955,Sheffield Wednesday,Hull City,4-1,4,1,2,2,5,3,H
1956-02-11,1955,Stoke City,Leicester City,2-0,2,0,2,2,2,2,H
1956-02-18,1955,Bristol Rovers,Barnsley,1-1,1,1,2,2,2,0,D
1956-02-18,1955,Hull City,Port Vale,2-1,2,1,2,2,3,1,H
1956-02-18,1955,Leicester City,Notts County,4-0,4,0,2,2,4,4,H
1956-02-18,1955,Lincoln City,Swansea City,3-1,3,1,2,2,4,2,H
1956-02-18,1955,Plymouth Argyle,Fulham,0-0,0,0,2,2,0,0,D
1956-02-18,1955,Sheffield Wednesday,Bristol City,2-1,2,1,2,2,3,1,H
1956-02-25,1955,Barnsley,Blackburn Rovers,2-1,2,1,2,2,3,1,H
1956-02-25,1955,Bristol City,Leicester City,1-1,1,1,2,2,2,0,D
1956-02-25,1955,Bury,Hull City,3-2,3,2,2,2,5,1,H
1956-02-25,1955,Leeds United,Sheffield Wednesday,2-1,2,1,2,2,3,1,H
1956-02-25,1955,Notts County,Doncaster Rovers,3-2,3,2,2,2,5,1,H
1956-02-25,1955,Port Vale,Plymouth Argyle,3-1,3,1,2,2,4,2,H
1956-02-25,1955,Swansea City,Bristol Rovers,1-2,1,2,2,2,3,-1,A
1956-02-25,1955,West Ham United,Liverpool,2-0,2,0,2,2,2,2,H
1956-02-29,1955,Liverpool,Leeds United,1-0,1,0,2,2,1,1,H
1956-03-03,1955,Blackburn Rovers,Notts County,2-0,2,0,2,2,2,2,H
1956-03-03,1955,Bristol Rovers,Bristol City,0-3,0,3,2,2,3,-3,A
1956-03-03,1955,Hull City,Swansea City,1-4,1,4,2,2,5,-3,A
1956-03-03,1955,Leicester City,Fulham,2-1,2,1,2,2,3,1,H
1956-03-03,1955,Lincoln City,Leeds United,1-1,1,1,2,2,2,0,D
1956-03-03,1955,Liverpool,Bury,4-2,4,2,2,2,6,2,H
1956-03-03,1955,Nottingham Forest,Rotherham United,1-0,1,0,2,2,1,1,H
1956-03-03,1955,Plymouth Argyle,Barnsley,3-0,3,0,2,2,3,3,H
1956-03-03,1955,Sheffield Wednesday,Port Vale,4-0,4,0,2,2,4,4,H
1956-03-03,1955,Stoke City,Middlesbrough,2-5,2,5,2,2,7,-3,A
1956-03-10,1955,Barnsley,Liverpool,0-5,0,5,2,2,5,-5,A
1956-03-10,1955,Bristol City,Stoke City,0-1,0,1,2,2,1,-1,A
1956-03-10,1955,Bury,Leicester City,3-1,3,1,2,2,4,2,H
1956-03-10,1955,Fulham,Lincoln City,3-0,3,0,2,2,3,3,H
1956-03-10,1955,Leeds United,Blackburn Rovers,1-2,1,2,2,2,3,-1,A
1956-03-10,1955,Middlesbrough,Plymouth Argyle,1-2,1,2,2,2,3,-1,A
1956-03-10,1955,Notts County,Hull City,0-2,0,2,2,2,2,-2,A
1956-03-10,1955,Port Vale,Doncaster Rovers,2-0,2,0,2,2,2,2,H
1956-03-10,1955,Rotherham United,Sheffield Wednesday,2-3,2,3,2,2,5,-1,A
1956-03-10,1955,Swansea City,Nottingham Forest,0-1,0,1,2,2,1,-1,A
1956-03-10,1955,West Ham United,Bristol Rovers,2-1,2,1,2,2,3,1,H
1956-03-17,1955,Blackburn Rovers,West Ham United,4-1,4,1,2,2,5,3,H
1956-03-17,1955,Bristol Rovers,Fulham,2-2,2,2,2,2,4,0,D
1956-03-17,1955,Doncaster Rovers,Bury,2-3,2,3,2,2,5,-1,A
1956-03-17,1955,Hull City,Bristol City,1-3,1,3,2,2,4,-2,A
1956-03-17,1955,Leicester City,Rotherham United,3-1,3,1,2,2,4,2,H
1956-03-17,1955,Lincoln City,Port Vale,1-0,1,0,2,2,1,1,H
1956-03-17,1955,Liverpool,Swansea City,4-1,4,1,2,2,5,3,H
1956-03-17,1955,Nottingham Forest,Middlesbrough,2-4,2,4,2,2,6,-2,A
1956-03-17,1955,Plymouth Argyle,Notts County,1-1,1,1,2,2,2,0,D
1956-03-17,1955,Stoke City,Leeds United,2-1,2,1,2,2,3,1,H
1956-03-19,1955,West Ham United,Bury,3-2,3,2,2,2,5,1,H
1956-03-21,1955,Sheffield Wednesday,Barnsley,3-0,3,0,2,2,3,3,H
1956-03-24,1955,Barnsley,Doncaster Rovers,2-2,2,2,2,2,4,0,D
1956-03-24,1955,Bristol City,Nottingham Forest,0-0,0,0,2,2,0,0,D
1956-03-24,1955,Bury,Bristol Rovers,0-1,0,1,2,2,1,-1,A
1956-03-24,1955,Fulham,Stoke City,2-0,2,0,2,2,2,2,H
1956-03-24,1955,Leeds United,Plymouth Argyle,4-2,4,2,2,2,6,2,H
1956-03-24,1955,Middlesbrough,Sheffield Wednesday,2-2,2,2,2,2,4,0,D
1956-03-24,1955,Notts County,Liverpool,2-1,2,1,2,2,3,1,H
1956-03-24,1955,Port Vale,Blackburn Rovers,4-1,4,1,2,2,5,3,H
1956-03-24,1955,Rotherham United,Lincoln City,2-2,2,2,2,2,4,0,D
1956-03-24,1955,Swansea City,Leicester City,6-1,6,1,2,2,7,5,H
1956-03-24,1955,West Ham United,Hull City,1-1,1,1,2,2,2,0,D
1956-03-26,1955,Doncaster Rovers,West Ham United,2-1,2,1,2,2,3,1,H
1956-03-30,1955,Blackburn Rovers,Hull City,2-0,2,0,2,2,2,2,H
1956-03-30,1955,Bristol Rovers,Plymouth Argyle,2-1,2,1,2,2,3,1,H
1956-03-30,1955,Bury,Notts County,4-0,4,0,2,2,4,4,H
1956-03-30,1955,Doncaster Rovers,Liverpool,1-0,1,0,2,2,1,1,H
1956-03-30,1955,Fulham,Leeds United,1-2,1,2,2,2,3,-1,A
1956-03-30,1955,Port Vale,Bristol City,2-0,2,0,2,2,2,2,H
1956-03-30,1955,West Ham United,Stoke City,2-0,2,0,2,2,2,2,H
1956-03-31,1955,Blackburn Rovers,Bury,3-1,3,1,2,2,4,2,H
1956-03-31,1955,Bristol Rovers,Rotherham United,1-4,1,4,2,2,5,-3,A
1956-03-31,1955,Doncaster Rovers,Swansea City,3-1,3,1,2,2,4,2,H
1956-03-31,1955,Hull City,Fulham,2-2,2,2,2,2,4,0,D
1956-03-31,1955,Leicester City,Middlesbrough,1-1,1,1,2,2,2,0,D
1956-03-31,1955,Lincoln City,Barnsley,4-0,4,0,2,2,4,4,H
1956-03-31,1955,Liverpool,Bristol City,2-1,2,1,2,2,3,1,H
1956-03-31,1955,Nottingham Forest,Leeds United,2-0,2,0,2,2,2,2,H
1956-03-31,1955,Plymouth Argyle,West Ham United,0-1,0,1,2,2,1,-1,A
1956-03-31,1955,Sheffield Wednesday,Notts County,1-0,1,0,2,2,1,1,H
1956-03-31,1955,Stoke City,Port Vale,1-1,1,1,2,2,2,0,D
1956-04-02,1955,Barnsley,Swansea City,3-2,3,2,2,2,5,1,H
1956-04-02,1955,Bristol City,Port Vale,0-0,0,0,2,2,0,0,D
1956-04-02,1955,Hull City,Blackburn Rovers,0-3,0,3,2,2,3,-3,A
1956-04-02,1955,Leeds United,Fulham,6-1,6,1,2,2,7,5,H
1956-04-02,1955,Leicester City,Sheffield Wednesday,1-2,1,2,2,2,3,-1,A
1956-04-02,1955,Lincoln City,Nottingham Forest,1-3,1,3,2,2,4,-2,A
1956-04-02,1955,Liverpool,Doncaster Rovers,1-2,1,2,2,2,3,-1,A
1956-04-02,1955,Middlesbrough,Rotherham United,0-1,0,1,2,2,1,-1,A
1956-04-02,1955,Notts County,Bury,2-1,2,1,2,2,3,1,H
1956-04-02,1955,Plymouth Argyle,Bristol Rovers,0-1,0,1,2,2,1,-1,A
1956-04-02,1955,Stoke City,West Ham United,3-0,3,0,2,2,3,3,H
1956-04-03,1955,Nottingham Forest,Lincoln City,2-2,2,2,2,2,4,0,D
1956-04-03,1955,Rotherham United,Middlesbrough,2-1,2,1,2,2,3,1,H
1956-04-07,1955,Barnsley,Stoke City,1-0,1,0,2,2,1,1,H
1956-04-07,1955,Bristol City,Doncaster Rovers,4-1,4,1,2,2,5,3,H
1956-04-07,1955,Bury,Plymouth Argyle,7-1,7,1,2,2,8,6,H
1956-04-07,1955,Fulham,Liverpool,3-1,3,1,2,2,4,2,H
1956-04-07,1955,Leeds United,Leicester City,4-0,4,0,2,2,4,4,H
1956-04-07,1955,Middlesbrough,Bristol Rovers,0-1,0,1,2,2,1,-1,A
1956-04-07,1955,Notts County,Lincoln City,2-2,2,2,2,2,4,0,D
1956-04-07,1955,Port Vale,Nottingham Forest,0-2,0,2,2,2,2,-2,A
1956-04-07,1955,Rotherham United,Hull City,0-2,0,2,2,2,2,-2,A
1956-04-07,1955,Swansea City,Blackburn Rovers,2-1,2,1,2,2,3,1,H
1956-04-07,1955,West Ham United,Sheffield Wednesday,3-3,3,3,2,2,6,0,D
1956-04-10,1955,Hull City,Doncaster Rovers,1-1,1,1,2,2,2,0,D
1956-04-14,1955,Blackburn Rovers,Middlesbrough,2-1,2,1,2,2,3,1,H
1956-04-14,1955,Bristol Rovers,Notts County,2-0,2,0,2,2,2,2,H
1956-04-14,1955,Doncaster Rovers,Leeds United,1-2,1,2,2,2,3,-1,A
1956-04-14,1955,Hull City,Barnsley,4-1,4,1,2,2,5,3,H
1956-04-14,1955,Leicester City,West Ham United,2-1,2,1,2,2,3,1,H
1956-04-14,1955,Lincoln City,Bristol City,2-0,2,0,2,2,2,2,H
1956-04-14,1955,Liverpool,Port Vale,4-1,4,1,2,2,5,3,H
1956-04-14,1955,Nottingham Forest,Bury,0-2,0,2,2,2,2,-2,A
1956-04-14,1955,Plymouth Argyle,Rotherham United,3-1,3,1,2,2,4,2,H
1956-04-14,1955,Sheffield Wednesday,Fulham,2-3,2,3,2,2,5,-1,A
1956-04-14,1955,Stoke City,Swansea City,5-0,5,0,2,2,5,5,H
1956-04-16,1955,Stoke City,Bury,0-2,0,2,2,2,2,-2,A
1956-04-18,1955,Middlesbrough,Lincoln City,4-2,4,2,2,2,6,2,H
1956-04-18,1955,Nottingham Forest,West Ham United,0-0,0,0,2,2,0,0,D
1956-04-21,1955,Barnsley,Nottingham Forest,1-1,1,1,2,2,2,0,D
1956-04-21,1955,Bristol City,Blackburn Rovers,2-0,2,0,2,2,2,2,H
1956-04-21,1955,Bury,Sheffield Wednesday,2-5,2,5,2,2,7,-3,A
1956-04-21,1955,Fulham,Doncaster Rovers,4-0,4,0,2,2,4,4,H
1956-04-21,1955,Leeds United,Bristol Rovers,2-1,2,1,2,2,3,1,H
1956-04-21,1955,Middlesbrough,Hull City,5-1,5,1,2,2,6,4,H
1956-04-21,1955,Notts County,Stoke City,1-3,1,3,2,2,4,-2,A
1956-04-21,1955,Port Vale,Leicester City,2-3,2,3,2,2,5,-1,A
1956-04-21,1955,Rotherham United,Liverpool,0-1,0,1,2,2,1,-1,A
1956-04-21,1955,Swansea City,Plymouth Argyle,2-2,2,2,2,2,4,0,D
1956-04-21,1955,West Ham United,Lincoln City,2-4,2,4,2,2,6,-2,A
1956-04-23,1955,Rotherham United,Leeds United,0-2,0,2,2,2,2,-2,A
1956-04-25,1955,Lincoln City,Stoke City,2-1,2,1,2,2,3,1,H
1956-04-28,1955,Bristol Rovers,Liverpool,1-2,1,2,2,2,3,-1,A
1956-04-28,1955,Hull City,Leeds United,1-4,1,4,2,2,5,-3,A
1956-04-28,1955,Leicester City,Doncaster Rovers,3-0,3,0,2,2,3,3,H
1956-04-28,1955,Nottingham Forest,Blackburn Rovers,1-1,1,1,2,2,2,0,D
1956-04-28,1955,Port Vale,Middlesbrough,3-2,3,2,2,2,5,1,H
1956-04-28,1955,Rotherham United,Stoke City,0-1,0,1,2,2,1,-1,A
1956-04-28,1955,Sheffield Wednesday,Lincoln City,5-3,5,3,2,2,8,2,H
1956-04-28,1955,Swansea City,Barnsley,3-1,3,1,2,2,4,2,H
1956-04-28,1955,West Ham United,Bristol City,3-0,3,0,2,2,3,3,H
1956-04-30,1955,Blackburn Rovers,Rotherham United,3-1,3,1,2,2,4,2,H
1956-05-01,1955,Hull City,Stoke City,3-2,3,2,2,2,5,1,H
1956-05-02,1955,Fulham,Nottingham Forest,4-3,4,3,2,2,7,1,H
1956-05-02,1955,Lincoln City,Liverpool,2-0,2,0,2,2,2,2,H
1956-05-03,1955,Doncaster Rovers,Middlesbrough,0-1,0,1,2,2,1,-1,A
1956-05-03,1955,Rotherham United,Swansea City,2-3,2,3,2,2,5,-1,A
1956-08-18,1956,Bristol Rovers,Grimsby Town,1-0,1,0,2,2,1,1,H
1956-08-18,1956,Fulham,West Ham United,1-4,1,4,2,2,5,-3,A
1956-08-18,1956,Leicester City,Doncaster Rovers,3-1,3,1,2,2,4,2,H
1956-08-18,1956,Leyton Orient,Nottingham Forest,1-4,1,4,2,2,5,-3,A
1956-08-18,1956,Lincoln City,Bristol City,1-1,1,1,2,2,2,0,D
1956-08-18,1956,Liverpool,Huddersfield Town,2-3,2,3,2,2,5,-1,A
1956-08-18,1956,Middlesbrough,Stoke City,1-1,1,1,2,2,2,0,D
1956-08-18,1956,Notts County,Bury,2-2,2,2,2,2,4,0,D
1956-08-18,1956,Port Vale,Barnsley,0-0,0,0,2,2,0,0,D
1956-08-18,1956,Rotherham United,Sheffield United,0-4,0,4,2,2,4,-4,A
1956-08-18,1956,Swansea City,Blackburn Rovers,5-1,5,1,2,2,6,4,H
1956-08-20,1956,Huddersfield Town,Leicester City,1-2,1,2,2,2,3,-1,A
1956-08-20,1956,Sheffield United,Fulham,5-2,5,2,2,2,7,3,H
1956-08-20,1956,Stoke City,Grimsby Town,1-0,1,0,2,2,1,1,H
1956-08-20,1956,West Ham United,Blackburn Rovers,1-3,1,3,2,2,4,-2,A
1956-08-21,1956,Bristol City,Nottingham Forest,1-5,1,5,2,2,6,-4,A
1956-08-21,1956,Bury,Middlesbrough,3-2,3,2,2,2,5,1,H
1956-08-22,1956,Barnsley,Swansea City,2-3,2,3,2,2,5,-1,A
1956-08-22,1956,Doncaster Rovers,Rotherham United,1-1,1,1,2,2,2,0,D
1956-08-22,1956,Lincoln City,Port Vale,4-0,4,0,2,2,4,4,H
1956-08-23,1956,Leyton Orient,Bristol Rovers,1-1,1,1,2,2,2,0,D
1956-08-23,1956,Notts County,Liverpool,1-1,1,1,2,2,2,0,D
1956-08-25,1956,Barnsley,Middlesbrough,1-3,1,3,2,2,4,-2,A
1956-08-25,1956,Blackburn Rovers,Lincoln City,3-4,3,4,2,2,7,-1,A
1956-08-25,1956,Bristol City,Rotherham United,2-1,2,1,2,2,3,1,H
1956-08-25,1956,Bury,Liverpool,0-2,0,2,2,2,2,-2,A
1956-08-25,1956,Doncaster Rovers,Bristol Rovers,2-4,2,4,2,2,6,-2,A
1956-08-25,1956,Grimsby Town,Notts County,2-1,2,1,2,2,3,1,H
1956-08-25,1956,Huddersfield Town,Leyton Orient,3-0,3,0,2,2,3,3,H
1956-08-25,1956,Nottingham Forest,Fulham,3-1,3,1,2,2,4,2,H
1956-08-25,1956,Sheffield United,Port Vale,4-2,4,2,2,2,6,2,H
1956-08-25,1956,Stoke City,Leicester City,3-1,3,1,2,2,4,2,H
1956-08-25,1956,West Ham United,Swansea City,1-2,1,2,2,2,3,-1,A
1956-08-27,1956,Blackburn Rovers,West Ham United,0-2,0,2,2,2,2,-2,A
1956-08-27,1956,Bristol Rovers,Leyton Orient,3-2,3,2,2,2,5,1,H
1956-08-27,1956,Port Vale,Lincoln City,1-1,1,1,2,2,2,0,D
1956-08-27,1956,Rotherham United,Doncaster Rovers,0-1,0,1,2,2,1,-1,A
1956-08-28,1956,Grimsby Town,Stoke City,4-1,4,1,2,2,5,3,H
1956-08-29,1956,Fulham,Sheffield United,1-2,1,2,2,2,3,-1,A
1956-08-29,1956,Leicester City,Huddersfield Town,2-2,2,2,2,2,4,0,D
1956-08-29,1956,Liverpool,Notts County,3-3,3,3,2,2,6,0,D
1956-08-29,1956,Middlesbrough,Bury,2-2,2,2,2,2,4,0,D
1956-08-30,1956,Nottingham Forest,Bristol City,2-2,2,2,2,2,4,0,D
1956-08-30,1956,Swansea City,Barnsley,2-3,2,3,2,2,5,-1,A
1956-09-01,1956,Barnsley,Sheffield United,1-6,1,6,2,2,7,-5,A
1956-09-01,1956,Bristol Rovers,Stoke City,4-0,4,0,2,2,4,4,H
1956-09-01,1956,Fulham,Huddersfield Town,1-0,1,0,2,2,1,1,H
1956-09-01,1956,Leicester City,Middlesbrough,1-1,1,1,2,2,2,0,D
1956-09-01,1956,Leyton Orient,Bury,4-3,4,3,2,2,7,1,H
1956-09-01,1956,Lincoln City,West Ham United,0-2,0,2,2,2,2,-2,A
1956-09-01,1956,Liverpool,Grimsby Town,3-2,3,2,2,2,5,1,H
1956-09-01,1956,Notts County,Doncaster Rovers,1-2,1,2,2,2,3,-1,A
1956-09-01,1956,Port Vale,Bristol City,3-1,3,1,2,2,4,2,H
1956-09-01,1956,Rotherham United,Blackburn Rovers,0-2,0,2,2,2,2,-2,A
1956-09-01,1956,Swansea City,Nottingham Forest,1-4,1,4,2,2,5,-3,A
1956-09-03,1956,Huddersfield Town,Bristol Rovers,2-1,2,1,2,2,3,1,H
1956-09-03,1956,Stoke City,Doncaster Rovers,1-1,1,1,2,2,2,0,D
1956-09-03,1956,West Ham United,Liverpool,1-1,1,1,2,2,2,0,D
1956-09-04,1956,Bristol City,Fulham,0-3,0,3,2,2,3,-3,A
1956-09-04,1956,Grimsby Town,Middlesbrough,3-2,3,2,2,2,5,1,H
1956-09-05,1956,Barnsley,Lincoln City,5-2,5,2,2,2,7,3,H
1956-09-06,1956,Nottingham Forest,Blackburn Rovers,2-1,2,1,2,2,3,1,H
1956-09-08,1956,Blackburn Rovers,Port Vale,2-4,2,4,2,2,6,-2,A
1956-09-08,1956,Bristol City,Barnsley,1-2,1,2,2,2,3,-1,A
1956-09-08,1956,Bury,Huddersfield Town,1-3,1,3,2,2,4,-2,A
1956-09-08,1956,Doncaster Rovers,Liverpool,1-1,1,1,2,2,2,0,D
1956-09-08,1956,Fulham,Swansea City,7-3,7,3,2,2,10,4,H
1956-09-08,1956,Grimsby Town,Leyton Orient,0-0,0,0,2,2,0,0,D
1956-09-08,1956,Middlesbrough,Bristol Rovers,3-2,3,2,2,2,5,1,H
1956-09-08,1956,Nottingham Forest,Lincoln City,1-1,1,1,2,2,2,0,D
1956-09-08,1956,Sheffield United,Leicester City,1-1,1,1,2,2,2,0,D
1956-09-08,1956,Stoke City,Notts County,6-0,6,0,2,2,6,6,H
1956-09-08,1956,West Ham United,Rotherham United,1-1,1,1,2,2,2,0,D
1956-09-10,1956,Bristol Rovers,Huddersfield Town,4-0,4,0,2,2,4,4,H
1956-09-10,1956,Doncaster Rovers,Stoke City,4-0,4,0,2,2,4,4,H
1956-09-12,1956,Fulham,Bristol City,2-1,2,1,2,2,3,1,H
1956-09-12,1956,Leicester City,Bury,3-0,3,0,2,2,3,3,H
1956-09-12,1956,Middlesbrough,Grimsby Town,2-1,2,1,2,2,3,1,H
1956-09-13,1956,Notts County,Leyton Orient,1-3,1,3,2,2,4,-2,A
1956-09-13,1956,Swansea City,Sheffield United,4-1,4,1,2,2,5,3,H
1956-09-15,1956,Barnsley,Blackburn Rovers,3-3,3,3,2,2,6,0,D
1956-09-15,1956,Bristol Rovers,Leicester City,1-2,1,2,2,2,3,-1,A
1956-09-15,1956,Huddersfield Town,Grimsby Town,2-1,2,1,2,2,3,1,H
1956-09-15,1956,Leyton Orient,Doncaster Rovers,1-1,1,1,2,2,2,0,D
1956-09-15,1956,Lincoln City,Fulham,1-0,1,0,2,2,1,1,H
1956-09-15,1956,Liverpool,Stoke City,0-2,0,2,2,2,2,-2,A
1956-09-15,1956,Notts County,Middlesbrough,2-1,2,1,2,2,3,1,H
1956-09-15,1956,Port Vale,West Ham United,0-0,0,0,2,2,0,0,D
1956-09-15,1956,Rotherham United,Nottingham Forest,3-2,3,2,2,2,5,1,H
1956-09-15,1956,Sheffield United,Bristol City,1-1,1,1,2,2,2,0,D
1956-09-15,1956,Swansea City,Bury,3-0,3,0,2,2,3,3,H
1956-09-17,1956,Bury,Leicester City,4-5,4,5,2,2,9,-1,A
1956-09-22,1956,Blackburn Rovers,Sheffield United,3-1,3,1,2,2,4,2,H
1956-09-22,1956,Bristol City,Bristol Rovers,5-3,5,3,2,2,8,2,H
1956-09-22,1956,Doncaster Rovers,Huddersfield Town,4-0,4,0,2,2,4,4,H
1956-09-22,1956,Fulham,Rotherham United,3-1,3,1,2,2,4,2,H
1956-09-22,1956,Grimsby Town,Bury,0-1,0,1,2,2,1,-1,A
1956-09-22,1956,Leicester City,Notts County,6-3,6,3,2,2,9,3,H
1956-09-22,1956,Middlesbrough,Liverpool,1-1,1,1,2,2,2,0,D
1956-09-22,1956,Nottingham Forest,Port Vale,4-2,4,2,2,2,6,2,H
1956-09-22,1956,Stoke City,Leyton Orient,7-1,7,1,2,2,8,6,H
1956-09-22,1956,Swansea City,Lincoln City,1-2,1,2,2,2,3,-1,A
1956-09-22,1956,West Ham United,Barnsley,2-0,2,0,2,2,2,2,H
1956-09-29,1956,Barnsley,Nottingham Forest,1-1,1,1,2,2,2,0,D
1956-09-29,1956,Bristol City,Blackburn Rovers,3-0,3,0,2,2,3,3,H
1956-09-29,1956,Bury,Doncaster Rovers,4-4,4,4,2,2,8,0,D
1956-09-29,1956,Huddersfield Town,Stoke City,2-2,2,2,2,2,4,0,D
1956-09-29,1956,Leyton Orient,Middlesbrough,1-1,1,1,2,2,2,0,D
1956-09-29,1956,Lincoln City,Grimsby Town,1-0,1,0,2,2,1,1,H
1956-09-29,1956,Liverpool,Leicester City,2-0,2,0,2,2,2,2,H
1956-09-29,1956,Notts County,Bristol Rovers,0-2,0,2,2,2,2,-2,A
1956-09-29,1956,Port Vale,Fulham,2-1,2,1,2,2,3,1,H
1956-09-29,1956,Rotherham United,Swansea City,6-1,6,1,2,2,7,5,H
1956-09-29,1956,Sheffield United,West Ham United,1-0,1,0,2,2,1,1,H
1956-10-06,1956,Bristol Rovers,Sheffield United,3-1,3,1,2,2,4,2,H
1956-10-06,1956,Bury,Fulham,0-1,0,1,2,2,1,-1,A
1956-10-06,1956,Doncaster Rovers,Lincoln City,3-1,3,1,2,2,4,2,H
1956-10-06,1956,Grimsby Town,Swansea City,5-0,5,0,2,2,5,5,H
1956-10-06,1956,Huddersfield Town,Nottingham Forest,1-0,1,0,2,2,1,1,H
1956-10-06,1956,Leicester City,Barnsley,5-2,5,2,2,2,7,3,H
1956-10-06,1956,Leyton Orient,West Ham United,1-2,1,2,2,2,3,-1,A
1956-10-06,1956,Liverpool,Blackburn Rovers,2-3,2,3,2,2,5,-1,A
1956-10-06,1956,Middlesbrough,Port Vale,3-1,3,1,2,2,4,2,H
1956-10-06,1956,Notts County,Bristol City,1-1,1,1,2,2,2,0,D
1956-10-06,1956,Stoke City,Rotherham United,6-0,6,0,2,2,6,6,H
1956-10-10,1956,Stoke City,Port Vale,3-1,3,1,2,2,4,2,H
1956-10-13,1956,Barnsley,Bristol Rovers,0-2,0,2,2,2,2,-2,A
1956-10-13,1956,Blackburn Rovers,Leyton Orient,3-3,3,3,2,2,6,0,D
1956-10-13,1956,Bristol City,Liverpool,2-1,2,1,2,2,3,1,H
1956-10-13,1956,Fulham,Grimsby Town,3-1,3,1,2,2,4,2,H
1956-10-13,1956,Lincoln City,Stoke City,0-1,0,1,2,2,1,-1,A
1956-10-13,1956,Nottingham Forest,Bury,5-1,5,1,2,2,6,4,H
1956-10-13,1956,Port Vale,Leicester City,2-3,2,3,2,2,5,-1,A
1956-10-13,1956,Rotherham United,Middlesbrough,2-3,2,3,2,2,5,-1,A
1956-10-13,1956,Sheffield United,Notts County,5-1,5,1,2,2,6,4,H
1956-10-13,1956,Swansea City,Doncaster Rovers,4-2,4,2,2,2,6,2,H
1956-10-13,1956,West Ham United,Huddersfield Town,0-2,0,2,2,2,2,-2,A
1956-10-20,1956,Bristol Rovers,West Ham United,1-1,1,1,2,2,2,0,D
1956-10-20,1956,Bury,Rotherham United,1-4,1,4,2,2,5,-3,A
1956-10-20,1956,Doncaster Rovers,Barnsley,5-2,5,2,2,2,7,3,H
1956-10-20,1956,Grimsby Town,Port Vale,1-0,1,0,2,2,1,1,H
1956-10-20,1956,Huddersfield Town,Lincoln City,0-1,0,1,2,2,1,-1,A
1956-10-20,1956,Leicester City,Blackburn Rovers,6-0,6,0,2,2,6,6,H
1956-10-20,1956,Leyton Orient,Swansea City,3-0,3,0,2,2,3,3,H
1956-10-20,1956,Liverpool,Fulham,4-3,4,3,2,2,7,1,H
1956-10-20,1956,Middlesbrough,Bristol City,4-1,4,1,2,2,5,3,H
1956-10-20,1956,Notts County,Nottingham Forest,1-2,1,2,2,2,3,-1,A
1956-10-20,1956,Stoke City,Sheffield United,3-3,3,3,2,2,6,0,D
1956-10-27,1956,Barnsley,Liverpool,4-1,4,1,2,2,5,3,H
1956-10-27,1956,Blackburn Rovers,Bury,6-2,6,2,2,2,8,4,H
1956-10-27,1956,Bristol City,Huddersfield Town,2-1,2,1,2,2,3,1,H
1956-10-27,1956,Fulham,Stoke City,1-0,1,0,2,2,1,1,H
1956-10-27,1956,Lincoln City,Leicester City,2-3,2,3,2,2,5,-1,A
1956-10-27,1956,Nottingham Forest,Doncaster Rovers,2-1,2,1,2,2,3,1,H
1956-10-27,1956,Port Vale,Notts County,1-2,1,2,2,2,3,-1,A
1956-10-27,1956,Rotherham United,Bristol Rovers,0-0,0,0,2,2,0,0,D
1956-10-27,1956,Sheffield United,Leyton Orient,2-3,2,3,2,2,5,-1,A
1956-10-27,1956,Swansea City,Middlesbrough,2-2,2,2,2,2,4,0,D
1956-10-27,1956,West Ham United,Grimsby Town,0-1,0,1,2,2,1,-1,A
1956-11-03,1956,Bristol Rovers,Lincoln City,0-1,0,1,2,2,1,-1,A
1956-11-03,1956,Bury,Bristol City,2-3,2,3,2,2,5,-1,A
1956-11-03,1956,Doncaster Rovers,West Ham United,3-0,3,0,2,2,3,3,H
1956-11-03,1956,Grimsby Town,Blackburn Rovers,1-3,1,3,2,2,4,-2,A
1956-11-03,1956,Huddersfield Town,Sheffield United,1-4,1,4,2,2,5,-3,A
1956-11-03,1956,Leicester City,Swansea City,1-1,1,1,2,2,2,0,D
1956-11-03,1956,Leyton Orient,Barnsley,2-0,2,0,2,2,2,2,H
1956-11-03,1956,Liverpool,Port Vale,4-1,4,1,2,2,5,3,H
1956-11-03,1956,Middlesbrough,Fulham,3-1,3,1,2,2,4,2,H
1956-11-03,1956,Notts County,Rotherham United,1-5,1,5,2,2,6,-4,A
1956-11-03,1956,Stoke City,Nottingham Forest,2-1,2,1,2,2,3,1,H
1956-11-10,1956,Barnsley,Huddersfield Town,0-5,0,5,2,2,5,-5,A
1956-11-10,1956,Blackburn Rovers,Doncaster Rovers,2-2,2,2,2,2,4,0,D
1956-11-10,1956,Bristol City,Grimsby Town,0-2,0,2,2,2,2,-2,A
1956-11-10,1956,Fulham,Leicester City,2-2,2,2,2,2,4,0,D
1956-11-10,1956,Lincoln City,Notts County,1-0,1,0,2,2,1,1,H
1956-11-10,1956,Nottingham Forest,Middlesbrough,0-4,0,4,2,2,4,-4,A
1956-11-10,1956,Port Vale,Leyton Orient,1-2,1,2,2,2,3,-1,A
1956-11-10,1956,Rotherham United,Liverpool,2-2,2,2,2,2,4,0,D
1956-11-10,1956,Sheffield United,Bury,1-1,1,1,2,2,2,0,D
1956-11-10,1956,Swansea City,Bristol Rovers,2-3,2,3,2,2,5,-1,A
1956-11-10,1956,West Ham United,Stoke City,1-0,1,0,2,2,1,1,H
1956-11-17,1956,Bristol Rovers,Fulham,4-0,4,0,2,2,4,4,H
1956-11-17,1956,Bury,Barnsley,1-2,1,2,2,2,3,-1,A
1956-11-17,1956,Doncaster Rovers,Bristol City,4-1,4,1,2,2,5,3,H
1956-11-17,1956,Grimsby Town,Sheffield United,1-2,1,2,2,2,3,-1,A
1956-11-17,1956,Huddersfield Town,Port Vale,3-1,3,1,2,2,4,2,H
1956-11-17,1956,Leicester City,Nottingham Forest,0-0,0,0,2,2,0,0,D
1956-11-17,1956,Leyton Orient,Rotherham United,2-1,2,1,2,2,3,1,H
1956-11-17,1956,Liverpool,Lincoln City,4-0,4,0,2,2,4,4,H
1956-11-17,1956,Middlesbrough,West Ham United,3-1,3,1,2,2,4,2,H
1956-11-17,1956,Notts County,Swansea City,1-4,1,4,2,2,5,-3,A
1956-11-17,1956,Stoke City,Blackburn Rovers,4-1,4,1,2,2,5,3,H
1956-11-24,1956,Barnsley,Grimsby Town,2-0,2,0,2,2,2,2,H
1956-11-24,1956,Blackburn Rovers,Middlesbrough,1-0,1,0,2,2,1,1,H
1956-11-24,1956,Bristol City,Stoke City,1-2,1,2,2,2,3,-1,A
1956-11-24,1956,Fulham,Notts County,5-1,5,1,2,2,6,4,H
1956-11-24,1956,Lincoln City,Leyton Orient,0-2,0,2,2,2,2,-2,A
1956-11-24,1956,Nottingham Forest,Bristol Rovers,1-1,1,1,2,2,2,0,D
1956-11-24,1956,Port Vale,Bury,3-2,3,2,2,2,5,1,H
1956-11-24,1956,Rotherham United,Huddersfield Town,3-3,3,3,2,2,6,0,D
1956-11-24,1956,Sheffield United,Doncaster Rovers,4-0,4,0,2,2,4,4,H
1956-11-24,1956,Swansea City,Liverpool,1-1,1,1,2,2,2,0,D
1956-11-24,1956,West Ham United,Leicester City,2-1,2,1,2,2,3,1,H
1956-12-01,1956,Bristol Rovers,Port Vale,2-1,2,1,2,2,3,1,H
1956-12-01,1956,Bury,West Ham United,3-3,3,3,2,2,6,0,D
1956-12-01,1956,Doncaster Rovers,Fulham,4-0,4,0,2,2,4,4,H
1956-12-01,1956,Grimsby Town,Nottingham Forest,0-0,0,0,2,2,0,0,D
1956-12-01,1956,Huddersfield Town,Blackburn Rovers,0-2,0,2,2,2,2,-2,A
1956-12-01,1956,Leicester City,Rotherham United,5-2,5,2,2,2,7,3,H
1956-12-01,1956,Leyton Orient,Bristol City,2-2,2,2,2,2,4,0,D
1956-12-01,1956,Liverpool,Sheffield United,5-1,5,1,2,2,6,4,H
1956-12-01,1956,Middlesbrough,Lincoln City,3-0,3,0,2,2,3,3,H
1956-12-01,1956,Notts County,Barnsley,3-2,3,2,2,2,5,1,H
1956-12-01,1956,Stoke City,Swansea City,4-1,4,1,2,2,5,3,H
1956-12-08,1956,Barnsley,Stoke City,2-2,2,2,2,2,4,0,D
1956-12-08,1956,Blackburn Rovers,Bristol Rovers,2-0,2,0,2,2,2,2,H
1956-12-08,1956,Bristol City,Leicester City,0-2,0,2,2,2,2,-2,A
1956-12-08,1956,Fulham,Leyton Orient,3-1,3,1,2,2,4,2,H
1956-12-08,1956,Lincoln City,Bury,2-0,2,0,2,2,2,2,H
1956-12-08,1956,Nottingham Forest,Liverpool,1-0,1,0,2,2,1,1,H
1956-12-08,1956,Port Vale,Doncaster Rovers,4-1,4,1,2,2,5,3,H
1956-12-08,1956,Rotherham United,Grimsby Town,2-1,2,1,2,2,3,1,H
1956-12-08,1956,Sheffield United,Middlesbrough,2-1,2,1,2,2,3,1,H
1956-12-08,1956,Swansea City,Huddersfield Town,4-2,4,2,2,2,6,2,H
1956-12-08,1956,West Ham United,Notts County,2-1,2,1,2,2,3,1,H
1956-12-15,1956,Barnsley,Port Vale,2-0,2,0,2,2,2,2,H
1956-12-15,1956,Blackburn Rovers,Swansea City,5-3,5,3,2,2,8,2,H
1956-12-15,1956,Bristol City,Lincoln City,5-1,5,1,2,2,6,4,H
1956-12-15,1956,Bury,Notts County,2-1,2,1,2,2,3,1,H
1956-12-15,1956,Doncaster Rovers,Leicester City,0-2,0,2,2,2,2,-2,A
1956-12-15,1956,Grimsby Town,Bristol Rovers,3-2,3,2,2,2,5,1,H
1956-12-15,1956,Huddersfield Town,Liverpool,0-3,0,3,2,2,3,-3,A
1956-12-15,1956,Nottingham Forest,Leyton Orient,1-2,1,2,2,2,3,-1,A
1956-12-15,1956,Sheffield United,Rotherham United,2-7,2,7,2,2,9,-5,A
1956-12-15,1956,Stoke City,Middlesbrough,3-1,3,1,2,2,4,2,H
1956-12-15,1956,West Ham United,Fulham,2-1,2,1,2,2,3,1,H
1956-12-22,1956,Bristol Rovers,Doncaster Rovers,6-1,6,1,2,2,7,5,H
1956-12-22,1956,Fulham,Nottingham Forest,0-1,0,1,2,2,1,-1,A
1956-12-22,1956,Leicester City,Stoke City,3-2,3,2,2,2,5,1,H
1956-12-22,1956,Leyton Orient,Huddersfield Town,3-1,3,1,2,2,4,2,H
1956-12-22,1956,Lincoln City,Blackburn Rovers,1-2,1,2,2,2,3,-1,A
1956-12-22,1956,Liverpool,Bury,2-0,2,0,2,2,2,2,H
1956-12-22,1956,Middlesbrough,Barnsley,1-2,1,2,2,2,3,-1,A
1956-12-22,1956,Notts County,Grimsby Town,0-1,0,1,2,2,1,-1,A
1956-12-22,1956,Rotherham United,Bristol City,6-1,6,1,2,2,7,5,H
1956-12-22,1956,Swansea City,West Ham United,3-1,3,1,2,2,4,2,H
1956-12-24,1956,Notts County,Huddersfield Town,1-2,1,2,2,2,3,-1,A
1956-12-25,1956,Blackburn Rovers,Fulham,2-0,2,0,2,2,2,2,H
1956-12-25,1956,Bury,Bristol Rovers,7-2,7,2,2,2,9,5,H
1956-12-25,1956,Grimsby Town,Leicester City,2-2,2,2,2,2,4,0,D
1956-12-25,1956,Liverpool,Leyton Orient,1-0,1,0,2,2,1,1,H
1956-12-25,1956,Middlesbrough,Doncaster Rovers,3-2,3,2,2,2,5,1,H
1956-12-25,1956,Rotherham United,Barnsley,0-0,0,0,2,2,0,0,D
1956-12-25,1956,Sheffield United,Lincoln City,2-0,2,0,2,2,2,2,H
1956-12-25,1956,West Ham United,Nottingham Forest,2-1,2,1,2,2,3,1,H
1956-12-26,1956,Barnsley,Rotherham United,1-1,1,1,2,2,2,0,D
1956-12-26,1956,Bristol Rovers,Bury,6-1,6,1,2,2,7,5,H
1956-12-26,1956,Doncaster Rovers,Middlesbrough,2-1,2,1,2,2,3,1,H
1956-12-26,1956,Fulham,Blackburn Rovers,7-2,7,2,2,2,9,5,H
1956-12-26,1956,Huddersfield Town,Notts County,3-0,3,0,2,2,3,3,H
1956-12-26,1956,Leyton Orient,Liverpool,0-4,0,4,2,2,4,-4,A
1956-12-26,1956,Lincoln City,Sheffield United,4-1,4,1,2,2,5,3,H
1956-12-26,1956,Swansea City,Bristol City,5-0,5,0,2,2,5,5,H
1956-12-29,1956,Blackburn Rovers,Rotherham United,3-2,3,2,2,2,5,1,H
1956-12-29,1956,Bristol City,Port Vale,3-3,3,3,2,2,6,0,D
1956-12-29,1956,Bury,Leyton Orient,1-3,1,3,2,2,4,-2,A
1956-12-29,1956,Doncaster Rovers,Notts County,4-2,4,2,2,2,6,2,H
1956-12-29,1956,Grimsby Town,Liverpool,0-0,0,0,2,2,0,0,D
1956-12-29,1956,Huddersfield Town,Fulham,1-1,1,1,2,2,2,0,D
1956-12-29,1956,Middlesbrough,Leicester City,1-3,1,3,2,2,4,-2,A
1956-12-29,1956,Nottingham Forest,Swansea City,4-3,4,3,2,2,7,1,H
1956-12-29,1956,Sheffield United,Barnsley,5-0,5,0,2,2,5,5,H
1956-12-29,1956,Stoke City,Bristol Rovers,2-1,2,1,2,2,3,1,H
1956-12-29,1956,West Ham United,Lincoln City,2-1,2,1,2,2,3,1,H
1957-01-01,1956,Blackburn Rovers,Nottingham Forest,2-2,2,2,2,2,4,0,D
1957-01-01,1956,Bury,Stoke City,0-1,0,1,2,2,1,-1,A
1957-01-01,1956,Rotherham United,Port Vale,1-0,1,0,2,2,1,1,H
1957-01-01,1956,Sheffield United,Swansea City,2-2,2,2,2,2,4,0,D
1957-01-12,1956,Barnsley,Bristol City,3-0,3,0,2,2,3,3,H
1957-01-12,1956,Bristol Rovers,Middlesbrough,0-2,0,2,2,2,2,-2,A
1957-01-12,1956,Huddersfield Town,Bury,1-2,1,2,2,2,3,-1,A
1957-01-12,1956,Leicester City,Sheffield United,5-0,5,0,2,2,5,5,H
1957-01-12,1956,Leyton Orient,Grimsby Town,1-1,1,1,2,2,2,0,D
1957-01-12,1956,Lincoln City,Nottingham Forest,0-2,0,2,2,2,2,-2,A
1957-01-12,1956,Liverpool,Doncaster Rovers,2-1,2,1,2,2,3,1,H
1957-01-12,1956,Notts County,Stoke City,5-0,5,0,2,2,5,5,H
1957-01-12,1956,Port Vale,Blackburn Rovers,0-3,0,3,2,2,3,-3,A
1957-01-12,1956,Rotherham United,West Ham United,0-1,0,1,2,2,1,-1,A
1957-01-12,1956,Swansea City,Fulham,4-5,4,5,2,2,9,-1,A
1957-01-19,1956,Blackburn Rovers,Barnsley,2-0,2,0,2,2,2,2,H
1957-01-19,1956,Bristol City,Sheffield United,5-1,5,1,2,2,6,4,H
1957-01-19,1956,Bury,Swansea City,1-3,1,3,2,2,4,-2,A
1957-01-19,1956,Doncaster Rovers,Leyton Orient,6-1,6,1,2,2,7,5,H
1957-01-19,1956,Fulham,Lincoln City,0-1,0,1,2,2,1,-1,A
1957-01-19,1956,Grimsby Town,Huddersfield Town,1-2,1,2,2,2,3,-1,A
1957-01-19,1956,Leicester City,Bristol Rovers,7-2,7,2,2,2,9,5,H
1957-01-19,1956,Middlesbrough,Notts County,0-0,0,0,2,2,0,0,D
1957-01-19,1956,Nottingham Forest,Rotherham United,3-1,3,1,2,2,4,2,H
1957-01-19,1956,Stoke City,Liverpool,1-0,1,0,2,2,1,1,H
1957-01-19,1956,West Ham United,Port Vale,2-1,2,1,2,2,3,1,H
1957-01-26,1956,Leicester City,Grimsby Town,4-3,4,3,2,2,7,1,H
1957-02-02,1956,Barnsley,West Ham United,1-2,1,2,2,2,3,-1,A
1957-02-02,1956,Bristol Rovers,Bristol City,0-0,0,0,2,2,0,0,D
1957-02-02,1956,Bury,Grimsby Town,2-3,2,3,2,2,5,-1,A
1957-02-02,1956,Huddersfield Town,Doncaster Rovers,0-1,0,1,2,2,1,-1,A
1957-02-02,1956,Leyton Orient,Stoke City,2-2,2,2,2,2,4,0,D
1957-02-02,1956,Lincoln City,Swansea City,0-2,0,2,2,2,2,-2,A
1957-02-02,1956,Liverpool,Middlesbrough,1-2,1,2,2,2,3,-1,A
1957-02-02,1956,Notts County,Leicester City,0-0,0,0,2,2,0,0,D
1957-02-02,1956,Port Vale,Nottingham Forest,1-7,1,7,2,2,8,-6,A
1957-02-02,1956,Rotherham United,Fulham,4-3,4,3,2,2,7,1,H
1957-02-02,1956,Sheffield United,Blackburn Rovers,0-2,0,2,2,2,2,-2,A
1957-02-09,1956,Blackburn Rovers,Bristol City,3-1,3,1,2,2,4,2,H
1957-02-09,1956,Bristol Rovers,Notts County,3-0,3,0,2,2,3,3,H
1957-02-09,1956,Doncaster Rovers,Bury,1-1,1,1,2,2,2,0,D
1957-02-09,1956,Fulham,Port Vale,6-3,6,3,2,2,9,3,H
1957-02-09,1956,Grimsby Town,Lincoln City,2-0,2,0,2,2,2,2,H
1957-02-09,1956,Leicester City,Liverpool,3-2,3,2,2,2,5,1,H
1957-02-09,1956,Middlesbrough,Leyton Orient,1-2,1,2,2,2,3,-1,A
1957-02-09,1956,Nottingham Forest,Barnsley,7-1,7,1,2,2,8,6,H
1957-02-09,1956,Stoke City,Huddersfield Town,5-1,5,1,2,2,6,4,H
1957-02-09,1956,Swansea City,Rotherham United,1-0,1,0,2,2,1,1,H
1957-02-09,1956,West Ham United,Sheffield United,3-2,3,2,2,2,5,1,H
1957-02-16,1956,Blackburn Rovers,Liverpool,2-2,2,2,2,2,4,0,D
1957-02-16,1956,Fulham,Bury,1-3,1,3,2,2,4,-2,A
1957-02-16,1956,Lincoln City,Doncaster Rovers,4-1,4,1,2,2,5,3,H
1957-02-16,1956,Port Vale,Middlesbrough,2-1,2,1,2,2,3,1,H
1957-02-16,1956,Rotherham United,Stoke City,1-0,1,0,2,2,1,1,H
1957-02-16,1956,Sheffield United,Bristol Rovers,0-0,0,0,2,2,0,0,D
1957-02-16,1956,Swansea City,Grimsby Town,3-1,3,1,2,2,4,2,H
1957-02-16,1956,West Ham United,Leyton Orient,2-1,2,1,2,2,3,1,H
1957-02-20,1956,Bristol City,Notts County,3-0,3,0,2,2,3,3,H
1957-02-21,1956,Nottingham Forest,Huddersfield Town,0-0,0,0,2,2,0,0,D
1957-02-23,1956,Bristol Rovers,Barnsley,1-1,1,1,2,2,2,0,D
1957-02-23,1956,Bury,Nottingham Forest,1-2,1,2,2,2,3,-1,A
1957-02-23,1956,Doncaster Rovers,Swansea City,0-1,0,1,2,2,1,-1,A
1957-02-23,1956,Grimsby Town,Fulham,3-1,3,1,2,2,4,2,H
1957-02-23,1956,Huddersfield Town,West Ham United,6-2,6,2,2,2,8,4,H
1957-02-23,1956,Leicester City,Port Vale,2-1,2,1,2,2,3,1,H
1957-02-23,1956,Leyton Orient,Blackburn Rovers,1-1,1,1,2,2,2,0,D
1957-02-23,1956,Middlesbrough,Rotherham United,0-1,0,1,2,2,1,-1,A
1957-02-23,1956,Notts County,Sheffield United,2-2,2,2,2,2,4,0,D
1957-02-23,1956,Stoke City,Lincoln City,8-0,8,0,2,2,8,8,H
1957-02-27,1956,Barnsley,Leicester City,2-0,2,0,2,2,2,2,H
1957-03-02,1956,Barnsley,Doncaster Rovers,3-1,3,1,2,2,4,2,H
1957-03-02,1956,Blackburn Rovers,Leicester City,1-1,1,1,2,2,2,0,D
1957-03-02,1956,Bristol City,Middlesbrough,2-1,2,1,2,2,3,1,H
1957-03-02,1956,Fulham,Liverpool,1-2,1,2,2,2,3,-1,A
1957-03-02,1956,Lincoln City,Huddersfield Town,1-2,1,2,2,2,3,-1,A
1957-03-02,1956,Port Vale,Grimsby Town,3-0,3,0,2,2,3,3,H
1957-03-02,1956,Rotherham United,Bury,1-1,1,1,2,2,2,0,D
1957-03-02,1956,Sheffield United,Stoke City,1-1,1,1,2,2,2,0,D
1957-03-02,1956,Swansea City,Leyton Orient,1-0,1,0,2,2,1,1,H
1957-03-02,1956,West Ham United,Bristol Rovers,1-2,1,2,2,2,3,-1,A
1957-03-09,1956,Bristol Rovers,Rotherham United,4-2,4,2,2,2,6,2,H
1957-03-09,1956,Bury,Blackburn Rovers,2-2,2,2,2,2,4,0,D
1957-03-09,1956,Doncaster Rovers,Nottingham Forest,1-1,1,1,2,2,2,0,D
1957-03-09,1956,Grimsby Town,West Ham United,2-1,2,1,2,2,3,1,H
1957-03-09,1956,Huddersfield Town,Bristol City,2-1,2,1,2,2,3,1,H
1957-03-09,1956,Leicester City,Lincoln City,4-3,4,3,2,2,7,1,H
1957-03-09,1956,Leyton Orient,Sheffield United,1-2,1,2,2,2,3,-1,A
1957-03-09,1956,Liverpool,Barnsley,2-1,2,1,2,2,3,1,H
1957-03-09,1956,Middlesbrough,Swansea City,6-2,6,2,2,2,8,4,H
1957-03-09,1956,Notts County,Port Vale,3-1,3,1,2,2,4,2,H
1957-03-09,1956,Stoke City,Fulham,0-2,0,2,2,2,2,-2,A
1957-03-16,1956,Barnsley,Leyton Orient,3-0,3,0,2,2,3,3,H
1957-03-16,1956,Blackburn Rovers,Grimsby Town,2-0,2,0,2,2,2,2,H
1957-03-16,1956,Bristol City,Bury,2-0,2,0,2,2,2,2,H
1957-03-16,1956,Fulham,Middlesbrough,1-2,1,2,2,2,3,-1,A
1957-03-16,1956,Lincoln City,Bristol Rovers,1-0,1,0,2,2,1,1,H
1957-03-16,1956,Nottingham Forest,Stoke City,4-0,4,0,2,2,4,4,H
1957-03-16,1956,Port Vale,Liverpool,1-2,1,2,2,2,3,-1,A
1957-03-16,1956,Rotherham United,Notts County,0-0,0,0,2,2,0,0,D
1957-03-16,1956,Sheffield United,Huddersfield Town,2-0,2,0,2,2,2,2,H
1957-03-16,1956,Swansea City,Leicester City,2-3,2,3,2,2,5,-1,A
1957-03-16,1956,West Ham United,Doncaster Rovers,1-1,1,1,2,2,2,0,D
1957-03-23,1956,Bristol Rovers,Swansea City,1-1,1,1,2,2,2,0,D
1957-03-23,1956,Bury,Sheffield United,0-1,0,1,2,2,1,-1,A
1957-03-23,1956,Doncaster Rovers,Blackburn Rovers,1-1,1,1,2,2,2,0,D
1957-03-23,1956,Grimsby Town,Bristol City,0-3,0,3,2,2,3,-3,A
1957-03-23,1956,Huddersfield Town,Barnsley,2-0,2,0,2,2,2,2,H
1957-03-23,1956,Leicester City,Fulham,1-3,1,3,2,2,4,-2,A
1957-03-23,1956,Leyton Orient,Port Vale,3-2,3,2,2,2,5,1,H
1957-03-23,1956,Liverpool,Rotherham United,4-1,4,1,2,2,5,3,H
1957-03-23,1956,Middlesbrough,Nottingham Forest,2-2,2,2,2,2,4,0,D
1957-03-23,1956,Notts County,Lincoln City,3-0,3,0,2,2,3,3,H
1957-03-23,1956,Stoke City,West Ham United,0-1,0,1,2,2,1,-1,A
1957-03-25,1956,Port Vale,Sheffield United,0-6,0,6,2,2,6,-6,A
1957-03-30,1956,Barnsley,Bury,1-1,1,1,2,2,2,0,D
1957-03-30,1956,Blackburn Rovers,Stoke City,1-0,1,0,2,2,1,1,H
1957-03-30,1956,Bristol City,Doncaster Rovers,4-0,4,0,2,2,4,4,H
1957-03-30,1956,Fulham,Bristol Rovers,3-2,3,2,2,2,5,1,H
1957-03-30,1956,Lincoln City,Liverpool,3-3,3,3,2,2,6,0,D
1957-03-30,1956,Nottingham Forest,Leicester City,1-2,1,2,2,2,3,-1,A
1957-03-30,1956,Port Vale,Huddersfield Town,1-2,1,2,2,2,3,-1,A
1957-03-30,1956,Rotherham United,Leyton Orient,2-0,2,0,2,2,2,2,H
1957-03-30,1956,Sheffield United,Grimsby Town,2-0,2,0,2,2,2,2,H
1957-03-30,1956,Swansea City,Notts County,2-1,2,1,2,2,3,1,H
1957-03-30,1956,West Ham United,Middlesbrough,1-1,1,1,2,2,2,0,D
1957-04-06,1956,Bristol Rovers,Nottingham Forest,3-2,3,2,2,2,5,1,H
1957-04-06,1956,Bury,Port Vale,1-0,1,0,2,2,1,1,H
1957-04-06,1956,Doncaster Rovers,Sheffield United,1-0,1,0,2,2,1,1,H
1957-04-06,1956,Grimsby Town,Barnsley,4-1,4,1,2,2,5,3,H
1957-04-06,1956,Huddersfield Town,Rotherham United,1-0,1,0,2,2,1,1,H
1957-04-06,1956,Leicester City,West Ham United,5-3,5,3,2,2,8,2,H
1957-04-06,1956,Leyton Orient,Lincoln City,2-1,2,1,2,2,3,1,H
1957-04-06,1956,Liverpool,Swansea City,2-0,2,0,2,2,2,2,H
1957-04-06,1956,Middlesbrough,Blackburn Rovers,2-1,2,1,2,2,3,1,H
1957-04-06,1956,Notts County,Fulham,0-0,0,0,2,2,0,0,D
1957-04-06,1956,Stoke City,Bristol City,0-2,0,2,2,2,2,-2,A
1957-04-13,1956,Barnsley,Notts County,1-1,1,1,2,2,2,0,D
1957-04-13,1956,Blackburn Rovers,Huddersfield Town,3-2,3,2,2,2,5,1,H
1957-04-13,1956,Bristol City,Leyton Orient,4-2,4,2,2,2,6,2,H
1957-04-13,1956,Fulham,Doncaster Rovers,3-0,3,0,2,2,3,3,H
1957-04-13,1956,Lincoln City,Middlesbrough,1-1,1,1,2,2,2,0,D
1957-04-13,1956,Nottingham Forest,Grimsby Town,2-1,2,1,2,2,3,1,H
1957-04-13,1956,Port Vale,Bristol Rovers,2-3,2,3,2,2,5,-1,A
1957-04-13,1956,Rotherham United,Leicester City,1-1,1,1,2,2,2,0,D
1957-04-13,1956,Sheffield United,Liverpool,3-0,3,0,2,2,3,3,H
1957-04-13,1956,Swansea City,Stoke City,1-0,1,0,2,2,1,1,H
1957-04-13,1956,West Ham United,Bury,1-0,1,0,2,2,1,1,H
1957-04-15,1956,Nottingham Forest,West Ham United,3-0,3,0,2,2,3,3,H
1957-04-19,1956,Blackburn Rovers,Notts County,1-1,1,1,2,2,2,0,D
1957-04-19,1956,Bristol City,West Ham United,1-1,1,1,2,2,2,0,D
1957-04-19,1956,Fulham,Barnsley,2-0,2,0,2,2,2,2,H
1957-04-19,1956,Grimsby Town,Doncaster Rovers,4-2,4,2,2,2,6,2,H
1957-04-19,1956,Leyton Orient,Leicester City,1-5,1,5,2,2,6,-4,A
1957-04-19,1956,Lincoln City,Rotherham United,3-3,3,3,2,2,6,0,D
1957-04-19,1956,Liverpool,Bristol Rovers,4-1,4,1,2,2,5,3,H
1957-04-19,1956,Port Vale,Swansea City,0-2,0,2,2,2,2,-2,A
1957-04-20,1956,Bristol Rovers,Blackburn Rovers,0-1,0,1,2,2,1,-1,A
1957-04-20,1956,Bury,Lincoln City,1-0,1,0,2,2,1,1,H
1957-04-20,1956,Doncaster Rovers,Port Vale,4-0,4,0,2,2,4,4,H
1957-04-20,1956,Grimsby Town,Rotherham United,3-2,3,2,2,2,5,1,H
1957-04-20,1956,Huddersfield Town,Swansea City,2-2,2,2,2,2,4,0,D
1957-04-20,1956,Leicester City,Bristol City,1-1,1,1,2,2,2,0,D
1957-04-20,1956,Leyton Orient,Fulham,0-2,0,2,2,2,2,-2,A
1957-04-20,1956,Liverpool,Nottingham Forest,3-1,3,1,2,2,4,2,H
1957-04-20,1956,Middlesbrough,Sheffield United,3-1,3,1,2,2,4,2,H
1957-04-20,1956,Notts County,West Ham United,4-1,4,1,2,2,5,3,H
1957-04-20,1956,Stoke City,Barnsley,3-0,3,0,2,2,3,3,H
1957-04-22,1956,Barnsley,Fulham,1-1,1,1,2,2,2,0,D
1957-04-22,1956,Bristol Rovers,Liverpool,0-0,0,0,2,2,0,0,D
1957-04-22,1956,Doncaster Rovers,Grimsby Town,0-1,0,1,2,2,1,-1,A
1957-04-22,1956,Leicester City,Leyton Orient,1-4,1,4,2,2,5,-3,A
1957-04-22,1956,Middlesbrough,Huddersfield Town,7-2,7,2,2,2,9,5,H
1957-04-22,1956,Nottingham Forest,Sheffield United,2-1,2,1,2,2,3,1,H
1957-04-22,1956,Rotherham United,Lincoln City,3-0,3,0,2,2,3,3,H
1957-04-22,1956,Stoke City,Bury,2-0,2,0,2,2,2,2,H
1957-04-22,1956,Swansea City,Port Vale,2-2,2,2,2,2,4,0,D
1957-04-22,1956,West Ham United,Bristol City,3-1,3,1,2,2,4,2,H
1957-04-23,1956,Huddersfield Town,Middlesbrough,0-1,0,1,2,2,1,-1,A
1957-04-23,1956,Notts County,Blackburn Rovers,2-0,2,0,2,2,2,2,H
1957-04-27,1956,Bristol City,Swansea City,3-1,3,1,2,2,4,2,H
1957-04-27,1956,Leyton Orient,Notts County,2-2,2,2,2,2,4,0,D
1957-04-27,1956,Lincoln City,Barnsley,4-1,4,1,2,2,5,3,H
1957-04-27,1956,Liverpool,West Ham United,1-0,1,0,2,2,1,1,H
1957-04-27,1956,Port Vale,Rotherham United,2-1,2,1,2,2,3,1,H
1957-04-27,1956,Sheffield United,Nottingham Forest,0-4,0,4,2,2,4,-4,A
1957-04-29,1956,Port Vale,Stoke City,2-2,2,2,2,2,4,0,D
1957-05-01,1956,Liverpool,Bristol City,2-1,2,1,2,2,3,1,H
1957-05-01,1956,Nottingham Forest,Notts County,2-4,2,4,2,2,6,-2,A
1957-08-24,1957,Barnsley,Bristol Rovers,2-2,2,2,2,2,4,0,D
1957-08-24,1957,Blackburn Rovers,Ipswich Town,0-0,0,0,2,2,0,0,D
1957-08-24,1957,Bristol City,Liverpool,1-2,1,2,2,2,3,-1,A
1957-08-24,1957,Cardiff City,Swansea City,0-0,0,0,2,2,0,0,D
1957-08-24,1957,Fulham,Derby County,2-0,2,0,2,2,2,2,H
1957-08-24,1957,Grimsby Town,Leyton Orient,7-2,7,2,2,2,9,5,H
1957-08-24,1957,Huddersfield Town,Charlton Athletic,3-3,3,3,2,2,6,0,D
1957-08-24,1957,Rotherham United,Doncaster Rovers,2-1,2,1,2,2,3,1,H
1957-08-24,1957,Sheffield United,Notts County,1-0,1,0,2,2,1,1,H
1957-08-24,1957,Stoke City,Middlesbrough,4-1,4,1,2,2,5,3,H
1957-08-24,1957,West Ham United,Lincoln City,2-2,2,2,2,2,4,0,D
1957-08-26,1957,Blackburn Rovers,West Ham United,2-1,2,1,2,2,3,1,H
1957-08-26,1957,Bristol Rovers,Derby County,5-2,5,2,2,2,7,3,H
1957-08-26,1957,Stoke City,Bristol City,3-0,3,0,2,2,3,3,H
1957-08-27,1957,Grimsby Town,Cardiff City,1-1,1,1,2,2,2,0,D
1957-08-28,1957,Doncaster Rovers,Leyton Orient,2-0,2,0,2,2,2,2,H
1957-08-28,1957,Ipswich Town,Barnsley,3-0,3,0,2,2,3,3,H
1957-08-28,1957,Liverpool,Huddersfield Town,1-1,1,1,2,2,2,0,D
1957-08-28,1957,Middlesbrough,Rotherham United,2-2,2,2,2,2,4,0,D
1957-08-29,1957,Charlton Athletic,Sheffield United,3-1,3,1,2,2,4,2,H
1957-08-29,1957,Notts County,Fulham,1-5,1,5,2,2,6,-4,A
1957-08-29,1957,Swansea City,Lincoln City,5-1,5,1,2,2,6,4,H
1957-08-31,1957,Bristol Rovers,West Ham United,2-3,2,3,2,2,5,-1,A
1957-08-31,1957,Charlton Athletic,Grimsby Town,2-0,2,0,2,2,2,2,H
1957-08-31,1957,Derby County,Barnsley,1-4,1,4,2,2,5,-3,A
1957-08-31,1957,Doncaster Rovers,Huddersfield Town,0-3,0,3,2,2,3,-3,A
1957-08-31,1957,Ipswich Town,Rotherham United,1-2,1,2,2,2,3,-1,A
1957-08-31,1957,Leyton Orient,Stoke City,0-2,0,2,2,2,2,-2,A
1957-08-31,1957,Lincoln City,Sheffield United,2-2,2,2,2,2,4,0,D
1957-08-31,1957,Liverpool,Cardiff City,3-0,3,0,2,2,3,3,H
1957-08-31,1957,Middlesbrough,Bristol City,0-0,0,0,2,2,0,0,D
1957-08-31,1957,Notts County,Blackburn Rovers,1-1,1,1,2,2,2,0,D
1957-08-31,1957,Swansea City,Fulham,4-4,4,4,2,2,8,0,D
1957-09-02,1957,Sheffield United,Charlton Athletic,0-3,0,3,2,2,3,-3,A
1957-09-02,1957,West Ham United,Blackburn Rovers,1-1,1,1,2,2,2,0,D
1957-09-03,1957,Bristol City,Stoke City,2-1,2,1,2,2,3,1,H
1957-09-04,1957,Barnsley,Ipswich Town,5-1,5,1,2,2,6,4,H
1957-09-04,1957,Cardiff City,Grimsby Town,1-3,1,3,2,2,4,-2,A
1957-09-04,1957,Derby County,Bristol Rovers,2-1,2,1,2,2,3,1,H
1957-09-04,1957,Fulham,Notts County,1-0,1,0,2,2,1,1,H
1957-09-04,1957,Huddersfield Town,Liverpool,2-1,2,1,2,2,3,1,H
1957-09-04,1957,Lincoln City,Swansea City,4-0,4,0,2,2,4,4,H
1957-09-05,1957,Leyton Orient,Doncaster Rovers,2-0,2,0,2,2,2,2,H
1957-09-05,1957,Rotherham United,Middlesbrough,1-4,1,4,2,2,5,-3,A
1957-09-07,1957,Barnsley,Swansea City,1-0,1,0,2,2,1,1,H
1957-09-07,1957,Blackburn Rovers,Lincoln City,0-1,0,1,2,2,1,-1,A
1957-09-07,1957,Bristol City,Leyton Orient,2-2,2,2,2,2,4,0,D
1957-09-07,1957,Cardiff City,Middlesbrough,0-2,0,2,2,2,2,-2,A
1957-09-07,1957,Fulham,Liverpool,2-2,2,2,2,2,4,0,D
1957-09-07,1957,Grimsby Town,Doncaster Rovers,3-1,3,1,2,2,4,2,H
1957-09-07,1957,Huddersfield Town,Rotherham United,1-3,1,3,2,2,4,-2,A
1957-09-07,1957,Ipswich Town,Notts County,2-1,2,1,2,2,3,1,H
1957-09-07,1957,Sheffield United,Bristol Rovers,2-0,2,0,2,2,2,2,H
1957-09-07,1957,Stoke City,Charlton Athletic,2-2,2,2,2,2,4,0,D
1957-09-07,1957,West Ham United,Derby County,2-1,2,1,2,2,3,1,H
1957-09-09,1957,Blackburn Rovers,Barnsley,3-1,3,1,2,2,4,2,H
1957-09-09,1957,Stoke City,Bristol Rovers,3-5,3,5,2,2,8,-2,A
1957-09-09,1957,West Ham United,Sheffield United,0-3,0,3,2,2,3,-3,A
1957-09-10,1957,Bristol City,Grimsby Town,3-2,3,2,2,2,5,1,H
1957-09-11,1957,Cardiff City,Huddersfield Town,1-0,1,0,2,2,1,1,H
1957-09-11,1957,Ipswich Town,Fulham,1-1,1,1,2,2,2,0,D
1957-09-11,1957,Lincoln City,Derby County,1-1,1,1,2,2,2,0,D
1957-09-11,1957,Middlesbrough,Doncaster Rovers,5-0,5,0,2,2,5,5,H
1957-09-12,1957,Charlton Athletic,Leyton Orient,3-2,3,2,2,2,5,1,H
1957-09-12,1957,Notts County,Swansea City,2-4,2,4,2,2,6,-2,A
1957-09-14,1957,Bristol Rovers,Blackburn Rovers,4-0,4,0,2,2,4,4,H
1957-09-14,1957,Charlton Athletic,Bristol City,1-0,1,0,2,2,1,1,H
1957-09-14,1957,Derby County,Sheffield United,2-0,2,0,2,2,2,2,H
1957-09-14,1957,Doncaster Rovers,Stoke City,0-1,0,1,2,2,1,-1,A
1957-09-14,1957,Fulham,Barnsley,1-1,1,1,2,2,2,0,D
1957-09-14,1957,Leyton Orient,Cardiff City,4-2,4,2,2,2,6,2,H
1957-09-14,1957,Lincoln City,Ipswich Town,2-1,2,1,2,2,3,1,H
1957-09-14,1957,Middlesbrough,Liverpool,2-2,2,2,2,2,4,0,D
1957-09-14,1957,Notts County,Huddersfield Town,1-1,1,1,2,2,2,0,D
1957-09-14,1957,Swansea City,West Ham United,3-2,3,2,2,2,5,1,H
1957-09-16,1957,Bristol Rovers,Stoke City,2-0,2,0,2,2,2,2,H
1957-09-16,1957,Sheffield United,West Ham United,2-1,2,1,2,2,3,1,H
1957-09-17,1957,Grimsby Town,Bristol City,1-1,1,1,2,2,2,0,D
1957-09-18,1957,Barnsley,Blackburn Rovers,0-2,0,2,2,2,2,-2,A
1957-09-18,1957,Derby County,Lincoln City,3-2,3,2,2,2,5,1,H
1957-09-18,1957,Doncaster Rovers,Middlesbrough,3-2,3,2,2,2,5,1,H
1957-09-18,1957,Fulham,Ipswich Town,0-0,0,0,2,2,0,0,D
1957-09-18,1957,Huddersfield Town,Cardiff City,1-1,1,1,2,2,2,0,D
1957-09-19,1957,Leyton Orient,Charlton Athletic,3-2,3,2,2,2,5,1,H
1957-09-19,1957,Rotherham United,Liverpool,2-2,2,2,2,2,4,0,D
1957-09-19,1957,Swansea City,Notts County,1-3,1,3,2,2,4,-2,A
1957-09-21,1957,Barnsley,Middlesbrough,1-1,1,1,2,2,2,0,D
1957-09-21,1957,Blackburn Rovers,Derby County,3-1,3,1,2,2,4,2,H
1957-09-21,1957,Bristol City,Doncaster Rovers,2-2,2,2,2,2,4,0,D
1957-09-21,1957,Cardiff City,Charlton Athletic,0-3,0,3,2,2,3,-3,A
1957-09-21,1957,Grimsby Town,Huddersfield Town,4-1,4,1,2,2,5,3,H
1957-09-21,1957,Ipswich Town,Bristol Rovers,3-2,3,2,2,2,5,1,H
1957-09-21,1957,Liverpool,Leyton Orient,3-0,3,0,2,2,3,3,H
1957-09-21,1957,Notts County,Lincoln City,1-0,1,0,2,2,1,1,H
1957-09-21,1957,Sheffield United,Swansea City,2-2,2,2,2,2,4,0,D
1957-09-21,1957,Stoke City,Rotherham United,4-1,4,1,2,2,5,3,H
1957-09-21,1957,West Ham United,Fulham,3-2,3,2,2,2,5,1,H
1957-09-23,1957,Stoke City,Liverpool,1-2,1,2,2,2,3,-1,A
1957-09-28,1957,Barnsley,West Ham United,1-0,1,0,2,2,1,1,H
1957-09-28,1957,Bristol Rovers,Notts County,5-2,5,2,2,2,7,3,H
1957-09-28,1957,Charlton Athletic,Liverpool,5-1,5,1,2,2,6,4,H
1957-09-28,1957,Derby County,Ipswich Town,2-2,2,2,2,2,4,0,D
1957-09-28,1957,Doncaster Rovers,Cardiff City,0-1,0,1,2,2,1,-1,A
1957-09-28,1957,Fulham,Sheffield United,6-3,6,3,2,2,9,3,H
1957-09-28,1957,Huddersfield Town,Stoke City,1-0,1,0,2,2,1,1,H
1957-09-28,1957,Leyton Orient,Middlesbrough,4-0,4,0,2,2,4,4,H
1957-09-28,1957,Lincoln City,Grimsby Town,1-4,1,4,2,2,5,-3,A
1957-09-28,1957,Rotherham United,Bristol City,4-1,4,1,2,2,5,3,H
1957-09-28,1957,Swansea City,Blackburn Rovers,0-4,0,4,2,2,4,-4,A
1957-10-05,1957,Blackburn Rovers,Fulham,1-1,1,1,2,2,2,0,D
1957-10-05,1957,Bristol City,Huddersfield Town,1-3,1,3,2,2,4,-2,A
1957-10-05,1957,Cardiff City,Rotherham United,2-2,2,2,2,2,4,0,D
1957-10-05,1957,Ipswich Town,Swansea City,0-1,0,1,2,2,1,-1,A
1957-10-05,1957,Lincoln City,Bristol Rovers,0-1,0,1,2,2,1,-1,A
1957-10-05,1957,Liverpool,Doncaster Rovers,5-0,5,0,2,2,5,5,H
1957-10-05,1957,Middlesbrough,Charlton Athletic,2-0,2,0,2,2,2,2,H
1957-10-05,1957,Notts County,Derby County,1-0,1,0,2,2,1,1,H
1957-10-05,1957,Sheffield United,Barnsley,0-0,0,0,2,2,0,0,D
1957-10-05,1957,Stoke City,Grimsby Town,4-1,4,1,2,2,5,3,H
1957-10-05,1957,West Ham United,Leyton Orient,3-2,3,2,2,2,5,1,H
1957-10-12,1957,Bristol City,Bristol Rovers,3-2,3,2,2,2,5,1,H
1957-10-12,1957,Cardiff City,Derby County,3-2,3,2,2,2,5,1,H
1957-10-12,1957,Charlton Athletic,West Ham United,0-3,0,3,2,2,3,-3,A
1957-10-12,1957,Doncaster Rovers,Sheffield United,2-2,2,2,2,2,4,0,D
1957-10-12,1957,Grimsby Town,Notts County,2-0,2,0,2,2,2,2,H
1957-10-12,1957,Huddersfield Town,Ipswich Town,3-0,3,0,2,2,3,3,H
1957-10-12,1957,Leyton Orient,Barnsley,2-1,2,1,2,2,3,1,H
1957-10-12,1957,Liverpool,Swansea City,4-0,4,0,2,2,4,4,H
1957-10-12,1957,Middlesbrough,Fulham,2-0,2,0,2,2,2,2,H
1957-10-12,1957,Rotherham United,Blackburn Rovers,1-2,1,2,2,2,3,-1,A
1957-10-12,1957,Stoke City,Lincoln City,1-1,1,1,2,2,2,0,D
1957-10-19,1957,Barnsley,Charlton Athletic,4-1,4,1,2,2,5,3,H
1957-10-19,1957,Blackburn Rovers,Huddersfield Town,1-1,1,1,2,2,2,0,D
1957-10-19,1957,Bristol Rovers,Cardiff City,0-2,0,2,2,2,2,-2,A
1957-10-19,1957,Derby County,Liverpool,2-1,2,1,2,2,3,1,H
1957-10-19,1957,Fulham,Leyton Orient,3-1,3,1,2,2,4,2,H
1957-10-19,1957,Ipswich Town,Grimsby Town,3-2,3,2,2,2,5,1,H
1957-10-19,1957,Notts County,Stoke City,1-2,1,2,2,2,3,-1,A
1957-10-19,1957,Sheffield United,Rotherham United,2-0,2,0,2,2,2,2,H
1957-10-19,1957,Swansea City,Middlesbrough,1-4,1,4,2,2,5,-3,A
1957-10-19,1957,West Ham United,Doncaster Rovers,1-1,1,1,2,2,2,0,D
1957-10-26,1957,Bristol City,Notts County,3-1,3,1,2,2,4,2,H
1957-10-26,1957,Cardiff City,Lincoln City,3-2,3,2,2,2,5,1,H
1957-10-26,1957,Charlton Athletic,Fulham,2-2,2,2,2,2,4,0,D
1957-10-26,1957,Grimsby Town,Blackburn Rovers,3-4,3,4,2,2,7,-1,A
1957-10-26,1957,Huddersfield Town,Sheffield United,1-1,1,1,2,2,2,0,D
1957-10-26,1957,Leyton Orient,Swansea City,5-1,5,1,2,2,6,4,H
1957-10-26,1957,Liverpool,Bristol Rovers,2-0,2,0,2,2,2,2,H
1957-10-26,1957,Middlesbrough,Derby County,3-2,3,2,2,2,5,1,H
1957-10-26,1957,Rotherham United,West Ham United,1-2,1,2,2,2,3,-1,A
1957-10-26,1957,Stoke City,Ipswich Town,5-1,5,1,2,2,6,4,H
1957-10-28,1957,Doncaster Rovers,Barnsley,1-1,1,1,2,2,2,0,D
1957-11-02,1957,Barnsley,Rotherham United,3-0,3,0,2,2,3,3,H
1957-11-02,1957,Blackburn Rovers,Stoke City,1-0,1,0,2,2,1,1,H
1957-11-02,1957,Bristol Rovers,Middlesbrough,5-0,5,0,2,2,5,5,H
1957-11-02,1957,Derby County,Leyton Orient,2-0,2,0,2,2,2,2,H
1957-11-02,1957,Fulham,Doncaster Rovers,4-1,4,1,2,2,5,3,H
1957-11-02,1957,Ipswich Town,Bristol City,4-2,4,2,2,2,6,2,H
1957-11-02,1957,Lincoln City,Liverpool,0-1,0,1,2,2,1,-1,A
1957-11-02,1957,Notts County,Cardiff City,5-2,5,2,2,2,7,3,H
1957-11-02,1957,Sheffield United,Grimsby Town,3-1,3,1,2,2,4,2,H
1957-11-02,1957,Swansea City,Charlton Athletic,1-3,1,3,2,2,4,-2,A
1957-11-02,1957,West Ham United,Huddersfield Town,5-2,5,2,2,2,7,3,H
1957-11-04,1957,Stoke City,Cardiff City,3-0,3,0,2,2,3,3,H
1957-11-09,1957,Bristol City,Blackburn Rovers,0-0,0,0,2,2,0,0,D
1957-11-09,1957,Cardiff City,Ipswich Town,1-1,1,1,2,2,2,0,D
1957-11-09,1957,Charlton Athletic,Derby County,2-2,2,2,2,2,4,0,D
1957-11-09,1957,Doncaster Rovers,Swansea City,3-0,3,0,2,2,3,3,H
1957-11-09,1957,Grimsby Town,West Ham United,1-2,1,2,2,2,3,-1,A
1957-11-09,1957,Huddersfield Town,Barnsley,0-5,0,5,2,2,5,-5,A
1957-11-09,1957,Leyton Orient,Bristol Rovers,1-3,1,3,2,2,4,-2,A
1957-11-09,1957,Liverpool,Notts County,4-0,4,0,2,2,4,4,H
1957-11-09,1957,Middlesbrough,Lincoln City,3-1,3,1,2,2,4,2,H
1957-11-09,1957,Rotherham United,Fulham,3-1,3,1,2,2,4,2,H
1957-11-09,1957,Stoke City,Sheffield United,2-3,2,3,2,2,5,-1,A
1957-11-16,1957,Barnsley,Grimsby Town,3-3,3,3,2,2,6,0,D
1957-11-16,1957,Blackburn Rovers,Cardiff City,4-0,4,0,2,2,4,4,H
1957-11-16,1957,Bristol Rovers,Charlton Athletic,1-0,1,0,2,2,1,1,H
1957-11-16,1957,Derby County,Doncaster Rovers,1-0,1,0,2,2,1,1,H
1957-11-16,1957,Fulham,Huddersfield Town,2-1,2,1,2,2,3,1,H
1957-11-16,1957,Ipswich Town,Liverpool,3-1,3,1,2,2,4,2,H
1957-11-16,1957,Lincoln City,Leyton Orient,2-0,2,0,2,2,2,2,H
1957-11-16,1957,Notts County,Middlesbrough,2-0,2,0,2,2,2,2,H
1957-11-16,1957,Sheffield United,Bristol City,0-3,0,3,2,2,3,-3,A
1957-11-16,1957,Swansea City,Rotherham United,1-3,1,3,2,2,4,-2,A
1957-11-16,1957,West Ham United,Stoke City,5-0,5,0,2,2,5,5,H
1957-11-23,1957,Bristol City,West Ham United,1-1,1,1,2,2,2,0,D
1957-11-23,1957,Cardiff City,Sheffield United,0-0,0,0,2,2,0,0,D
1957-11-23,1957,Charlton Athletic,Lincoln City,4-1,4,1,2,2,5,3,H
1957-11-23,1957,Doncaster Rovers,Bristol Rovers,3-2,3,2,2,2,5,1,H
1957-11-23,1957,Grimsby Town,Fulham,3-1,3,1,2,2,4,2,H
1957-11-23,1957,Huddersfield Town,Swansea City,2-2,2,2,2,2,4,0,D
1957-11-23,1957,Leyton Orient,Notts County,2-2,2,2,2,2,4,0,D
1957-11-23,1957,Liverpool,Blackburn Rovers,2-0,2,0,2,2,2,2,H
1957-11-23,1957,Middlesbrough,Ipswich Town,5-2,5,2,2,2,7,3,H
1957-11-23,1957,Rotherham United,Derby County,0-2,0,2,2,2,2,-2,A
1957-11-23,1957,Stoke City,Barnsley,3-1,3,1,2,2,4,2,H
1957-11-27,1957,Liverpool,Rotherham United,2-0,2,0,2,2,2,2,H
1957-11-30,1957,Barnsley,Bristol City,4-1,4,1,2,2,5,3,H
1957-11-30,1957,Blackburn Rovers,Middlesbrough,3-3,3,3,2,2,6,0,D
1957-11-30,1957,Bristol Rovers,Rotherham United,1-3,1,3,2,2,4,-2,A
1957-11-30,1957,Derby County,Huddersfield Town,2-4,2,4,2,2,6,-2,A
1957-11-30,1957,Fulham,Stoke City,3-4,3,4,2,2,7,-1,A
1957-11-30,1957,Ipswich Town,Leyton Orient,5-3,5,3,2,2,8,2,H
1957-11-30,1957,Lincoln City,Doncaster Rovers,1-1,1,1,2,2,2,0,D
1957-11-30,1957,Notts County,Charlton Athletic,2-1,2,1,2,2,3,1,H
1957-11-30,1957,Sheffield United,Liverpool,1-1,1,1,2,2,2,0,D
1957-11-30,1957,Swansea City,Grimsby Town,0-2,0,2,2,2,2,-2,A
1957-11-30,1957,West Ham United,Cardiff City,1-1,1,1,2,2,2,0,D
1957-12-07,1957,Bristol City,Fulham,0-5,0,5,2,2,5,-5,A
1957-12-07,1957,Cardiff City,Barnsley,7-0,7,0,2,2,7,7,H
1957-12-07,1957,Charlton Athletic,Ipswich Town,4-1,4,1,2,2,5,3,H
1957-12-07,1957,Doncaster Rovers,Notts County,4-0,4,0,2,2,4,4,H
1957-12-07,1957,Grimsby Town,Derby County,3-2,3,2,2,2,5,1,H
1957-12-07,1957,Huddersfield Town,Bristol Rovers,0-0,0,0,2,2,0,0,D
1957-12-07,1957,Leyton Orient,Blackburn Rovers,5-1,5,1,2,2,6,4,H
1957-12-07,1957,Liverpool,West Ham United,1-1,1,1,2,2,2,0,D
1957-12-07,1957,Middlesbrough,Sheffield United,1-2,1,2,2,2,3,-1,A
1957-12-07,1957,Rotherham United,Lincoln City,1-2,1,2,2,2,3,-1,A
1957-12-09,1957,Stoke City,Swansea City,6-2,6,2,2,2,8,4,H
1957-12-14,1957,Barnsley,Liverpool,2-1,2,1,2,2,3,1,H
1957-12-14,1957,Blackburn Rovers,Charlton Athletic,1-1,1,1,2,2,2,0,D
1957-12-14,1957,Bristol Rovers,Grimsby Town,0-7,0,7,2,2,7,-7,A
1957-12-14,1957,Derby County,Stoke City,0-0,0,0,2,2,0,0,D
1957-12-14,1957,Fulham,Cardiff City,2-0,2,0,2,2,2,2,H
1957-12-14,1957,Ipswich Town,Doncaster Rovers,2-0,2,0,2,2,2,2,H
1957-12-14,1957,Lincoln City,Huddersfield Town,1-1,1,1,2,2,2,0,D
1957-12-14,1957,Notts County,Rotherham United,1-0,1,0,2,2,1,1,H
1957-12-14,1957,Sheffield United,Leyton Orient,0-2,0,2,2,2,2,-2,A
1957-12-14,1957,Swansea City,Bristol City,5-1,5,1,2,2,6,4,H
1957-12-14,1957,West Ham United,Middlesbrough,2-1,2,1,2,2,3,1,H
1957-12-21,1957,Bristol Rovers,Barnsley,1-1,1,1,2,2,2,0,D
1957-12-21,1957,Charlton Athletic,Huddersfield Town,7-6,7,6,2,2,13,1,H
1957-12-21,1957,Derby County,Fulham,3-3,3,3,2,2,6,0,D
1957-12-21,1957,Doncaster Rovers,Rotherham United,3-2,3,2,2,2,5,1,H
1957-12-21,1957,Ipswich Town,Blackburn Rovers,2-1,2,1,2,2,3,1,H
1957-12-21,1957,Leyton Orient,Grimsby Town,5-1,5,1,2,2,6,4,H
1957-12-21,1957,Lincoln City,West Ham United,1-6,1,6,2,2,7,-5,A
1957-12-21,1957,Liverpool,Bristol City,4-3,4,3,2,2,7,1,H
1957-12-21,1957,Middlesbrough,Stoke City,1-3,1,3,2,2,4,-2,A
1957-12-21,1957,Notts County,Sheffield United,1-0,1,0,2,2,1,1,H
1957-12-21,1957,Swansea City,Cardiff City,0-1,0,1,2,2,1,-1,A
1957-12-25,1957,Blackburn Rovers,Sheffield United,1-0,1,0,2,2,1,1,H
1957-12-25,1957,Bristol City,Derby County,2-1,2,1,2,2,3,1,H
1957-12-25,1957,Charlton Athletic,Doncaster Rovers,2-0,2,0,2,2,2,2,H
1957-12-25,1957,Grimsby Town,Liverpool,3-1,3,1,2,2,4,2,H
1957-12-25,1957,Huddersfield Town,Middlesbrough,1-0,1,0,2,2,1,1,H
1957-12-25,1957,Leyton Orient,Rotherham United,6-2,6,2,2,2,8,4,H
1957-12-25,1957,Lincoln City,Fulham,0-1,0,1,2,2,1,-1,A
1957-12-25,1957,Notts County,Barnsley,2-3,2,3,2,2,5,-1,A
1957-12-25,1957,Swansea City,Bristol Rovers,6-4,6,4,2,2,10,2,H
1957-12-25,1957,West Ham United,Ipswich Town,1-1,1,1,2,2,2,0,D
1957-12-26,1957,Barnsley,Notts County,1-1,1,1,2,2,2,0,D
1957-12-26,1957,Bristol Rovers,Swansea City,3-0,3,0,2,2,3,3,H
1957-12-26,1957,Cardiff City,Stoke City,5-2,5,2,2,2,7,3,H
1957-12-26,1957,Derby County,Bristol City,5-2,5,2,2,2,7,3,H
1957-12-26,1957,Doncaster Rovers,Charlton Athletic,1-2,1,2,2,2,3,-1,A
1957-12-26,1957,Fulham,Lincoln City,4-1,4,1,2,2,5,3,H
1957-12-26,1957,Ipswich Town,West Ham United,2-1,2,1,2,2,3,1,H
1957-12-26,1957,Liverpool,Grimsby Town,3-2,3,2,2,2,5,1,H
1957-12-26,1957,Middlesbrough,Huddersfield Town,0-1,0,1,2,2,1,-1,A
1957-12-26,1957,Rotherham United,Leyton Orient,2-2,2,2,2,2,4,0,D
1957-12-26,1957,Sheffield United,Blackburn Rovers,4-2,4,2,2,2,6,2,H
1957-12-28,1957,Barnsley,Derby County,3-0,3,0,2,2,3,3,H
1957-12-28,1957,Blackburn Rovers,Notts County,3-0,3,0,2,2,3,3,H
1957-12-28,1957,Bristol City,Middlesbrough,0-0,0,0,2,2,0,0,D
1957-12-28,1957,Cardiff City,Liverpool,6-1,6,1,2,2,7,5,H
1957-12-28,1957,Fulham,Swansea City,2-0,2,0,2,2,2,2,H
1957-12-28,1957,Grimsby Town,Charlton Athletic,4-2,4,2,2,2,6,2,H
1957-12-28,1957,Huddersfield Town,Doncaster Rovers,2-2,2,2,2,2,4,0,D
1957-12-28,1957,Rotherham United,Ipswich Town,1-4,1,4,2,2,5,-3,A
1957-12-28,1957,Sheffield United,Lincoln City,4-0,4,0,2,2,4,4,H
1957-12-28,1957,Stoke City,Leyton Orient,1-3,1,3,2,2,4,-2,A
1957-12-28,1957,West Ham United,Bristol Rovers,6-1,6,1,2,2,7,5,H
1958-01-11,1957,Bristol Rovers,Sheffield United,2-2,2,2,2,2,4,0,D
1958-01-11,1957,Charlton Athletic,Stoke City,3-0,3,0,2,2,3,3,H
1958-01-11,1957,Derby County,West Ham United,2-3,2,3,2,2,5,-1,A
1958-01-11,1957,Doncaster Rovers,Grimsby Town,3-3,3,3,2,2,6,0,D
1958-01-11,1957,Leyton Orient,Bristol City,4-0,4,0,2,2,4,4,H
1958-01-11,1957,Lincoln City,Blackburn Rovers,1-1,1,1,2,2,2,0,D
1958-01-11,1957,Liverpool,Fulham,2-1,2,1,2,2,3,1,H
1958-01-11,1957,Middlesbrough,Cardiff City,4-1,4,1,2,2,5,3,H
1958-01-11,1957,Notts County,Ipswich Town,0-3,0,3,2,2,3,-3,A
1958-01-11,1957,Rotherham United,Huddersfield Town,1-1,1,1,2,2,2,0,D
1958-01-11,1957,Swansea City,Barnsley,4-2,4,2,2,2,6,2,H
1958-01-18,1957,Barnsley,Fulham,1-0,1,0,2,2,1,1,H
1958-01-18,1957,Blackburn Rovers,Bristol Rovers,2-0,2,0,2,2,2,2,H
1958-01-18,1957,Bristol City,Charlton Athletic,1-2,1,2,2,2,3,-1,A
1958-01-18,1957,Cardiff City,Leyton Orient,1-1,1,1,2,2,2,0,D
1958-01-18,1957,Grimsby Town,Rotherham United,3-1,3,1,2,2,4,2,H
1958-01-18,1957,Huddersfield Town,Notts County,3-0,3,0,2,2,3,3,H
1958-01-18,1957,Ipswich Town,Lincoln City,1-1,1,1,2,2,2,0,D
1958-01-18,1957,Liverpool,Middlesbrough,0-2,0,2,2,2,2,-2,A
1958-01-18,1957,Sheffield United,Derby County,0-1,0,1,2,2,1,-1,A
1958-01-18,1957,Stoke City,Doncaster Rovers,0-0,0,0,2,2,0,0,D
1958-01-18,1957,West Ham United,Swansea City,6-2,6,2,2,2,8,4,H
1958-02-01,1957,Bristol Rovers,Ipswich Town,3-1,3,1,2,2,4,2,H
1958-02-01,1957,Charlton Athletic,Cardiff City,3-1,3,1,2,2,4,2,H
1958-02-01,1957,Derby County,Blackburn Rovers,0-3,0,3,2,2,3,-3,A
1958-02-01,1957,Doncaster Rovers,Bristol City,2-1,2,1,2,2,3,1,H
1958-02-01,1957,Fulham,West Ham United,2-2,2,2,2,2,4,0,D
1958-02-01,1957,Huddersfield Town,Grimsby Town,1-0,1,0,2,2,1,1,H
1958-02-01,1957,Leyton Orient,Liverpool,1-0,1,0,2,2,1,1,H
1958-02-01,1957,Lincoln City,Notts County,2-2,2,2,2,2,4,0,D
1958-02-01,1957,Middlesbrough,Barnsley,3-1,3,1,2,2,4,2,H
1958-02-01,1957,Rotherham United,Stoke City,0-2,0,2,2,2,2,-2,A
1958-02-01,1957,Swansea City,Sheffield United,0-2,0,2,2,2,2,-2,A
1958-02-08,1957,Blackburn Rovers,Swansea City,2-2,2,2,2,2,4,0,D
1958-02-08,1957,Bristol City,Rotherham United,0-1,0,1,2,2,1,-1,A
1958-02-08,1957,Cardiff City,Doncaster Rovers,3-1,3,1,2,2,4,2,H
1958-02-08,1957,Grimsby Town,Lincoln City,4-0,4,0,2,2,4,4,H
1958-02-08,1957,Ipswich Town,Derby County,2-2,2,2,2,2,4,0,D
1958-02-08,1957,Liverpool,Charlton Athletic,3-1,3,1,2,2,4,2,H
1958-02-08,1957,Stoke City,Huddersfield Town,1-1,1,1,2,2,2,0,D
1958-02-08,1957,West Ham United,Barnsley,1-1,1,1,2,2,2,0,D
1958-02-15,1957,Charlton Athletic,Middlesbrough,6-2,6,2,2,2,8,4,H
1958-02-15,1957,Derby County,Notts County,2-1,2,1,2,2,3,1,H
1958-02-15,1957,Rotherham United,Grimsby Town,2-0,2,0,2,2,2,2,H
1958-02-15,1957,Swansea City,Ipswich Town,0-0,0,0,2,2,0,0,D
1958-02-19,1957,Bristol Rovers,Lincoln City,3-0,3,0,2,2,3,3,H
1958-02-19,1957,Doncaster Rovers,Liverpool,1-1,1,1,2,2,2,0,D
1958-02-19,1957,Huddersfield Town,Bristol City,0-0,0,0,2,2,0,0,D
1958-02-20,1957,Leyton Orient,West Ham United,1-4,1,4,2,2,5,-3,A
1958-02-22,1957,Barnsley,Stoke City,1-2,1,2,2,2,3,-1,A
1958-02-22,1957,Blackburn Rovers,Liverpool,3-3,3,3,2,2,6,0,D
1958-02-22,1957,Bristol Rovers,Doncaster Rovers,2-1,2,1,2,2,3,1,H
1958-02-22,1957,Derby County,Rotherham United,3-4,3,4,2,2,7,-1,A
1958-02-22,1957,Fulham,Grimsby Town,6-0,6,0,2,2,6,6,H
1958-02-22,1957,Ipswich Town,Middlesbrough,1-1,1,1,2,2,2,0,D
1958-02-22,1957,Lincoln City,Charlton Athletic,2-3,2,3,2,2,5,-1,A
1958-02-22,1957,Notts County,Leyton Orient,0-1,0,1,2,2,1,-1,A
1958-02-22,1957,Sheffield United,Cardiff City,3-0,3,0,2,2,3,3,H
1958-02-22,1957,Swansea City,Huddersfield Town,1-1,1,1,2,2,2,0,D
1958-02-22,1957,West Ham United,Bristol City,3-2,3,2,2,2,5,1,H
1958-03-01,1957,Bristol City,Lincoln City,4-0,4,0,2,2,4,4,H
1958-03-01,1957,Charlton Athletic,Barnsley,4-2,4,2,2,2,6,2,H
1958-03-01,1957,Doncaster Rovers,West Ham United,1-2,1,2,2,2,3,-1,A
1958-03-01,1957,Grimsby Town,Ipswich Town,0-2,0,2,2,2,2,-2,A
1958-03-01,1957,Middlesbrough,Swansea City,2-1,2,1,2,2,3,1,H
1958-03-01,1957,Rotherham United,Sheffield United,1-6,1,6,2,2,7,-5,A
1958-03-01,1957,Stoke City,Notts County,0-1,0,1,2,2,1,-1,A
1958-03-05,1957,Huddersfield Town,Blackburn Rovers,2-1,2,1,2,2,3,1,H
1958-03-05,1957,Liverpool,Derby County,2-0,2,0,2,2,2,2,H
1958-03-08,1957,Barnsley,Doncaster Rovers,1-1,1,1,2,2,2,0,D
1958-03-08,1957,Blackburn Rovers,Grimsby Town,3-0,3,0,2,2,3,3,H
1958-03-08,1957,Bristol Rovers,Liverpool,3-1,3,1,2,2,4,2,H
1958-03-08,1957,Derby County,Middlesbrough,2-1,2,1,2,2,3,1,H
1958-03-08,1957,Fulham,Charlton Athletic,3-1,3,1,2,2,4,2,H
1958-03-08,1957,Ipswich Town,Stoke City,1-3,1,3,2,2,4,-2,A
1958-03-08,1957,Notts County,Bristol City,0-1,0,1,2,2,1,-1,A
1958-03-08,1957,Sheffield United,Huddersfield Town,3-2,3,2,2,2,5,1,H
1958-03-08,1957,Swansea City,Leyton Orient,1-2,1,2,2,2,3,-1,A
1958-03-08,1957,West Ham United,Rotherham United,8-0,8,0,2,2,8,8,H
1958-03-13,1957,Leyton Orient,Fulham,1-3,1,3,2,2,4,-2,A
1958-03-15,1957,Bristol City,Ipswich Town,1-0,1,0,2,2,1,1,H
1958-03-15,1957,Cardiff City,Notts County,2-0,2,0,2,2,2,2,H
1958-03-15,1957,Charlton Athletic,Swansea City,1-1,1,1,2,2,2,0,D
1958-03-15,1957,Doncaster Rovers,Fulham,1-6,1,6,2,2,7,-5,A
1958-03-15,1957,Grimsby Town,Sheffield United,1-3,1,3,2,2,4,-2,A
1958-03-15,1957,Huddersfield Town,West Ham United,3-1,3,1,2,2,4,2,H
1958-03-15,1957,Leyton Orient,Derby County,1-1,1,1,2,2,2,0,D
1958-03-15,1957,Liverpool,Lincoln City,1-0,1,0,2,2,1,1,H
1958-03-15,1957,Middlesbrough,Bristol Rovers,4-3,4,3,2,2,7,1,H
1958-03-15,1957,Rotherham United,Barnsley,4-1,4,1,2,2,5,3,H
1958-03-15,1957,Stoke City,Blackburn Rovers,2-4,2,4,2,2,6,-2,A
1958-03-19,1957,Middlesbrough,Leyton Orient,2-0,2,0,2,2,2,2,H
1958-03-22,1957,Barnsley,Huddersfield Town,2-3,2,3,2,2,5,-1,A
1958-03-22,1957,Bristol Rovers,Leyton Orient,4-0,4,0,2,2,4,4,H
1958-03-22,1957,Derby County,Charlton Athletic,1-3,1,3,2,2,4,-2,A
1958-03-22,1957,Ipswich Town,Cardiff City,3-1,3,1,2,2,4,2,H
1958-03-22,1957,Lincoln City,Middlesbrough,2-3,2,3,2,2,5,-1,A
1958-03-22,1957,Notts County,Liverpool,0-2,0,2,2,2,2,-2,A
1958-03-22,1957,Sheffield United,Stoke City,3-0,3,0,2,2,3,3,H
1958-03-22,1957,Swansea City,Doncaster Rovers,4-3,4,3,2,2,7,1,H
1958-03-22,1957,West Ham United,Grimsby Town,2-0,2,0,2,2,2,2,H
1958-03-24,1957,Blackburn Rovers,Bristol City,5-0,5,0,2,2,5,5,H
1958-03-26,1957,Cardiff City,Bristol Rovers,0-2,0,2,2,2,2,-2,A
1958-03-29,1957,Bristol City,Sheffield United,1-4,1,4,2,2,5,-3,A
1958-03-29,1957,Cardiff City,Blackburn Rovers,4-3,4,3,2,2,7,1,H
1958-03-29,1957,Charlton Athletic,Bristol Rovers,2-3,2,3,2,2,5,-1,A
1958-03-29,1957,Doncaster Rovers,Derby County,1-2,1,2,2,2,3,-1,A
1958-03-29,1957,Grimsby Town,Barnsley,2-1,2,1,2,2,3,1,H
1958-03-29,1957,Huddersfield Town,Fulham,0-3,0,3,2,2,3,-3,A
1958-03-29,1957,Leyton Orient,Lincoln City,1-0,1,0,2,2,1,1,H
1958-03-29,1957,Liverpool,Ipswich Town,3-1,3,1,2,2,4,2,H
1958-03-29,1957,Middlesbrough,Notts County,3-1,3,1,2,2,4,2,H
1958-03-29,1957,Rotherham United,Swansea City,5-2,5,2,2,2,7,3,H
1958-03-29,1957,Stoke City,West Ham United,1-4,1,4,2,2,5,-3,A
1958-04-04,1957,Bristol Rovers,Fulham,2-2,2,2,2,2,4,0,D
1958-04-04,1957,Cardiff City,Bristol City,2-3,2,3,2,2,5,-1,A
1958-04-04,1957,Charlton Athletic,Rotherham United,4-0,4,0,2,2,4,4,H
1958-04-04,1957,Doncaster Rovers,Blackburn Rovers,1-5,1,5,2,2,6,-4,A
1958-04-04,1957,Grimsby Town,Middlesbrough,4-1,4,1,2,2,5,3,H
1958-04-04,1957,Leyton Orient,Huddersfield Town,3-1,3,1,2,2,4,2,H
1958-04-04,1957,West Ham United,Notts County,3-1,3,1,2,2,4,2,H
1958-04-05,1957,Barnsley,Leyton Orient,3-0,3,0,2,2,3,3,H
1958-04-05,1957,Blackburn Rovers,Rotherham United,5-0,5,0,2,2,5,5,H
1958-04-05,1957,Bristol Rovers,Bristol City,3-3,3,3,2,2,6,0,D
1958-04-05,1957,Derby County,Cardiff City,0-2,0,2,2,2,2,-2,A
1958-04-05,1957,Ipswich Town,Huddersfield Town,4-0,4,0,2,2,4,4,H
1958-04-05,1957,Lincoln City,Stoke City,1-3,1,3,2,2,4,-2,A
1958-04-05,1957,Notts County,Grimsby Town,2-0,2,0,2,2,2,2,H
1958-04-05,1957,Sheffield United,Doncaster Rovers,3-0,3,0,2,2,3,3,H
1958-04-05,1957,Swansea City,Liverpool,0-2,0,2,2,2,2,-2,A
1958-04-05,1957,West Ham United,Charlton Athletic,0-0,0,0,2,2,0,0,D
1958-04-07,1957,Blackburn Rovers,Doncaster Rovers,3-2,3,2,2,2,5,1,H
1958-04-07,1957,Bristol City,Cardiff City,2-0,2,0,2,2,2,2,H
1958-04-07,1957,Derby County,Swansea City,1-0,1,0,2,2,1,1,H
1958-04-07,1957,Fulham,Bristol Rovers,3-0,3,0,2,2,3,3,H
1958-04-07,1957,Ipswich Town,Sheffield United,1-0,1,0,2,2,1,1,H
1958-04-07,1957,Lincoln City,Barnsley,1-3,1,3,2,2,4,-2,A
1958-04-07,1957,Liverpool,Stoke City,3-0,3,0,2,2,3,3,H
1958-04-07,1957,Middlesbrough,Grimsby Town,5-1,5,1,2,2,6,4,H
1958-04-07,1957,Rotherham United,Charlton Athletic,1-5,1,5,2,2,6,-4,A
1958-04-08,1957,Barnsley,Lincoln City,1-3,1,3,2,2,4,-2,A
1958-04-08,1957,Huddersfield Town,Leyton Orient,2-0,2,0,2,2,2,2,H
1958-04-08,1957,Notts County,West Ham United,1-0,1,0,2,2,1,1,H
1958-04-08,1957,Sheffield United,Ipswich Town,1-1,1,1,2,2,2,0,D
1958-04-08,1957,Swansea City,Derby County,7-0,7,0,2,2,7,7,H
1958-04-12,1957,Bristol City,Barnsley,5-0,5,0,2,2,5,5,H
1958-04-12,1957,Cardiff City,West Ham United,0-3,0,3,2,2,3,-3,A
1958-04-12,1957,Charlton Athletic,Notts County,4-1,4,1,2,2,5,3,H
1958-04-12,1957,Doncaster Rovers,Lincoln City,1-3,1,3,2,2,4,-2,A
1958-04-12,1957,Grimsby Town,Swansea City,2-2,2,2,2,2,4,0,D
1958-04-12,1957,Huddersfield Town,Derby County,0-0,0,0,2,2,0,0,D
1958-04-12,1957,Leyton Orient,Ipswich Town,2-0,2,0,2,2,2,2,H
1958-04-12,1957,Liverpool,Sheffield United,1-0,1,0,2,2,1,1,H
1958-04-12,1957,Middlesbrough,Blackburn Rovers,2-3,2,3,2,2,5,-1,A
1958-04-12,1957,Rotherham United,Bristol Rovers,2-0,2,0,2,2,2,2,H
1958-04-12,1957,Stoke City,Fulham,1-2,1,2,2,2,3,-1,A
1958-04-19,1957,Barnsley,Cardiff City,1-1,1,1,2,2,2,0,D
1958-04-19,1957,Blackburn Rovers,Leyton Orient,4-1,4,1,2,2,5,3,H
1958-04-19,1957,Bristol Rovers,Huddersfield Town,1-1,1,1,2,2,2,0,D
1958-04-19,1957,Derby County,Grimsby Town,1-0,1,0,2,2,1,1,H
1958-04-19,1957,Fulham,Bristol City,3-4,3,4,2,2,7,-1,A
1958-04-19,1957,Ipswich Town,Charlton Athletic,1-4,1,4,2,2,5,-3,A
1958-04-19,1957,Lincoln City,Rotherham United,2-0,2,0,2,2,2,2,H
1958-04-19,1957,Notts County,Doncaster Rovers,0-5,0,5,2,2,5,-5,A
1958-04-19,1957,Sheffield United,Middlesbrough,3-2,3,2,2,2,5,1,H
1958-04-19,1957,Swansea City,Stoke City,4-1,4,1,2,2,5,3,H
1958-04-19,1957,West Ham United,Liverpool,1-1,1,1,2,2,2,0,D
1958-04-21,1957,Fulham,Middlesbrough,0-1,0,1,2,2,1,-1,A
1958-04-21,1957,Rotherham United,Cardiff City,3-1,3,1,2,2,4,2,H
1958-04-22,1957,Grimsby Town,Stoke City,0-0,0,0,2,2,0,0,D
1958-04-23,1957,Barnsley,Sheffield United,0-2,0,2,2,2,2,-2,A
1958-04-23,1957,Fulham,Blackburn Rovers,1-1,1,1,2,2,2,0,D
1958-04-23,1957,Lincoln City,Bristol City,4-0,4,0,2,2,4,4,H
1958-04-23,1957,Notts County,Bristol Rovers,0-0,0,0,2,2,0,0,D
1958-04-26,1957,Bristol City,Swansea City,1-2,1,2,2,2,3,-1,A
1958-04-26,1957,Cardiff City,Fulham,3-0,3,0,2,2,3,3,H
1958-04-26,1957,Charlton Athletic,Blackburn Rovers,3-4,3,4,2,2,7,-1,A
1958-04-26,1957,Doncaster Rovers,Ipswich Town,1-1,1,1,2,2,2,0,D
1958-04-26,1957,Grimsby Town,Bristol Rovers,3-2,3,2,2,2,5,1,H
1958-04-26,1957,Huddersfield Town,Lincoln City,0-1,0,1,2,2,1,-1,A
1958-04-26,1957,Leyton Orient,Sheffield United,0-1,0,1,2,2,1,-1,A
1958-04-26,1957,Liverpool,Barnsley,1-1,1,1,2,2,2,0,D
1958-04-26,1957,Middlesbrough,West Ham United,1-3,1,3,2,2,4,-2,A
1958-04-26,1957,Rotherham United,Notts County,1-3,1,3,2,2,4,-2,A
1958-04-26,1957,Stoke City,Derby County,2-1,2,1,2,2,3,1,H
1958-04-28,1957,Sheffield United,Fulham,1-1,1,1,2,2,2,0,D
1958-04-30,1957,Lincoln City,Cardiff City,3-1,3,1,2,2,4,2,H
1958-05-01,1957,Fulham,Rotherham United,3-1,3,1,2,2,4,2,H
1958-08-23,1958,Bristol City,Rotherham United,6-1,6,1,2,2,7,5,H
1958-08-23,1958,Cardiff City,Barnsley,0-1,0,1,2,2,1,-1,A
1958-08-23,1958,Charlton Athletic,Sheffield United,1-1,1,1,2,2,2,0,D
1958-08-23,1958,Fulham,Stoke City,6-1,6,1,2,2,7,5,H
1958-08-23,1958,Huddersfield Town,Derby County,1-1,1,1,2,2,2,0,D
1958-08-23,1958,Leyton Orient,Bristol Rovers,1-3,1,3,2,2,4,-2,A
1958-08-23,1958,Lincoln City,Sunderland,3-1,3,1,2,2,4,2,H
1958-08-23,1958,Liverpool,Grimsby Town,3-3,3,3,2,2,6,0,D
1958-08-23,1958,Middlesbrough,Brighton & Hove Albion,9-0,9,0,2,2,9,9,H
1958-08-23,1958,Scunthorpe United,Ipswich Town,1-1,1,1,2,2,2,0,D
1958-08-23,1958,Sheffield Wednesday,Swansea City,2-1,2,1,2,2,3,1,H
1958-08-25,1958,Sheffield United,Middlesbrough,0-1,0,1,2,2,1,-1,A
1958-08-26,1958,Grimsby Town,Lincoln City,4-2,4,2,2,2,6,2,H
1958-08-27,1958,Barnsley,Bristol City,4-7,4,7,2,2,11,-3,A
1958-08-27,1958,Huddersfield Town,Cardiff City,3-0,3,0,2,2,3,3,H
1958-08-27,1958,Ipswich Town,Leyton Orient,2-1,2,1,2,2,3,1,H
1958-08-27,1958,Stoke City,Sheffield Wednesday,3-0,3,0,2,2,3,3,H
1958-08-27,1958,Sunderland,Fulham,1-2,1,2,2,2,3,-1,A
1958-08-28,1958,Rotherham United,Charlton Athletic,4-3,4,3,2,2,7,1,H
1958-08-28,1958,Swansea City,Scunthorpe United,3-0,3,0,2,2,3,3,H
1958-08-30,1958,Barnsley,Huddersfield Town,1-0,1,0,2,2,1,1,H
1958-08-30,1958,Brighton & Hove Albion,Charlton Athletic,2-2,2,2,2,2,4,0,D
1958-08-30,1958,Bristol Rovers,Scunthorpe United,4-0,4,0,2,2,4,4,H
1958-08-30,1958,Derby County,Leyton Orient,1-2,1,2,2,2,3,-1,A
1958-08-30,1958,Grimsby Town,Middlesbrough,3-2,3,2,2,2,5,1,H
1958-08-30,1958,Ipswich Town,Sheffield Wednesday,0-2,0,2,2,2,2,-2,A
1958-08-30,1958,Rotherham United,Cardiff City,1-0,1,0,2,2,1,1,H
1958-08-30,1958,Sheffield United,Bristol City,4-0,4,0,2,2,4,4,H
1958-08-30,1958,Stoke City,Lincoln City,1-0,1,0,2,2,1,1,H
1958-08-30,1958,Sunderland,Liverpool,2-1,2,1,2,2,3,1,H
1958-08-30,1958,Swansea City,Fulham,1-2,1,2,2,2,3,-1,A
1958-09-02,1958,Bristol City,Barnsley,3-1,3,1,2,2,4,2,H
1958-09-03,1958,Cardiff City,Huddersfield Town,3-2,3,2,2,2,5,1,H
1958-09-03,1958,Derby County,Bristol Rovers,3-2,3,2,2,2,5,1,H
1958-09-03,1958,Fulham,Sunderland,6-2,6,2,2,2,8,4,H
1958-09-03,1958,Lincoln City,Grimsby Town,4-4,4,4,2,2,8,0,D
1958-09-03,1958,Liverpool,Brighton & Hove Albion,5-0,5,0,2,2,5,5,H
1958-09-03,1958,Middlesbrough,Sheffield United,0-0,0,0,2,2,0,0,D
1958-09-03,1958,Sheffield Wednesday,Stoke City,4-1,4,1,2,2,5,3,H
1958-09-04,1958,Charlton Athletic,Rotherham United,5-2,5,2,2,2,7,3,H
1958-09-04,1958,Leyton Orient,Ipswich Town,2-0,2,0,2,2,2,2,H
1958-09-04,1958,Scunthorpe United,Swansea City,3-1,3,1,2,2,4,2,H
1958-09-06,1958,Bristol City,Brighton & Hove Albion,3-0,3,0,2,2,3,3,H
1958-09-06,1958,Cardiff City,Sheffield United,3-1,3,1,2,2,4,2,H
1958-09-06,1958,Charlton Athletic,Grimsby Town,2-1,2,1,2,2,3,1,H
1958-09-06,1958,Fulham,Ipswich Town,3-2,3,2,2,2,5,1,H
1958-09-06,1958,Huddersfield Town,Rotherham United,3-0,3,0,2,2,3,3,H
1958-09-06,1958,Leyton Orient,Barnsley,5-1,5,1,2,2,6,4,H
1958-09-06,1958,Lincoln City,Swansea City,1-2,1,2,2,2,3,-1,A
1958-09-06,1958,Middlesbrough,Liverpool,2-1,2,1,2,2,3,1,H
1958-09-06,1958,Scunthorpe United,Derby County,2-2,2,2,2,2,4,0,D
1958-09-06,1958,Sheffield Wednesday,Bristol Rovers,3-1,3,1,2,2,4,2,H
1958-09-06,1958,Sunderland,Stoke City,3-1,3,1,2,2,4,2,H
1958-09-08,1958,Bristol Rovers,Cardiff City,2-0,2,0,2,2,2,2,H
1958-09-09,1958,Huddersfield Town,Bristol City,0-1,0,1,2,2,1,-1,A
1958-09-10,1958,Barnsley,Charlton Athletic,7-1,7,1,2,2,8,6,H
1958-09-10,1958,Brighton & Hove Albion,Grimsby Town,2-0,2,0,2,2,2,2,H
1958-09-10,1958,Ipswich Town,Derby County,1-1,1,1,2,2,2,0,D
1958-09-10,1958,Lincoln City,Fulham,2-4,2,4,2,2,6,-2,A
1958-09-10,1958,Liverpool,Sheffield United,2-1,2,1,2,2,3,1,H
1958-09-10,1958,Stoke City,Scunthorpe United,4-3,4,3,2,2,7,1,H
1958-09-10,1958,Sunderland,Sheffield Wednesday,3-3,3,3,2,2,6,0,D
1958-09-11,1958,Rotherham United,Middlesbrough,1-4,1,4,2,2,5,-3,A
1958-09-11,1958,Swansea City,Leyton Orient,3-3,3,3,2,2,6,0,D
1958-09-13,1958,Brighton & Hove Albion,Cardiff City,2-2,2,2,2,2,4,0,D
1958-09-13,1958,Bristol Rovers,Fulham,0-0,0,0,2,2,0,0,D
1958-09-13,1958,Derby County,Sheffield Wednesday,1-4,1,4,2,2,5,-3,A
1958-09-13,1958,Grimsby Town,Bristol City,2-0,2,0,2,2,2,2,H
1958-09-13,1958,Ipswich Town,Lincoln City,4-1,4,1,2,2,5,3,H
1958-09-13,1958,Leyton Orient,Scunthorpe United,2-1,2,1,2,2,3,1,H
1958-09-13,1958,Liverpool,Charlton Athletic,3-0,3,0,2,2,3,3,H
1958-09-13,1958,Rotherham United,Barnsley,3-0,3,0,2,2,3,3,H
1958-09-13,1958,Sheffield United,Huddersfield Town,0-0,0,0,2,2,0,0,D
1958-09-13,1958,Stoke City,Middlesbrough,3-1,3,1,2,2,4,2,H
1958-09-13,1958,Swansea City,Sunderland,5-0,5,0,2,2,5,5,H
1958-09-15,1958,Sheffield United,Liverpool,2-0,2,0,2,2,2,2,H
1958-09-16,1958,Bristol City,Huddersfield Town,2-1,2,1,2,2,3,1,H
1958-09-16,1958,Grimsby Town,Brighton & Hove Albion,1-1,1,1,2,2,2,0,D
1958-09-17,1958,Cardiff City,Bristol Rovers,2-4,2,4,2,2,6,-2,A
1958-09-17,1958,Derby County,Ipswich Town,3-2,3,2,2,2,5,1,H
1958-09-17,1958,Fulham,Lincoln City,4-2,4,2,2,2,6,2,H
1958-09-17,1958,Middlesbrough,Rotherham United,1-2,1,2,2,2,3,-1,A
1958-09-17,1958,Sheffield Wednesday,Sunderland,6-0,6,0,2,2,6,6,H
1958-09-18,1958,Charlton Athletic,Barnsley,4-0,4,0,2,2,4,4,H
1958-09-18,1958,Leyton Orient,Swansea City,0-0,0,0,2,2,0,0,D
1958-09-18,1958,Scunthorpe United,Stoke City,1-1,1,1,2,2,2,0,D
1958-09-20,1958,Barnsley,Sheffield United,1-3,1,3,2,2,4,-2,A
1958-09-20,1958,Bristol City,Liverpool,1-3,1,3,2,2,4,-2,A
1958-09-20,1958,Cardiff City,Grimsby Town,4-1,4,1,2,2,5,3,H
1958-09-20,1958,Charlton Athletic,Middlesbrough,1-0,1,0,2,2,1,1,H
1958-09-20,1958,Fulham,Derby County,4-2,4,2,2,2,6,2,H
1958-09-20,1958,Huddersfield Town,Brighton & Hove Albion,3-2,3,2,2,2,5,1,H
1958-09-20,1958,Lincoln City,Bristol Rovers,4-1,4,1,2,2,5,3,H
1958-09-20,1958,Scunthorpe United,Rotherham United,2-0,2,0,2,2,2,2,H
1958-09-20,1958,Sheffield Wednesday,Leyton Orient,2-0,2,0,2,2,2,2,H
1958-09-20,1958,Stoke City,Swansea City,3-0,3,0,2,2,3,3,H
1958-09-20,1958,Sunderland,Ipswich Town,0-2,0,2,2,2,2,-2,A
1958-09-22,1958,Bristol Rovers,Derby County,2-1,2,1,2,2,3,1,H
1958-09-24,1958,Brighton & Hove Albion,Liverpool,2-2,2,2,2,2,4,0,D
1958-09-27,1958,Brighton & Hove Albion,Barnsley,1-1,1,1,2,2,2,0,D
1958-09-27,1958,Bristol Rovers,Sunderland,2-1,2,1,2,2,3,1,H
1958-09-27,1958,Derby County,Lincoln City,1-0,1,0,2,2,1,1,H
1958-09-27,1958,Grimsby Town,Huddersfield Town,2-1,2,1,2,2,3,1,H
1958-09-27,1958,Ipswich Town,Stoke City,0-2,0,2,2,2,2,-2,A
1958-09-27,1958,Leyton Orient,Fulham,0-2,0,2,2,2,2,-2,A
1958-09-27,1958,Liverpool,Cardiff City,1-2,1,2,2,2,3,-1,A
1958-09-27,1958,Middlesbrough,Bristol City,0-0,0,0,2,2,0,0,D
1958-09-27,1958,Scunthorpe United,Sheffield Wednesday,1-4,1,4,2,2,5,-3,A
1958-09-27,1958,Sheffield United,Rotherham United,2-0,2,0,2,2,2,2,H
1958-09-27,1958,Swansea City,Charlton Athletic,2-2,2,2,2,2,4,0,D
1958-10-04,1958,Barnsley,Grimsby Town,3-1,3,1,2,2,4,2,H
1958-10-04,1958,Bristol City,Charlton Athletic,2-4,2,4,2,2,6,-2,A
1958-10-04,1958,Cardiff City,Middlesbrough,3-2,3,2,2,2,5,1,H
1958-10-04,1958,Fulham,Scunthorpe United,1-1,1,1,2,2,2,0,D
1958-10-04,1958,Huddersfield Town,Liverpool,5-0,5,0,2,2,5,5,H
1958-10-04,1958,Lincoln City,Leyton Orient,2-0,2,0,2,2,2,2,H
1958-10-04,1958,Rotherham United,Brighton & Hove Albion,0-1,0,1,2,2,1,-1,A
1958-10-04,1958,Sheffield Wednesday,Sheffield United,2-0,2,0,2,2,2,2,H
1958-10-04,1958,Stoke City,Bristol Rovers,2-2,2,2,2,2,4,0,D
1958-10-04,1958,Sunderland,Derby County,3-0,3,0,2,2,3,3,H
1958-10-04,1958,Swansea City,Ipswich Town,4-2,4,2,2,2,6,2,H
1958-10-11,1958,Barnsley,Derby County,0-0,0,0,2,2,0,0,D
1958-10-11,1958,Brighton & Hove Albion,Sheffield Wednesday,1-3,1,3,2,2,4,-2,A
1958-10-11,1958,Bristol City,Swansea City,4-0,4,0,2,2,4,4,H
1958-10-11,1958,Cardiff City,Ipswich Town,1-2,1,2,2,2,3,-1,A
1958-10-11,1958,Charlton Athletic,Stoke City,1-2,1,2,2,2,3,-1,A
1958-10-11,1958,Grimsby Town,Fulham,2-2,2,2,2,2,4,0,D
1958-10-11,1958,Huddersfield Town,Bristol Rovers,1-2,1,2,2,2,3,-1,A
1958-10-11,1958,Liverpool,Lincoln City,3-2,3,2,2,2,5,1,H
1958-10-11,1958,Middlesbrough,Sunderland,0-0,0,0,2,2,0,0,D
1958-10-11,1958,Rotherham United,Leyton Orient,1-1,1,1,2,2,2,0,D
1958-10-11,1958,Sheffield United,Scunthorpe United,4-1,4,1,2,2,5,3,H
1958-10-18,1958,Bristol Rovers,Barnsley,0-2,0,2,2,2,2,-2,A
1958-10-18,1958,Derby County,Rotherham United,1-1,1,1,2,2,2,0,D
1958-10-18,1958,Fulham,Liverpool,0-1,0,1,2,2,1,-1,A
1958-10-18,1958,Ipswich Town,Huddersfield Town,0-0,0,0,2,2,0,0,D
1958-10-18,1958,Leyton Orient,Sheffield United,1-1,1,1,2,2,2,0,D
1958-10-18,1958,Lincoln City,Middlesbrough,1-1,1,1,2,2,2,0,D
1958-10-18,1958,Scunthorpe United,Brighton & Hove Albion,2-3,2,3,2,2,5,-1,A
1958-10-18,1958,Sheffield Wednesday,Grimsby Town,6-0,6,0,2,2,6,6,H
1958-10-18,1958,Stoke City,Bristol City,2-1,2,1,2,2,3,1,H
1958-10-18,1958,Sunderland,Charlton Athletic,0-3,0,3,2,2,3,-3,A
1958-10-22,1958,Stoke City,Derby County,2-1,2,1,2,2,3,1,H
1958-10-25,1958,Barnsley,Ipswich Town,3-0,3,0,2,2,3,3,H
1958-10-25,1958,Brighton & Hove Albion,Leyton Orient,2-2,2,2,2,2,4,0,D
1958-10-25,1958,Bristol City,Sunderland,4-1,4,1,2,2,5,3,H
1958-10-25,1958,Cardiff City,Stoke City,2-1,2,1,2,2,3,1,H
1958-10-25,1958,Charlton Athletic,Lincoln City,3-2,3,2,2,2,5,1,H
1958-10-25,1958,Grimsby Town,Scunthorpe United,1-1,1,1,2,2,2,0,D
1958-10-25,1958,Huddersfield Town,Swansea City,3-2,3,2,2,2,5,1,H
1958-10-25,1958,Liverpool,Sheffield Wednesday,3-2,3,2,2,2,5,1,H
1958-10-25,1958,Middlesbrough,Fulham,2-3,2,3,2,2,5,-1,A
1958-10-25,1958,Rotherham United,Bristol Rovers,3-3,3,3,2,2,6,0,D
1958-10-25,1958,Sheffield United,Derby County,1-2,1,2,2,2,3,-1,A
1958-11-01,1958,Bristol Rovers,Bristol City,1-2,1,2,2,2,3,-1,A
1958-11-01,1958,Derby County,Cardiff City,1-3,1,3,2,2,4,-2,A
1958-11-01,1958,Fulham,Sheffield United,4-2,4,2,2,2,6,2,H
1958-11-01,1958,Ipswich Town,Charlton Athletic,3-1,3,1,2,2,4,2,H
1958-11-01,1958,Leyton Orient,Huddersfield Town,2-5,2,5,2,2,7,-3,A
1958-11-01,1958,Lincoln City,Brighton & Hove Albion,4-2,4,2,2,2,6,2,H
1958-11-01,1958,Scunthorpe United,Barnsley,1-0,1,0,2,2,1,1,H
1958-11-01,1958,Sheffield Wednesday,Rotherham United,5-0,5,0,2,2,5,5,H
1958-11-01,1958,Stoke City,Liverpool,0-2,0,2,2,2,2,-2,A
1958-11-01,1958,Sunderland,Grimsby Town,1-0,1,0,2,2,1,1,H
1958-11-01,1958,Swansea City,Middlesbrough,5-2,5,2,2,2,7,3,H
1958-11-08,1958,Barnsley,Stoke City,2-1,2,1,2,2,3,1,H
1958-11-08,1958,Brighton & Hove Albion,Bristol Rovers,1-1,1,1,2,2,2,0,D
1958-11-08,1958,Bristol City,Fulham,1-1,1,1,2,2,2,0,D
1958-11-08,1958,Cardiff City,Lincoln City,3-0,3,0,2,2,3,3,H
1958-11-08,1958,Charlton Athletic,Sheffield Wednesday,3-3,3,3,2,2,6,0,D
1958-11-08,1958,Grimsby Town,Derby County,3-0,3,0,2,2,3,3,H
1958-11-08,1958,Huddersfield Town,Sunderland,1-1,1,1,2,2,2,0,D
1958-11-08,1958,Liverpool,Leyton Orient,3-0,3,0,2,2,3,3,H
1958-11-08,1958,Middlesbrough,Scunthorpe United,6-1,6,1,2,2,7,5,H
1958-11-08,1958,Rotherham United,Swansea City,3-3,3,3,2,2,6,0,D
1958-11-08,1958,Sheffield United,Ipswich Town,2-0,2,0,2,2,2,2,H
1958-11-15,1958,Bristol Rovers,Grimsby Town,7-3,7,3,2,2,10,4,H
1958-11-15,1958,Derby County,Liverpool,3-2,3,2,2,2,5,1,H
1958-11-15,1958,Fulham,Cardiff City,2-1,2,1,2,2,3,1,H
1958-11-15,1958,Ipswich Town,Brighton & Hove Albion,5-3,5,3,2,2,8,2,H
1958-11-15,1958,Leyton Orient,Middlesbrough,5-2,5,2,2,2,7,3,H
1958-11-15,1958,Lincoln City,Huddersfield Town,1-1,1,1,2,2,2,0,D
1958-11-15,1958,Scunthorpe United,Charlton Athletic,3-3,3,3,2,2,6,0,D
1958-11-15,1958,Sheffield Wednesday,Bristol City,2-3,2,3,2,2,5,-1,A
1958-11-15,1958,Stoke City,Rotherham United,3-0,3,0,2,2,3,3,H
1958-11-15,1958,Sunderland,Barnsley,2-2,2,2,2,2,4,0,D
1958-11-15,1958,Swansea City,Sheffield United,0-2,0,2,2,2,2,-2,A
1958-11-22,1958,Barnsley,Lincoln City,2-2,2,2,2,2,4,0,D
1958-11-22,1958,Brighton & Hove Albion,Swansea City,2-2,2,2,2,2,4,0,D
1958-11-22,1958,Bristol City,Scunthorpe United,0-1,0,1,2,2,1,-1,A
1958-11-22,1958,Cardiff City,Sheffield Wednesday,2-2,2,2,2,2,4,0,D
1958-11-22,1958,Charlton Athletic,Leyton Orient,4-1,4,1,2,2,5,3,H
1958-11-22,1958,Grimsby Town,Ipswich Town,2-3,2,3,2,2,5,-1,A
1958-11-22,1958,Huddersfield Town,Fulham,2-1,2,1,2,2,3,1,H
1958-11-22,1958,Liverpool,Bristol Rovers,2-1,2,1,2,2,3,1,H
1958-11-22,1958,Middlesbrough,Derby County,5-0,5,0,2,2,5,5,H
1958-11-22,1958,Rotherham United,Sunderland,0-4,0,4,2,2,4,-4,A
1958-11-22,1958,Sheffield United,Stoke City,2-1,2,1,2,2,3,1,H
1958-11-29,1958,Bristol Rovers,Middlesbrough,3-1,3,1,2,2,4,2,H
1958-11-29,1958,Derby County,Charlton Athletic,3-2,3,2,2,2,5,1,H
1958-11-29,1958,Fulham,Barnsley,5-2,5,2,2,2,7,3,H
1958-11-29,1958,Ipswich Town,Liverpool,2-0,2,0,2,2,2,2,H
1958-11-29,1958,Leyton Orient,Bristol City,4-2,4,2,2,2,6,2,H
1958-11-29,1958,Lincoln City,Rotherham United,1-0,1,0,2,2,1,1,H
1958-11-29,1958,Sheffield Wednesday,Huddersfield Town,4-1,4,1,2,2,5,3,H
1958-11-29,1958,Stoke City,Brighton & Hove Albion,3-0,3,0,2,2,3,3,H
1958-11-29,1958,Sunderland,Sheffield United,4-1,4,1,2,2,5,3,H
1958-11-29,1958,Swansea City,Grimsby Town,1-1,1,1,2,2,2,0,D
1958-12-06,1958,Barnsley,Sheffield Wednesday,0-1,0,1,2,2,1,-1,A
1958-12-06,1958,Brighton & Hove Albion,Sunderland,2-0,2,0,2,2,2,2,H
1958-12-06,1958,Bristol City,Derby County,1-3,1,3,2,2,4,-2,A
1958-12-06,1958,Cardiff City,Leyton Orient,2-1,2,1,2,2,3,1,H
1958-12-06,1958,Charlton Athletic,Bristol Rovers,4-3,4,3,2,2,7,1,H
1958-12-06,1958,Grimsby Town,Stoke City,2-2,2,2,2,2,4,0,D
1958-12-06,1958,Huddersfield Town,Scunthorpe United,0-1,0,1,2,2,1,-1,A
1958-12-06,1958,Liverpool,Swansea City,4-0,4,0,2,2,4,4,H
1958-12-06,1958,Middlesbrough,Ipswich Town,2-3,2,3,2,2,5,-1,A
1958-12-06,1958,Rotherham United,Fulham,4-0,4,0,2,2,4,4,H
1958-12-06,1958,Sheffield United,Lincoln City,6-1,6,1,2,2,7,5,H
1958-12-13,1958,Bristol Rovers,Sheffield United,1-1,1,1,2,2,2,0,D
1958-12-13,1958,Derby County,Brighton & Hove Albion,1-3,1,3,2,2,4,-2,A
1958-12-13,1958,Fulham,Charlton Athletic,2-1,2,1,2,2,3,1,H
1958-12-13,1958,Ipswich Town,Rotherham United,1-0,1,0,2,2,1,1,H
1958-12-13,1958,Leyton Orient,Grimsby Town,0-1,0,1,2,2,1,-1,A
1958-12-13,1958,Lincoln City,Bristol City,0-2,0,2,2,2,2,-2,A
1958-12-13,1958,Scunthorpe United,Liverpool,1-2,1,2,2,2,3,-1,A
1958-12-13,1958,Sheffield Wednesday,Middlesbrough,2-0,2,0,2,2,2,2,H
1958-12-13,1958,Stoke City,Huddersfield Town,5-1,5,1,2,2,6,4,H
1958-12-13,1958,Sunderland,Cardiff City,0-2,0,2,2,2,2,-2,A
1958-12-13,1958,Swansea City,Barnsley,2-1,2,1,2,2,3,1,H
1958-12-18,1958,Scunthorpe United,Cardiff City,1-0,1,0,2,2,1,1,H
1958-12-20,1958,Barnsley,Cardiff City,3-2,3,2,2,2,5,1,H
1958-12-20,1958,Brighton & Hove Albion,Middlesbrough,4-6,4,6,2,2,10,-2,A
1958-12-20,1958,Bristol Rovers,Leyton Orient,1-3,1,3,2,2,4,-2,A
1958-12-20,1958,Derby County,Huddersfield Town,3-1,3,1,2,2,4,2,H
1958-12-20,1958,Grimsby Town,Liverpool,2-3,2,3,2,2,5,-1,A
1958-12-20,1958,Ipswich Town,Scunthorpe United,3-1,3,1,2,2,4,2,H
1958-12-20,1958,Rotherham United,Bristol City,1-2,1,2,2,2,3,-1,A
1958-12-20,1958,Sheffield United,Charlton Athletic,5-0,5,0,2,2,5,5,H
1958-12-20,1958,Stoke City,Fulham,4-1,4,1,2,2,5,3,H
1958-12-20,1958,Sunderland,Lincoln City,2-0,2,0,2,2,2,2,H
1958-12-20,1958,Swansea City,Sheffield Wednesday,4-0,4,0,2,2,4,4,H
1958-12-25,1958,Grimsby Town,Sheffield United,1-2,1,2,2,2,3,-1,A
1958-12-25,1958,Huddersfield Town,Charlton Athletic,1-0,1,0,2,2,1,1,H
1958-12-26,1958,Bristol City,Cardiff City,2-3,2,3,2,2,5,-1,A
1958-12-26,1958,Derby County,Swansea City,3-1,3,1,2,2,4,2,H
1958-12-26,1958,Fulham,Brighton & Hove Albion,3-1,3,1,2,2,4,2,H
1958-12-26,1958,Ipswich Town,Bristol Rovers,0-2,0,2,2,2,2,-2,A
1958-12-26,1958,Leyton Orient,Stoke City,0-1,0,1,2,2,1,-1,A
1958-12-26,1958,Middlesbrough,Barnsley,3-1,3,1,2,2,4,2,H
1958-12-26,1958,Rotherham United,Liverpool,0-1,0,1,2,2,1,-1,A
1958-12-26,1958,Scunthorpe United,Sunderland,3-2,3,2,2,2,5,1,H
1958-12-26,1958,Sheffield Wednesday,Lincoln City,7-0,7,0,2,2,7,7,H
1958-12-27,1958,Barnsley,Middlesbrough,1-0,1,0,2,2,1,1,H
1958-12-27,1958,Brighton & Hove Albion,Fulham,3-0,3,0,2,2,3,3,H
1958-12-27,1958,Bristol Rovers,Ipswich Town,1-1,1,1,2,2,2,0,D
1958-12-27,1958,Cardiff City,Bristol City,1-0,1,0,2,2,1,1,H
1958-12-27,1958,Charlton Athletic,Huddersfield Town,2-1,2,1,2,2,3,1,H
1958-12-27,1958,Lincoln City,Sheffield Wednesday,0-1,0,1,2,2,1,-1,A
1958-12-27,1958,Liverpool,Rotherham United,4-0,4,0,2,2,4,4,H
1958-12-27,1958,Sheffield United,Grimsby Town,2-1,2,1,2,2,3,1,H
1958-12-27,1958,Stoke City,Leyton Orient,3-2,3,2,2,2,5,1,H
1958-12-27,1958,Sunderland,Scunthorpe United,3-1,3,1,2,2,4,2,H
1958-12-27,1958,Swansea City,Derby County,4-4,4,4,2,2,8,0,D
1959-01-01,1958,Middlesbrough,Huddersfield Town,3-1,3,1,2,2,4,2,H
1959-01-01,1958,Sunderland,Leyton Orient,4-0,4,0,2,2,4,4,H
1959-01-03,1958,Bristol City,Sheffield United,3-1,3,1,2,2,4,2,H
1959-01-03,1958,Cardiff City,Rotherham United,1-0,1,0,2,2,1,1,H
1959-01-03,1958,Charlton Athletic,Brighton & Hove Albion,2-3,2,3,2,2,5,-1,A
1959-01-03,1958,Fulham,Swansea City,1-2,1,2,2,2,3,-1,A
1959-01-03,1958,Huddersfield Town,Barnsley,2-1,2,1,2,2,3,1,H
1959-01-03,1958,Leyton Orient,Derby County,1-3,1,3,2,2,4,-2,A
1959-01-03,1958,Lincoln City,Stoke City,3-1,3,1,2,2,4,2,H
1959-01-03,1958,Liverpool,Sunderland,3-1,3,1,2,2,4,2,H
1959-01-03,1958,Scunthorpe United,Bristol Rovers,0-0,0,0,2,2,0,0,D
1959-01-03,1958,Sheffield Wednesday,Ipswich Town,3-1,3,1,2,2,4,2,H
1959-01-17,1958,Brighton & Hove Albion,Bristol City,2-2,2,2,2,2,4,0,D
1959-01-17,1958,Derby County,Scunthorpe United,3-1,3,1,2,2,4,2,H
1959-01-17,1958,Ipswich Town,Fulham,1-2,1,2,2,2,3,-1,A
1959-01-17,1958,Swansea City,Lincoln City,3-1,3,1,2,2,4,2,H
1959-01-31,1958,Barnsley,Rotherham United,1-1,1,1,2,2,2,0,D
1959-01-31,1958,Cardiff City,Brighton & Hove Albion,3-1,3,1,2,2,4,2,H
1959-01-31,1958,Charlton Athletic,Liverpool,2-3,2,3,2,2,5,-1,A
1959-01-31,1958,Fulham,Bristol Rovers,1-0,1,0,2,2,1,1,H
1959-01-31,1958,Huddersfield Town,Sheffield United,0-2,0,2,2,2,2,-2,A
1959-01-31,1958,Lincoln City,Ipswich Town,3-1,3,1,2,2,4,2,H
1959-01-31,1958,Middlesbrough,Stoke City,0-0,0,0,2,2,0,0,D
1959-01-31,1958,Scunthorpe United,Leyton Orient,2-0,2,0,2,2,2,2,H
1959-01-31,1958,Sheffield Wednesday,Derby County,1-1,1,1,2,2,2,0,D
1959-01-31,1958,Sunderland,Swansea City,2-1,2,1,2,2,3,1,H
1959-02-07,1958,Brighton & Hove Albion,Huddersfield Town,2-0,2,0,2,2,2,2,H
1959-02-07,1958,Bristol Rovers,Lincoln City,3-0,3,0,2,2,3,3,H
1959-02-07,1958,Derby County,Fulham,2-0,2,0,2,2,2,2,H
1959-02-07,1958,Grimsby Town,Cardiff City,5-1,5,1,2,2,6,4,H
1959-02-07,1958,Ipswich Town,Sunderland,0-2,0,2,2,2,2,-2,A
1959-02-07,1958,Leyton Orient,Sheffield Wednesday,0-2,0,2,2,2,2,-2,A
1959-02-07,1958,Liverpool,Bristol City,3-2,3,2,2,2,5,1,H
1959-02-07,1958,Middlesbrough,Charlton Athletic,1-3,1,3,2,2,4,-2,A
1959-02-07,1958,Rotherham United,Scunthorpe United,1-0,1,0,2,2,1,1,H
1959-02-07,1958,Sheffield United,Barnsley,5-0,5,0,2,2,5,5,H
1959-02-07,1958,Swansea City,Stoke City,1-0,1,0,2,2,1,1,H
1959-02-14,1958,Barnsley,Brighton & Hove Albion,0-2,0,2,2,2,2,-2,A
1959-02-14,1958,Bristol City,Middlesbrough,2-2,2,2,2,2,4,0,D
1959-02-14,1958,Cardiff City,Liverpool,3-0,3,0,2,2,3,3,H
1959-02-14,1958,Charlton Athletic,Swansea City,2-1,2,1,2,2,3,1,H
1959-02-14,1958,Fulham,Leyton Orient,5-2,5,2,2,2,7,3,H
1959-02-14,1958,Huddersfield Town,Grimsby Town,2-0,2,0,2,2,2,2,H
1959-02-14,1958,Lincoln City,Derby County,1-4,1,4,2,2,5,-3,A
1959-02-14,1958,Sheffield Wednesday,Scunthorpe United,2-0,2,0,2,2,2,2,H
1959-02-14,1958,Sunderland,Bristol Rovers,3-1,3,1,2,2,4,2,H
1959-02-16,1958,Stoke City,Ipswich Town,1-0,1,0,2,2,1,1,H
1959-02-21,1958,Brighton & Hove Albion,Rotherham United,3-0,3,0,2,2,3,3,H
1959-02-21,1958,Bristol Rovers,Stoke City,1-0,1,0,2,2,1,1,H
1959-02-21,1958,Charlton Athletic,Bristol City,4-1,4,1,2,2,5,3,H
1959-02-21,1958,Derby County,Sunderland,2-0,2,0,2,2,2,2,H
1959-02-21,1958,Grimsby Town,Barnsley,3-3,3,3,2,2,6,0,D
1959-02-21,1958,Ipswich Town,Swansea City,3-2,3,2,2,2,5,1,H
1959-02-21,1958,Leyton Orient,Lincoln City,0-0,0,0,2,2,0,0,D
1959-02-21,1958,Liverpool,Huddersfield Town,2-2,2,2,2,2,4,0,D
1959-02-21,1958,Middlesbrough,Cardiff City,1-1,1,1,2,2,2,0,D
1959-02-21,1958,Scunthorpe United,Fulham,1-2,1,2,2,2,3,-1,A
1959-02-21,1958,Sheffield United,Sheffield Wednesday,1-0,1,0,2,2,1,1,H
1959-02-24,1958,Bristol City,Grimsby Town,1-0,1,0,2,2,1,1,H
1959-02-27,1958,Sheffield Wednesday,Charlton Athletic,4-1,4,1,2,2,5,3,H
1959-02-28,1958,Bristol Rovers,Brighton & Hove Albion,2-0,2,0,2,2,2,2,H
1959-02-28,1958,Derby County,Grimsby Town,3-0,3,0,2,2,3,3,H
1959-02-28,1958,Fulham,Bristol City,1-0,1,0,2,2,1,1,H
1959-02-28,1958,Leyton Orient,Liverpool,1-3,1,3,2,2,4,-2,A
1959-02-28,1958,Lincoln City,Cardiff City,4-2,4,2,2,2,6,2,H
1959-02-28,1958,Scunthorpe United,Middlesbrough,0-3,0,3,2,2,3,-3,A
1959-02-28,1958,Stoke City,Barnsley,2-1,2,1,2,2,3,1,H
1959-02-28,1958,Sunderland,Huddersfield Town,1-0,1,0,2,2,1,1,H
1959-02-28,1958,Swansea City,Rotherham United,3-0,3,0,2,2,3,3,H
1959-03-07,1958,Barnsley,Bristol Rovers,0-0,0,0,2,2,0,0,D
1959-03-07,1958,Brighton & Hove Albion,Scunthorpe United,2-1,2,1,2,2,3,1,H
1959-03-07,1958,Bristol City,Stoke City,2-1,2,1,2,2,3,1,H
1959-03-07,1958,Cardiff City,Swansea City,0-1,0,1,2,2,1,-1,A
1959-03-07,1958,Charlton Athletic,Sunderland,3-2,3,2,2,2,5,1,H
1959-03-07,1958,Grimsby Town,Sheffield Wednesday,0-2,0,2,2,2,2,-2,A
1959-03-07,1958,Huddersfield Town,Ipswich Town,3-0,3,0,2,2,3,3,H
1959-03-07,1958,Liverpool,Fulham,0-0,0,0,2,2,0,0,D
1959-03-07,1958,Middlesbrough,Lincoln City,1-2,1,2,2,2,3,-1,A
1959-03-07,1958,Rotherham United,Derby County,3-0,3,0,2,2,3,3,H
1959-03-07,1958,Sheffield United,Leyton Orient,2-3,2,3,2,2,5,-1,A
1959-03-11,1958,Middlesbrough,Grimsby Town,1-0,1,0,2,2,1,1,H
1959-03-14,1958,Bristol Rovers,Rotherham United,4-1,4,1,2,2,5,3,H
1959-03-14,1958,Derby County,Sheffield United,2-1,2,1,2,2,3,1,H
1959-03-14,1958,Fulham,Middlesbrough,3-2,3,2,2,2,5,1,H
1959-03-14,1958,Ipswich Town,Barnsley,3-1,3,1,2,2,4,2,H
1959-03-14,1958,Leyton Orient,Brighton & Hove Albion,2-2,2,2,2,2,4,0,D
1959-03-14,1958,Lincoln City,Charlton Athletic,3-3,3,3,2,2,6,0,D
1959-03-14,1958,Scunthorpe United,Grimsby Town,1-3,1,3,2,2,4,-2,A
1959-03-14,1958,Stoke City,Cardiff City,0-1,0,1,2,2,1,-1,A
1959-03-14,1958,Sunderland,Bristol City,3-1,3,1,2,2,4,2,H
1959-03-14,1958,Swansea City,Huddersfield Town,0-1,0,1,2,2,1,-1,A
1959-03-20,1958,Liverpool,Stoke City,3-4,3,4,2,2,7,-1,A
1959-03-21,1958,Barnsley,Scunthorpe United,0-1,0,1,2,2,1,-1,A
1959-03-21,1958,Brighton & Hove Albion,Lincoln City,2-1,2,1,2,2,3,1,H
1959-03-21,1958,Bristol City,Bristol Rovers,1-1,1,1,2,2,2,0,D
1959-03-21,1958,Cardiff City,Derby County,0-0,0,0,2,2,0,0,D
1959-03-21,1958,Charlton Athletic,Ipswich Town,5-1,5,1,2,2,6,4,H
1959-03-21,1958,Grimsby Town,Sunderland,1-1,1,1,2,2,2,0,D
1959-03-21,1958,Huddersfield Town,Leyton Orient,0-0,0,0,2,2,0,0,D
1959-03-21,1958,Middlesbrough,Swansea City,6-2,6,2,2,2,8,4,H
1959-03-21,1958,Rotherham United,Sheffield Wednesday,1-0,1,0,2,2,1,1,H
1959-03-21,1958,Sheffield United,Fulham,2-0,2,0,2,2,2,2,H
1959-03-27,1958,Bristol City,Ipswich Town,3-0,3,0,2,2,3,3,H
1959-03-27,1958,Fulham,Sheffield Wednesday,6-2,6,2,2,2,8,4,H
1959-03-27,1958,Grimsby Town,Rotherham United,1-1,1,1,2,2,2,0,D
1959-03-27,1958,Lincoln City,Scunthorpe United,3-3,3,3,2,2,6,0,D
1959-03-27,1958,Liverpool,Barnsley,3-2,3,2,2,2,5,1,H
1959-03-27,1958,Swansea City,Bristol Rovers,2-1,2,1,2,2,3,1,H
1959-03-28,1958,Bristol Rovers,Huddersfield Town,1-1,1,1,2,2,2,0,D
1959-03-28,1958,Derby County,Barnsley,3-0,3,0,2,2,3,3,H
1959-03-28,1958,Fulham,Grimsby Town,3-0,3,0,2,2,3,3,H
1959-03-28,1958,Ipswich Town,Cardiff City,3-3,3,3,2,2,6,0,D
1959-03-28,1958,Leyton Orient,Rotherham United,2-0,2,0,2,2,2,2,H
1959-03-28,1958,Lincoln City,Liverpool,2-1,2,1,2,2,3,1,H
1959-03-28,1958,Scunthorpe United,Sheffield United,1-3,1,3,2,2,4,-2,A
1959-03-28,1958,Sheffield Wednesday,Brighton & Hove Albion,2-0,2,0,2,2,2,2,H
1959-03-28,1958,Stoke City,Charlton Athletic,2-1,2,1,2,2,3,1,H
1959-03-28,1958,Sunderland,Middlesbrough,0-0,0,0,2,2,0,0,D
1959-03-28,1958,Swansea City,Bristol City,1-0,1,0,2,2,1,1,H
1959-03-30,1958,Barnsley,Liverpool,0-2,0,2,2,2,2,-2,A
1959-03-30,1958,Brighton & Hove Albion,Sheffield United,2-0,2,0,2,2,2,2,H
1959-03-30,1958,Bristol Rovers,Swansea City,4-4,4,4,2,2,8,0,D
1959-03-30,1958,Charlton Athletic,Cardiff City,0-0,0,0,2,2,0,0,D
1959-03-30,1958,Derby County,Stoke City,3-0,3,0,2,2,3,3,H
1959-03-30,1958,Huddersfield Town,Middlesbrough,5-1,5,1,2,2,6,4,H
1959-03-30,1958,Ipswich Town,Bristol City,1-1,1,1,2,2,2,0,D
1959-03-30,1958,Leyton Orient,Sunderland,6-0,6,0,2,2,6,6,H
1959-03-30,1958,Rotherham United,Grimsby Town,2-1,2,1,2,2,3,1,H
1959-03-30,1958,Scunthorpe United,Lincoln City,3-1,3,1,2,2,4,2,H
1959-03-30,1958,Sheffield Wednesday,Fulham,2-2,2,2,2,2,4,0,D
1959-03-31,1958,Cardiff City,Charlton Athletic,1-2,1,2,2,2,3,-1,A
1959-03-31,1958,Sheffield United,Brighton & Hove Albion,3-1,3,1,2,2,4,2,H
1959-04-04,1958,Barnsley,Sunderland,0-2,0,2,2,2,2,-2,A
1959-04-04,1958,Brighton & Hove Albion,Ipswich Town,4-1,4,1,2,2,5,3,H
1959-04-04,1958,Bristol City,Sheffield Wednesday,1-2,1,2,2,2,3,-1,A
1959-04-04,1958,Cardiff City,Fulham,1-2,1,2,2,2,3,-1,A
1959-04-04,1958,Charlton Athletic,Scunthorpe United,2-3,2,3,2,2,5,-1,A
1959-04-04,1958,Grimsby Town,Bristol Rovers,1-2,1,2,2,2,3,-1,A
1959-04-04,1958,Huddersfield Town,Lincoln City,2-1,2,1,2,2,3,1,H
1959-04-04,1958,Liverpool,Derby County,3-0,3,0,2,2,3,3,H
1959-04-04,1958,Middlesbrough,Leyton Orient,4-2,4,2,2,2,6,2,H
1959-04-04,1958,Rotherham United,Stoke City,0-0,0,0,2,2,0,0,D
1959-04-04,1958,Sheffield United,Swansea City,2-0,2,0,2,2,2,2,H
1959-04-06,1958,Stoke City,Sunderland,0-0,0,0,2,2,0,0,D
1959-04-08,1958,Liverpool,Middlesbrough,1-2,1,2,2,2,3,-1,A
1959-04-11,1958,Bristol Rovers,Liverpool,3-0,3,0,2,2,3,3,H
1959-04-11,1958,Derby County,Middlesbrough,0-3,0,3,2,2,3,-3,A
1959-04-11,1958,Fulham,Huddersfield Town,1-0,1,0,2,2,1,1,H
1959-04-11,1958,Ipswich Town,Grimsby Town,2-1,2,1,2,2,3,1,H
1959-04-11,1958,Leyton Orient,Charlton Athletic,6-1,6,1,2,2,7,5,H
1959-04-11,1958,Lincoln City,Barnsley,2-1,2,1,2,2,3,1,H
1959-04-11,1958,Scunthorpe United,Bristol City,3-3,3,3,2,2,6,0,D
1959-04-11,1958,Sheffield Wednesday,Cardiff City,3-1,3,1,2,2,4,2,H
1959-04-11,1958,Stoke City,Sheffield United,1-2,1,2,2,2,3,-1,A
1959-04-11,1958,Sunderland,Rotherham United,1-1,1,1,2,2,2,0,D
1959-04-11,1958,Swansea City,Brighton & Hove Albion,4-2,4,2,2,2,6,2,H
1959-04-14,1958,Grimsby Town,Charlton Athletic,1-5,1,5,2,2,6,-4,A
1959-04-14,1958,Sheffield Wednesday,Liverpool,1-0,1,0,2,2,1,1,H
1959-04-15,1958,Rotherham United,Sheffield United,2-2,2,2,2,2,4,0,D
1959-04-15,1958,Swansea City,Cardiff City,1-3,1,3,2,2,4,-2,A
1959-04-18,1958,Barnsley,Fulham,2-4,2,4,2,2,6,-2,A
1959-04-18,1958,Brighton & Hove Albion,Stoke City,2-2,2,2,2,2,4,0,D
1959-04-18,1958,Bristol City,Leyton Orient,0-1,0,1,2,2,1,-1,A
1959-04-18,1958,Cardiff City,Scunthorpe United,0-2,0,2,2,2,2,-2,A
1959-04-18,1958,Charlton Athletic,Derby County,1-2,1,2,2,2,3,-1,A
1959-04-18,1958,Grimsby Town,Swansea City,0-1,0,1,2,2,1,-1,A
1959-04-18,1958,Huddersfield Town,Sheffield Wednesday,1-2,1,2,2,2,3,-1,A
1959-04-18,1958,Liverpool,Ipswich Town,3-1,3,1,2,2,4,2,H
1959-04-18,1958,Middlesbrough,Bristol Rovers,2-2,2,2,2,2,4,0,D
1959-04-18,1958,Rotherham United,Lincoln City,1-0,1,0,2,2,1,1,H
1959-04-18,1958,Sheffield United,Sunderland,3-1,3,1,2,2,4,2,H
1959-04-20,1958,Barnsley,Swansea City,3-1,3,1,2,2,4,2,H
1959-04-20,1958,Sheffield United,Bristol Rovers,5-2,5,2,2,2,7,3,H
1959-04-21,1958,Bristol City,Lincoln City,1-0,1,0,2,2,1,1,H
1959-04-21,1958,Grimsby Town,Leyton Orient,4-1,4,1,2,2,5,3,H
1959-04-22,1958,Brighton & Hove Albion,Derby County,3-1,3,1,2,2,4,2,H
1959-04-22,1958,Cardiff City,Sunderland,2-1,2,1,2,2,3,1,H
1959-04-22,1958,Huddersfield Town,Stoke City,1-2,1,2,2,2,3,-1,A
1959-04-22,1958,Liverpool,Scunthorpe United,3-0,3,0,2,2,3,3,H
1959-04-22,1958,Middlesbrough,Sheffield Wednesday,2-2,2,2,2,2,4,0,D
1959-04-23,1958,Charlton Athletic,Fulham,2-1,2,1,2,2,3,1,H
1959-04-23,1958,Rotherham United,Ipswich Town,1-2,1,2,2,2,3,-1,A
1959-04-25,1958,Bristol Rovers,Charlton Athletic,2-1,2,1,2,2,3,1,H
1959-04-25,1958,Derby County,Bristol City,4-1,4,1,2,2,5,3,H
1959-04-25,1958,Fulham,Rotherham United,4-0,4,0,2,2,4,4,H
1959-04-25,1958,Ipswich Town,Middlesbrough,2-1,2,1,2,2,3,1,H
1959-04-25,1958,Leyton Orient,Cardiff City,3-0,3,0,2,2,3,3,H
1959-04-25,1958,Lincoln City,Sheffield United,1-2,1,2,2,2,3,-1,A
1959-04-25,1958,Scunthorpe United,Huddersfield Town,0-3,0,3,2,2,3,-3,A
1959-04-25,1958,Sheffield Wednesday,Barnsley,5-0,5,0,2,2,5,5,H
1959-04-25,1958,Stoke City,Grimsby Town,4-0,4,0,2,2,4,4,H
1959-04-25,1958,Sunderland,Brighton & Hove Albion,4-1,4,1,2,2,5,3,H
1959-04-25,1958,Swansea City,Liverpool,3-3,3,3,2,2,6,0,D
1959-04-27,1958,Sheffield United,Cardiff City,1-1,1,1,2,2,2,0,D
1959-04-29,1958,Barnsley,Leyton Orient,1-3,1,3,2,2,4,-2,A
1959-04-30,1958,Bristol Rovers,Sheffield Wednesday,2-1,2,1,2,2,3,1,H
1959-04-30,1958,Ipswich Town,Sheffield United,1-0,1,0,2,2,1,1,H
1959-04-30,1958,Rotherham United,Huddersfield Town,0-1,0,1,2,2,1,-1,A
1959-08-22,1959,Brighton & Hove Albion,Aston Villa,1-2,1,2,2,2,3,-1,A
1959-08-22,1959,Bristol Rovers,Leyton Orient,2-2,2,2,2,2,4,0,D
1959-08-22,1959,Cardiff City,Liverpool,3-2,3,2,2,2,5,1,H
1959-08-22,1959,Hull City,Plymouth Argyle,3-1,3,1,2,2,4,2,H
1959-08-22,1959,Ipswich Town,Huddersfield Town,1-4,1,4,2,2,5,-3,A
1959-08-22,1959,Middlesbrough,Portsmouth,0-0,0,0,2,2,0,0,D
1959-08-22,1959,Rotherham United,Charlton Athletic,3-3,3,3,2,2,6,0,D
1959-08-22,1959,Scunthorpe United,Bristol City,1-1,1,1,2,2,2,0,D
1959-08-22,1959,Sheffield United,Derby County,2-1,2,1,2,2,3,1,H
1959-08-22,1959,Stoke City,Sunderland,3-1,3,1,2,2,4,2,H
1959-08-22,1959,Swansea City,Lincoln City,2-1,2,1,2,2,3,1,H
1959-08-24,1959,Plymouth Argyle,Scunthorpe United,4-0,4,0,2,2,4,4,H
1959-08-24,1959,Sheffield United,Hull City,6-0,6,0,2,2,6,6,H
1959-08-26,1959,Cardiff City,Middlesbrough,2-0,2,0,2,2,2,2,H
1959-08-26,1959,Charlton Athletic,Bristol Rovers,2-2,2,2,2,2,4,0,D
1959-08-26,1959,Derby County,Rotherham United,1-1,1,1,2,2,2,0,D
1959-08-26,1959,Huddersfield Town,Brighton & Hove Albion,2-0,2,0,2,2,2,2,H
1959-08-26,1959,Ipswich Town,Swansea City,4-1,4,1,2,2,5,3,H
1959-08-26,1959,Lincoln City,Portsmouth,0-2,0,2,2,2,2,-2,A
1959-08-26,1959,Liverpool,Bristol City,4-2,4,2,2,2,6,2,H
1959-08-26,1959,Sunderland,Aston Villa,1-0,1,0,2,2,1,1,H
1959-08-27,1959,Leyton Orient,Stoke City,2-1,2,1,2,2,3,1,H
1959-08-29,1959,Aston Villa,Swansea City,1-0,1,0,2,2,1,1,H
1959-08-29,1959,Bristol City,Rotherham United,2-3,2,3,2,2,5,-1,A
1959-08-29,1959,Charlton Athletic,Cardiff City,2-1,2,1,2,2,3,1,H
1959-08-29,1959,Derby County,Middlesbrough,1-7,1,7,2,2,8,-6,A
1959-08-29,1959,Huddersfield Town,Scunthorpe United,2-0,2,0,2,2,2,2,H
1959-08-29,1959,Leyton Orient,Ipswich Town,4-1,4,1,2,2,5,3,H
1959-08-29,1959,Lincoln City,Bristol Rovers,0-1,0,1,2,2,1,-1,A
1959-08-29,1959,Liverpool,Hull City,5-3,5,3,2,2,8,2,H
1959-08-29,1959,Plymouth Argyle,Sheffield United,1-1,1,1,2,2,2,0,D
1959-08-29,1959,Portsmouth,Stoke City,2-2,2,2,2,2,4,0,D
1959-08-29,1959,Sunderland,Brighton & Hove Albion,0-0,0,0,2,2,0,0,D
1959-08-31,1959,Aston Villa,Sunderland,3-0,3,0,2,2,3,3,H
1959-08-31,1959,Hull City,Sheffield United,0-2,0,2,2,2,2,-2,A
1959-08-31,1959,Rotherham United,Derby County,1-2,1,2,2,2,3,-1,A
1959-09-01,1959,Bristol City,Liverpool,1-0,1,0,2,2,1,1,H
1959-09-02,1959,Brighton & Hove Albion,Huddersfield Town,3-2,3,2,2,2,5,1,H
1959-09-02,1959,Middlesbrough,Cardiff City,1-1,1,1,2,2,2,0,D
1959-09-02,1959,Portsmouth,Lincoln City,1-2,1,2,2,2,3,-1,A
1959-09-02,1959,Stoke City,Leyton Orient,2-1,2,1,2,2,3,1,H
1959-09-03,1959,Scunthorpe United,Plymouth Argyle,2-0,2,0,2,2,2,2,H
1959-09-03,1959,Swansea City,Ipswich Town,2-1,2,1,2,2,3,1,H
1959-09-05,1959,Brighton & Hove Albion,Portsmouth,3-1,3,1,2,2,4,2,H
1959-09-05,1959,Bristol Rovers,Aston Villa,1-1,1,1,2,2,2,0,D
1959-09-05,1959,Cardiff City,Bristol City,4-2,4,2,2,2,6,2,H
1959-09-05,1959,Huddersfield Town,Leyton Orient,1-1,1,1,2,2,2,0,D
1959-09-05,1959,Hull City,Charlton Athletic,0-4,0,4,2,2,4,-4,A
1959-09-05,1959,Ipswich Town,Lincoln City,3-0,3,0,2,2,3,3,H
1959-09-05,1959,Middlesbrough,Plymouth Argyle,6-2,6,2,2,2,8,4,H
1959-09-05,1959,Rotherham United,Scunthorpe United,1-1,1,1,2,2,2,0,D
1959-09-05,1959,Sheffield United,Liverpool,2-1,2,1,2,2,3,1,H
1959-09-05,1959,Stoke City,Derby County,2-1,2,1,2,2,3,1,H
1959-09-05,1959,Swansea City,Sunderland,1-2,1,2,2,2,3,-1,A
1959-09-07,1959,Bristol Rovers,Ipswich Town,2-1,2,1,2,2,3,1,H
1959-09-07,1959,Plymouth Argyle,Rotherham United,1-0,1,0,2,2,1,1,H
1959-09-07,1959,Sheffield United,Sunderland,1-2,1,2,2,2,3,-1,A
1959-09-09,1959,Charlton Athletic,Bristol City,4-2,4,2,2,2,6,2,H
1959-09-09,1959,Derby County,Cardiff City,1-2,1,2,2,2,3,-1,A
1959-09-09,1959,Huddersfield Town,Swansea City,4-3,4,3,2,2,7,1,H
1959-09-09,1959,Lincoln City,Stoke City,3-0,3,0,2,2,3,3,H
1959-09-09,1959,Liverpool,Scunthorpe United,2-0,2,0,2,2,2,2,H
1959-09-09,1959,Middlesbrough,Hull City,4-0,4,0,2,2,4,4,H
1959-09-09,1959,Portsmouth,Aston Villa,1-2,1,2,2,2,3,-1,A
1959-09-10,1959,Leyton Orient,Brighton & Hove Albion,3-2,3,2,2,2,5,1,H
1959-09-12,1959,Aston Villa,Ipswich Town,3-1,3,1,2,2,4,2,H
1959-09-12,1959,Bristol City,Hull City,0-1,0,1,2,2,1,-1,A
1959-09-12,1959,Charlton Athletic,Sheffield United,1-1,1,1,2,2,2,0,D
1959-09-12,1959,Leyton Orient,Rotherham United,2-3,2,3,2,2,5,-1,A
1959-09-12,1959,Lincoln City,Huddersfield Town,0-2,0,2,2,2,2,-2,A
1959-09-12,1959,Liverpool,Middlesbrough,1-2,1,2,2,2,3,-1,A
1959-09-12,1959,Plymouth Argyle,Derby County,0-5,0,5,2,2,5,-5,A
1959-09-12,1959,Portsmouth,Swansea City,1-3,1,3,2,2,4,-2,A
1959-09-12,1959,Scunthorpe United,Cardiff City,1-2,1,2,2,2,3,-1,A
1959-09-12,1959,Stoke City,Brighton & Hove Albion,1-3,1,3,2,2,4,-2,A
1959-09-12,1959,Sunderland,Bristol Rovers,2-2,2,2,2,2,4,0,D
1959-09-14,1959,Aston Villa,Portsmouth,5-2,5,2,2,2,7,3,H
1959-09-14,1959,Hull City,Middlesbrough,3-3,3,3,2,2,6,0,D
1959-09-15,1959,Bristol City,Charlton Athletic,1-2,1,2,2,2,3,-1,A
1959-09-16,1959,Brighton & Hove Albion,Leyton Orient,1-1,1,1,2,2,2,0,D
1959-09-16,1959,Cardiff City,Derby County,2-0,2,0,2,2,2,2,H
1959-09-16,1959,Ipswich Town,Bristol Rovers,3-0,3,0,2,2,3,3,H
1959-09-16,1959,Rotherham United,Plymouth Argyle,1-1,1,1,2,2,2,0,D
1959-09-16,1959,Stoke City,Lincoln City,6-1,6,1,2,2,7,5,H
1959-09-16,1959,Sunderland,Sheffield United,5-1,5,1,2,2,6,4,H
1959-09-17,1959,Scunthorpe United,Liverpool,1-1,1,1,2,2,2,0,D
1959-09-17,1959,Swansea City,Huddersfield Town,3-1,3,1,2,2,4,2,H
1959-09-19,1959,Brighton & Hove Albion,Plymouth Argyle,2-2,2,2,2,2,4,0,D
1959-09-19,1959,Bristol Rovers,Portsmouth,2-0,2,0,2,2,2,2,H
1959-09-19,1959,Cardiff City,Rotherham United,1-4,1,4,2,2,5,-3,A
1959-09-19,1959,Derby County,Liverpool,1-2,1,2,2,2,3,-1,A
1959-09-19,1959,Huddersfield Town,Aston Villa,0-1,0,1,2,2,1,-1,A
1959-09-19,1959,Hull City,Scunthorpe United,0-2,0,2,2,2,2,-2,A
1959-09-19,1959,Ipswich Town,Sunderland,6-1,6,1,2,2,7,5,H
1959-09-19,1959,Leyton Orient,Lincoln City,4-0,4,0,2,2,4,4,H
1959-09-19,1959,Middlesbrough,Charlton Athletic,3-0,3,0,2,2,3,3,H
1959-09-19,1959,Sheffield United,Bristol City,5-2,5,2,2,2,7,3,H
1959-09-19,1959,Swansea City,Stoke City,2-2,2,2,2,2,4,0,D
1959-09-21,1959,Bristol Rovers,Charlton Athletic,2-2,2,2,2,2,4,0,D
1959-09-26,1959,Aston Villa,Leyton Orient,1-0,1,0,2,2,1,1,H
1959-09-26,1959,Brighton & Hove Albion,Swansea City,1-2,1,2,2,2,3,-1,A
1959-09-26,1959,Bristol City,Middlesbrough,2-0,2,0,2,2,2,2,H
1959-09-26,1959,Charlton Athletic,Derby County,6-1,6,1,2,2,7,5,H
1959-09-26,1959,Lincoln City,Cardiff City,2-3,2,3,2,2,5,-1,A
1959-09-26,1959,Liverpool,Plymouth Argyle,4-1,4,1,2,2,5,3,H
1959-09-26,1959,Portsmouth,Ipswich Town,0-2,0,2,2,2,2,-2,A
1959-09-26,1959,Rotherham United,Hull City,1-0,1,0,2,2,1,1,H
1959-09-26,1959,Scunthorpe United,Sheffield United,1-1,1,1,2,2,2,0,D
1959-09-26,1959,Stoke City,Bristol Rovers,0-1,0,1,2,2,1,-1,A
1959-09-26,1959,Sunderland,Huddersfield Town,0-0,0,0,2,2,0,0,D
1959-09-30,1959,Stoke City,Aston Villa,3-3,3,3,2,2,6,0,D
1959-10-03,1959,Bristol Rovers,Brighton & Hove Albion,4-5,4,5,2,2,9,-1,A
1959-10-03,1959,Derby County,Bristol City,3-0,3,0,2,2,3,3,H
1959-10-03,1959,Huddersfield Town,Portsmouth,6-3,6,3,2,2,9,3,H
1959-10-03,1959,Hull City,Cardiff City,0-0,0,0,2,2,0,0,D
1959-10-03,1959,Ipswich Town,Stoke City,4-0,4,0,2,2,4,4,H
1959-10-03,1959,Leyton Orient,Sunderland,1-1,1,1,2,2,2,0,D
1959-10-03,1959,Lincoln City,Aston Villa,0-0,0,0,2,2,0,0,D
1959-10-03,1959,Middlesbrough,Scunthorpe United,3-1,3,1,2,2,4,2,H
1959-10-03,1959,Plymouth Argyle,Charlton Athletic,6-4,6,4,2,2,10,2,H
1959-10-03,1959,Sheffield United,Rotherham United,2-3,2,3,2,2,5,-1,A
1959-10-03,1959,Swansea City,Liverpool,5-4,5,4,2,2,9,1,H
1959-10-10,1959,Bristol City,Bristol Rovers,2-1,2,1,2,2,3,1,H
1959-10-10,1959,Cardiff City,Leyton Orient,5-1,5,1,2,2,6,4,H
1959-10-10,1959,Charlton Athletic,Swansea City,2-2,2,2,2,2,4,0,D
1959-10-10,1959,Derby County,Portsmouth,1-0,1,0,2,2,1,1,H
1959-10-10,1959,Hull City,Lincoln City,0-5,0,5,2,2,5,-5,A
1959-10-10,1959,Liverpool,Brighton & Hove Albion,2-2,2,2,2,2,4,0,D
1959-10-10,1959,Middlesbrough,Sunderland,1-1,1,1,2,2,2,0,D
1959-10-10,1959,Plymouth Argyle,Stoke City,2-3,2,3,2,2,5,-1,A
1959-10-10,1959,Rotherham United,Huddersfield Town,1-1,1,1,2,2,2,0,D
1959-10-10,1959,Scunthorpe United,Ipswich Town,2-2,2,2,2,2,4,0,D
1959-10-10,1959,Sheffield United,Aston Villa,1-1,1,1,2,2,2,0,D
1959-10-17,1959,Aston Villa,Middlesbrough,1-0,1,0,2,2,1,1,H
1959-10-17,1959,Brighton & Hove Albion,Charlton Athletic,1-1,1,1,2,2,2,0,D
1959-10-17,1959,Bristol Rovers,Scunthorpe United,1-1,1,1,2,2,2,0,D
1959-10-17,1959,Huddersfield Town,Cardiff City,0-1,0,1,2,2,1,-1,A
1959-10-17,1959,Ipswich Town,Rotherham United,2-3,2,3,2,2,5,-1,A
1959-10-17,1959,Leyton Orient,Hull City,3-1,3,1,2,2,4,2,H
1959-10-17,1959,Lincoln City,Sheffield United,2-0,2,0,2,2,2,2,H
1959-10-17,1959,Portsmouth,Plymouth Argyle,1-0,1,0,2,2,1,1,H
1959-10-17,1959,Stoke City,Liverpool,1-1,1,1,2,2,2,0,D
1959-10-17,1959,Sunderland,Derby County,3-1,3,1,2,2,4,2,H
1959-10-24,1959,Bristol City,Brighton & Hove Albion,0-1,0,1,2,2,1,-1,A
1959-10-24,1959,Cardiff City,Ipswich Town,3-2,3,2,2,2,5,1,H
1959-10-24,1959,Charlton Athletic,Stoke City,1-2,1,2,2,2,3,-1,A
1959-10-24,1959,Derby County,Aston Villa,2-2,2,2,2,2,4,0,D
1959-10-24,1959,Hull City,Huddersfield Town,1-1,1,1,2,2,2,0,D
1959-10-24,1959,Liverpool,Portsmouth,1-1,1,1,2,2,2,0,D
1959-10-24,1959,Middlesbrough,Lincoln City,3-2,3,2,2,2,5,1,H
1959-10-24,1959,Plymouth Argyle,Sunderland,0-0,0,0,2,2,0,0,D
1959-10-24,1959,Rotherham United,Bristol Rovers,3-0,3,0,2,2,3,3,H
1959-10-24,1959,Scunthorpe United,Swansea City,3-1,3,1,2,2,4,2,H
1959-10-24,1959,Sheffield United,Leyton Orient,0-2,0,2,2,2,2,-2,A
1959-10-31,1959,Aston Villa,Plymouth Argyle,2-0,2,0,2,2,2,2,H
1959-10-31,1959,Brighton & Hove Albion,Scunthorpe United,0-1,0,1,2,2,1,-1,A
1959-10-31,1959,Bristol Rovers,Cardiff City,1-1,1,1,2,2,2,0,D
1959-10-31,1959,Huddersfield Town,Sheffield United,0-1,0,1,2,2,1,-1,A
1959-10-31,1959,Ipswich Town,Hull City,2-0,2,0,2,2,2,2,H
1959-10-31,1959,Leyton Orient,Middlesbrough,5-0,5,0,2,2,5,5,H
1959-10-31,1959,Lincoln City,Derby County,6-2,6,2,2,2,8,4,H
1959-10-31,1959,Portsmouth,Charlton Athletic,2-2,2,2,2,2,4,0,D
1959-10-31,1959,Stoke City,Bristol City,1-3,1,3,2,2,4,-2,A
1959-10-31,1959,Sunderland,Liverpool,1-1,1,1,2,2,2,0,D
1959-10-31,1959,Swansea City,Rotherham United,2-2,2,2,2,2,4,0,D
1959-11-07,1959,Bristol City,Portsmouth,2-0,2,0,2,2,2,2,H
1959-11-07,1959,Cardiff City,Swansea City,2-1,2,1,2,2,3,1,H
1959-11-07,1959,Charlton Athletic,Sunderland,3-1,3,1,2,2,4,2,H
1959-11-07,1959,Derby County,Leyton Orient,1-1,1,1,2,2,2,0,D
1959-11-07,1959,Hull City,Bristol Rovers,3-1,3,1,2,2,4,2,H
1959-11-07,1959,Liverpool,Aston Villa,2-1,2,1,2,2,3,1,H
1959-11-07,1959,Middlesbrough,Huddersfield Town,1-0,1,0,2,2,1,1,H
1959-11-07,1959,Plymouth Argyle,Lincoln City,0-2,0,2,2,2,2,-2,A
1959-11-07,1959,Rotherham United,Brighton & Hove Albion,1-0,1,0,2,2,1,1,H
1959-11-07,1959,Scunthorpe United,Stoke City,1-1,1,1,2,2,2,0,D
1959-11-07,1959,Sheffield United,Ipswich Town,1-0,1,0,2,2,1,1,H
1959-11-14,1959,Aston Villa,Charlton Athletic,11-1,11,1,2,2,12,10,H
1959-11-14,1959,Brighton & Hove Albion,Cardiff City,2-2,2,2,2,2,4,0,D
1959-11-14,1959,Bristol Rovers,Sheffield United,3-2,3,2,2,2,5,1,H
1959-11-14,1959,Huddersfield Town,Derby County,2-2,2,2,2,2,4,0,D
1959-11-14,1959,Ipswich Town,Middlesbrough,1-0,1,0,2,2,1,1,H
1959-11-14,1959,Leyton Orient,Plymouth Argyle,2-3,2,3,2,2,5,-1,A
1959-11-14,1959,Lincoln City,Liverpool,4-2,4,2,2,2,6,2,H
1959-11-14,1959,Portsmouth,Scunthorpe United,4-0,4,0,2,2,4,4,H
1959-11-14,1959,Stoke City,Rotherham United,2-3,2,3,2,2,5,-1,A
1959-11-14,1959,Sunderland,Bristol City,3-2,3,2,2,2,5,1,H
1959-11-14,1959,Swansea City,Hull City,0-0,0,0,2,2,0,0,D
1959-11-21,1959,Bristol City,Aston Villa,0-5,0,5,2,2,5,-5,A
1959-11-21,1959,Cardiff City,Stoke City,4-4,4,4,2,2,8,0,D
1959-11-21,1959,Charlton Athletic,Lincoln City,2-2,2,2,2,2,4,0,D
1959-11-21,1959,Derby County,Ipswich Town,3-0,3,0,2,2,3,3,H
1959-11-21,1959,Hull City,Brighton & Hove Albion,3-1,3,1,2,2,4,2,H
1959-11-21,1959,Liverpool,Leyton Orient,4-3,4,3,2,2,7,1,H
1959-11-21,1959,Middlesbrough,Bristol Rovers,5-1,5,1,2,2,6,4,H
1959-11-21,1959,Plymouth Argyle,Huddersfield Town,1-3,1,3,2,2,4,-2,A
1959-11-21,1959,Rotherham United,Portsmouth,2-1,2,1,2,2,3,1,H
1959-11-21,1959,Scunthorpe United,Sunderland,3-1,3,1,2,2,4,2,H
1959-11-21,1959,Sheffield United,Swansea City,3-3,3,3,2,2,6,0,D
1959-11-28,1959,Aston Villa,Scunthorpe United,5-0,5,0,2,2,5,5,H
1959-11-28,1959,Brighton & Hove Albion,Sheffield United,0-2,0,2,2,2,2,-2,A
1959-11-28,1959,Bristol Rovers,Derby County,2-1,2,1,2,2,3,1,H
1959-11-28,1959,Huddersfield Town,Liverpool,1-0,1,0,2,2,1,1,H
1959-11-28,1959,Ipswich Town,Plymouth Argyle,3-3,3,3,2,2,6,0,D
1959-11-28,1959,Leyton Orient,Charlton Athletic,2-0,2,0,2,2,2,2,H
1959-11-28,1959,Lincoln City,Bristol City,3-1,3,1,2,2,4,2,H
1959-11-28,1959,Portsmouth,Cardiff City,1-1,1,1,2,2,2,0,D
1959-11-28,1959,Stoke City,Hull City,3-1,3,1,2,2,4,2,H
1959-11-28,1959,Sunderland,Rotherham United,1-2,1,2,2,2,3,-1,A
1959-11-28,1959,Swansea City,Middlesbrough,3-1,3,1,2,2,4,2,H
1959-12-05,1959,Bristol City,Leyton Orient,1-1,1,1,2,2,2,0,D
1959-12-05,1959,Cardiff City,Sunderland,2-1,2,1,2,2,3,1,H
1959-12-05,1959,Charlton Athletic,Huddersfield Town,1-1,1,1,2,2,2,0,D
1959-12-05,1959,Derby County,Swansea City,1-2,1,2,2,2,3,-1,A
1959-12-05,1959,Hull City,Portsmouth,1-3,1,3,2,2,4,-2,A
1959-12-05,1959,Liverpool,Ipswich Town,3-1,3,1,2,2,4,2,H
1959-12-05,1959,Middlesbrough,Brighton & Hove Albion,4-1,4,1,2,2,5,3,H
1959-12-05,1959,Plymouth Argyle,Bristol Rovers,5-3,5,3,2,2,8,2,H
1959-12-05,1959,Rotherham United,Aston Villa,2-1,2,1,2,2,3,1,H
1959-12-05,1959,Scunthorpe United,Lincoln City,5-0,5,0,2,2,5,5,H
1959-12-05,1959,Sheffield United,Stoke City,0-1,0,1,2,2,1,-1,A
1959-12-12,1959,Aston Villa,Cardiff City,2-0,2,0,2,2,2,2,H
1959-12-12,1959,Brighton & Hove Albion,Derby County,2-0,2,0,2,2,2,2,H
1959-12-12,1959,Bristol Rovers,Liverpool,0-2,0,2,2,2,2,-2,A
1959-12-12,1959,Huddersfield Town,Bristol City,6-1,6,1,2,2,7,5,H
1959-12-12,1959,Ipswich Town,Charlton Athletic,1-1,1,1,2,2,2,0,D
1959-12-12,1959,Leyton Orient,Scunthorpe United,1-1,1,1,2,2,2,0,D
1959-12-12,1959,Lincoln City,Rotherham United,0-1,0,1,2,2,1,-1,A
1959-12-12,1959,Portsmouth,Sheffield United,0-2,0,2,2,2,2,-2,A
1959-12-12,1959,Stoke City,Middlesbrough,2-5,2,5,2,2,7,-3,A
1959-12-12,1959,Sunderland,Hull City,1-3,1,3,2,2,4,-2,A
1959-12-12,1959,Swansea City,Plymouth Argyle,6-1,6,1,2,2,7,5,H
1959-12-19,1959,Aston Villa,Brighton & Hove Albion,3-1,3,1,2,2,4,2,H
1959-12-19,1959,Bristol City,Scunthorpe United,0-2,0,2,2,2,2,-2,A
1959-12-19,1959,Charlton Athletic,Rotherham United,2-2,2,2,2,2,4,0,D
1959-12-19,1959,Derby County,Sheffield United,1-1,1,1,2,2,2,0,D
1959-12-19,1959,Huddersfield Town,Ipswich Town,3-1,3,1,2,2,4,2,H
1959-12-19,1959,Leyton Orient,Bristol Rovers,1-2,1,2,2,2,3,-1,A
1959-12-19,1959,Lincoln City,Swansea City,2-0,2,0,2,2,2,2,H
1959-12-19,1959,Liverpool,Cardiff City,0-4,0,4,2,2,4,-4,A
1959-12-19,1959,Plymouth Argyle,Hull City,3-2,3,2,2,2,5,1,H
1959-12-19,1959,Portsmouth,Middlesbrough,6-3,6,3,2,2,9,3,H
1959-12-19,1959,Sunderland,Stoke City,0-2,0,2,2,2,2,-2,A
1959-12-26,1959,Bristol Rovers,Swansea City,3-1,3,1,2,2,4,2,H
1959-12-26,1959,Cardiff City,Sheffield United,2-0,2,0,2,2,2,2,H
1959-12-26,1959,Charlton Athletic,Liverpool,3-0,3,0,2,2,3,3,H
1959-12-26,1959,Hull City,Aston Villa,0-1,0,1,2,2,1,-1,A
1959-12-26,1959,Ipswich Town,Brighton & Hove Albion,3-0,3,0,2,2,3,3,H
1959-12-26,1959,Leyton Orient,Portsmouth,1-2,1,2,2,2,3,-1,A
1959-12-26,1959,Plymouth Argyle,Bristol City,1-4,1,4,2,2,5,-3,A
1959-12-26,1959,Rotherham United,Middlesbrough,0-2,0,2,2,2,2,-2,A
1959-12-26,1959,Scunthorpe United,Derby County,3-2,3,2,2,2,5,1,H
1959-12-26,1959,Stoke City,Huddersfield Town,1-1,1,1,2,2,2,0,D
1959-12-26,1959,Sunderland,Lincoln City,2-4,2,4,2,2,6,-2,A
1959-12-28,1959,Aston Villa,Hull City,1-1,1,1,2,2,2,0,D
1959-12-28,1959,Brighton & Hove Albion,Ipswich Town,1-4,1,4,2,2,5,-3,A
1959-12-28,1959,Bristol City,Plymouth Argyle,2-1,2,1,2,2,3,1,H
1959-12-28,1959,Derby County,Scunthorpe United,3-0,3,0,2,2,3,3,H
1959-12-28,1959,Huddersfield Town,Stoke City,2-3,2,3,2,2,5,-1,A
1959-12-28,1959,Lincoln City,Sunderland,0-0,0,0,2,2,0,0,D
1959-12-28,1959,Liverpool,Charlton Athletic,2-0,2,0,2,2,2,2,H
1959-12-28,1959,Middlesbrough,Rotherham United,3-0,3,0,2,2,3,3,H
1959-12-28,1959,Portsmouth,Leyton Orient,1-1,1,1,2,2,2,0,D
1959-12-28,1959,Sheffield United,Cardiff City,2-1,2,1,2,2,3,1,H
1959-12-28,1959,Swansea City,Bristol Rovers,3-0,3,0,2,2,3,3,H
1960-01-02,1959,Brighton & Hove Albion,Sunderland,2-1,2,1,2,2,3,1,H
1960-01-02,1959,Bristol Rovers,Lincoln City,3-3,3,3,2,2,6,0,D
1960-01-02,1959,Cardiff City,Charlton Athletic,5-1,5,1,2,2,6,4,H
1960-01-02,1959,Hull City,Liverpool,0-1,0,1,2,2,1,-1,A
1960-01-02,1959,Ipswich Town,Leyton Orient,6-3,6,3,2,2,9,3,H
1960-01-02,1959,Middlesbrough,Derby County,3-0,3,0,2,2,3,3,H
1960-01-02,1959,Rotherham United,Bristol City,3-1,3,1,2,2,4,2,H
1960-01-02,1959,Scunthorpe United,Huddersfield Town,0-2,0,2,2,2,2,-2,A
1960-01-02,1959,Sheffield United,Plymouth Argyle,4-0,4,0,2,2,4,4,H
1960-01-02,1959,Stoke City,Portsmouth,4-0,4,0,2,2,4,4,H
1960-01-02,1959,Swansea City,Aston Villa,1-3,1,3,2,2,4,-2,A
1960-01-16,1959,Aston Villa,Bristol Rovers,4-1,4,1,2,2,5,3,H
1960-01-16,1959,Bristol City,Cardiff City,0-3,0,3,2,2,3,-3,A
1960-01-16,1959,Charlton Athletic,Hull City,3-2,3,2,2,2,5,1,H
1960-01-16,1959,Derby County,Stoke City,2-0,2,0,2,2,2,2,H
1960-01-16,1959,Leyton Orient,Huddersfield Town,2-1,2,1,2,2,3,1,H
1960-01-16,1959,Lincoln City,Ipswich Town,0-1,0,1,2,2,1,-1,A
1960-01-16,1959,Liverpool,Sheffield United,3-0,3,0,2,2,3,3,H
1960-01-16,1959,Plymouth Argyle,Middlesbrough,2-2,2,2,2,2,4,0,D
1960-01-16,1959,Portsmouth,Brighton & Hove Albion,2-2,2,2,2,2,4,0,D
1960-01-16,1959,Scunthorpe United,Rotherham United,2-1,2,1,2,2,3,1,H
1960-01-16,1959,Sunderland,Swansea City,4-0,4,0,2,2,4,4,H
1960-01-23,1959,Brighton & Hove Albion,Stoke City,1-0,1,0,2,2,1,1,H
1960-01-23,1959,Bristol Rovers,Sunderland,3-1,3,1,2,2,4,2,H
1960-01-23,1959,Cardiff City,Scunthorpe United,4-2,4,2,2,2,6,2,H
1960-01-23,1959,Derby County,Plymouth Argyle,1-0,1,0,2,2,1,1,H
1960-01-23,1959,Huddersfield Town,Lincoln City,3-0,3,0,2,2,3,3,H
1960-01-23,1959,Hull City,Bristol City,1-1,1,1,2,2,2,0,D
1960-01-23,1959,Ipswich Town,Aston Villa,2-1,2,1,2,2,3,1,H
1960-01-23,1959,Middlesbrough,Liverpool,3-3,3,3,2,2,6,0,D
1960-01-23,1959,Rotherham United,Leyton Orient,1-1,1,1,2,2,2,0,D
1960-01-23,1959,Sheffield United,Charlton Athletic,2-0,2,0,2,2,2,2,H
1960-01-23,1959,Swansea City,Portsmouth,1-1,1,1,2,2,2,0,D
1960-01-30,1959,Plymouth Argyle,Cardiff City,1-1,1,1,2,2,2,0,D
1960-02-06,1959,Aston Villa,Huddersfield Town,4-0,4,0,2,2,4,4,H
1960-02-06,1959,Bristol City,Sheffield United,2-2,2,2,2,2,4,0,D
1960-02-06,1959,Charlton Athletic,Middlesbrough,1-0,1,0,2,2,1,1,H
1960-02-06,1959,Lincoln City,Leyton Orient,2-2,2,2,2,2,4,0,D
1960-02-06,1959,Plymouth Argyle,Brighton & Hove Albion,3-2,3,2,2,2,5,1,H
1960-02-06,1959,Portsmouth,Bristol Rovers,4-5,4,5,2,2,9,-1,A
1960-02-06,1959,Rotherham United,Cardiff City,2-2,2,2,2,2,4,0,D
1960-02-06,1959,Scunthorpe United,Hull City,3-0,3,0,2,2,3,3,H
1960-02-06,1959,Stoke City,Swansea City,4-2,4,2,2,2,6,2,H
1960-02-06,1959,Sunderland,Ipswich Town,0-1,0,1,2,2,1,-1,A
1960-02-13,1959,Bristol Rovers,Stoke City,3-1,3,1,2,2,4,2,H
1960-02-13,1959,Cardiff City,Lincoln City,6-2,6,2,2,2,8,4,H
1960-02-13,1959,Huddersfield Town,Sunderland,1-1,1,1,2,2,2,0,D
1960-02-13,1959,Hull City,Rotherham United,1-0,1,0,2,2,1,1,H
1960-02-13,1959,Ipswich Town,Portsmouth,1-1,1,1,2,2,2,0,D
1960-02-13,1959,Leyton Orient,Aston Villa,0-0,0,0,2,2,0,0,D
1960-02-13,1959,Middlesbrough,Bristol City,6-3,6,3,2,2,9,3,H
1960-02-13,1959,Plymouth Argyle,Liverpool,1-1,1,1,2,2,2,0,D
1960-02-13,1959,Sheffield United,Scunthorpe United,2-1,2,1,2,2,3,1,H
1960-02-13,1959,Swansea City,Brighton & Hove Albion,2-2,2,2,2,2,4,0,D
1960-02-20,1959,Bristol City,Derby County,0-1,0,1,2,2,1,-1,A
1960-02-20,1959,Cardiff City,Hull City,3-2,3,2,2,2,5,1,H
1960-02-20,1959,Charlton Athletic,Plymouth Argyle,5-2,5,2,2,2,7,3,H
1960-02-20,1959,Liverpool,Swansea City,4-1,4,1,2,2,5,3,H
1960-02-20,1959,Portsmouth,Huddersfield Town,0-2,0,2,2,2,2,-2,A
1960-02-20,1959,Scunthorpe United,Middlesbrough,1-1,1,1,2,2,2,0,D
1960-02-20,1959,Sunderland,Leyton Orient,1-4,1,4,2,2,5,-3,A
1960-02-24,1959,Derby County,Charlton Athletic,1-2,1,2,2,2,3,-1,A
1960-02-27,1959,Aston Villa,Sheffield United,1-3,1,3,2,2,4,-2,A
1960-02-27,1959,Brighton & Hove Albion,Liverpool,1-2,1,2,2,2,3,-1,A
1960-02-27,1959,Bristol Rovers,Bristol City,2-1,2,1,2,2,3,1,H
1960-02-27,1959,Huddersfield Town,Rotherham United,2-1,2,1,2,2,3,1,H
1960-02-27,1959,Ipswich Town,Scunthorpe United,1-0,1,0,2,2,1,1,H
1960-02-27,1959,Leyton Orient,Cardiff City,3-4,3,4,2,2,7,-1,A
1960-02-27,1959,Lincoln City,Hull City,3-0,3,0,2,2,3,3,H
1960-02-27,1959,Portsmouth,Derby County,2-3,2,3,2,2,5,-1,A
1960-02-27,1959,Stoke City,Plymouth Argyle,1-0,1,0,2,2,1,1,H
1960-02-27,1959,Sunderland,Middlesbrough,2-2,2,2,2,2,4,0,D
1960-02-27,1959,Swansea City,Charlton Athletic,5-2,5,2,2,2,7,3,H
1960-03-01,1959,Aston Villa,Lincoln City,1-1,1,1,2,2,2,0,D
1960-03-02,1959,Brighton & Hove Albion,Bristol Rovers,2-2,2,2,2,2,4,0,D
1960-03-02,1959,Rotherham United,Sheffield United,0-0,0,0,2,2,0,0,D
1960-03-05,1959,Bristol City,Swansea City,2-2,2,2,2,2,4,0,D
1960-03-05,1959,Cardiff City,Huddersfield Town,2-1,2,1,2,2,3,1,H
1960-03-05,1959,Charlton Athletic,Brighton & Hove Albion,3-1,3,1,2,2,4,2,H
1960-03-05,1959,Derby County,Sunderland,0-1,0,1,2,2,1,-1,A
1960-03-05,1959,Hull City,Leyton Orient,1-2,1,2,2,2,3,-1,A
1960-03-05,1959,Liverpool,Stoke City,5-1,5,1,2,2,6,4,H
1960-03-05,1959,Middlesbrough,Aston Villa,0-1,0,1,2,2,1,-1,A
1960-03-05,1959,Plymouth Argyle,Portsmouth,1-1,1,1,2,2,2,0,D
1960-03-05,1959,Rotherham United,Ipswich Town,1-4,1,4,2,2,5,-3,A
1960-03-05,1959,Scunthorpe United,Bristol Rovers,3-4,3,4,2,2,7,-1,A
1960-03-05,1959,Sheffield United,Lincoln City,3-2,3,2,2,2,5,1,H
1960-03-12,1959,Brighton & Hove Albion,Bristol City,5-1,5,1,2,2,6,4,H
1960-03-12,1959,Bristol Rovers,Rotherham United,3-1,3,1,2,2,4,2,H
1960-03-12,1959,Huddersfield Town,Hull City,1-0,1,0,2,2,1,1,H
1960-03-12,1959,Ipswich Town,Cardiff City,1-1,1,1,2,2,2,0,D
1960-03-12,1959,Lincoln City,Middlesbrough,5-2,5,2,2,2,7,3,H
1960-03-12,1959,Portsmouth,Liverpool,2-1,2,1,2,2,3,1,H
1960-03-12,1959,Stoke City,Charlton Athletic,1-3,1,3,2,2,4,-2,A
1960-03-12,1959,Sunderland,Plymouth Argyle,4-0,4,0,2,2,4,4,H
1960-03-12,1959,Swansea City,Scunthorpe United,3-1,3,1,2,2,4,2,H
1960-03-15,1959,Aston Villa,Derby County,3-2,3,2,2,2,5,1,H
1960-03-17,1959,Hull City,Stoke City,4-0,4,0,2,2,4,4,H
1960-03-17,1959,Leyton Orient,Sheffield United,1-1,1,1,2,2,2,0,D
1960-03-19,1959,Bristol City,Lincoln City,1-0,1,0,2,2,1,1,H
1960-03-19,1959,Cardiff City,Portsmouth,1-4,1,4,2,2,5,-3,A
1960-03-19,1959,Charlton Athletic,Leyton Orient,0-0,0,0,2,2,0,0,D
1960-03-19,1959,Derby County,Bristol Rovers,1-0,1,0,2,2,1,1,H
1960-03-19,1959,Liverpool,Huddersfield Town,2-2,2,2,2,2,4,0,D
1960-03-19,1959,Middlesbrough,Swansea City,2-0,2,0,2,2,2,2,H
1960-03-19,1959,Plymouth Argyle,Ipswich Town,3-1,3,1,2,2,4,2,H
1960-03-19,1959,Rotherham United,Sunderland,1-0,1,0,2,2,1,1,H
1960-03-19,1959,Scunthorpe United,Aston Villa,1-2,1,2,2,2,3,-1,A
1960-03-19,1959,Sheffield United,Brighton & Hove Albion,4-1,4,1,2,2,5,3,H
1960-03-26,1959,Brighton & Hove Albion,Rotherham United,0-0,0,0,2,2,0,0,D
1960-03-26,1959,Bristol Rovers,Hull City,1-0,1,0,2,2,1,1,H
1960-03-26,1959,Huddersfield Town,Middlesbrough,2-0,2,0,2,2,2,2,H
1960-03-26,1959,Ipswich Town,Sheffield United,2-0,2,0,2,2,2,2,H
1960-03-26,1959,Leyton Orient,Derby County,3-0,3,0,2,2,3,3,H
1960-03-26,1959,Lincoln City,Plymouth Argyle,0-1,0,1,2,2,1,-1,A
1960-03-26,1959,Portsmouth,Bristol City,2-0,2,0,2,2,2,2,H
1960-03-26,1959,Stoke City,Scunthorpe United,1-3,1,3,2,2,4,-2,A
1960-03-26,1959,Sunderland,Charlton Athletic,1-3,1,3,2,2,4,-2,A
1960-03-26,1959,Swansea City,Cardiff City,3-3,3,3,2,2,6,0,D
1960-03-30,1959,Aston Villa,Liverpool,4-4,4,4,2,2,8,0,D
1960-03-30,1959,Stoke City,Ipswich Town,1-2,1,2,2,2,3,-1,A
1960-04-02,1959,Bristol City,Sunderland,1-0,1,0,2,2,1,1,H
1960-04-02,1959,Cardiff City,Brighton & Hove Albion,1-4,1,4,2,2,5,-3,A
1960-04-02,1959,Charlton Athletic,Aston Villa,2-0,2,0,2,2,2,2,H
1960-04-02,1959,Derby County,Huddersfield Town,3-2,3,2,2,2,5,1,H
1960-04-02,1959,Hull City,Swansea City,3-1,3,1,2,2,4,2,H
1960-04-02,1959,Liverpool,Lincoln City,1-3,1,3,2,2,4,-2,A
1960-04-02,1959,Middlesbrough,Ipswich Town,4-1,4,1,2,2,5,3,H
1960-04-02,1959,Plymouth Argyle,Leyton Orient,1-0,1,0,2,2,1,1,H
1960-04-02,1959,Rotherham United,Stoke City,3-0,3,0,2,2,3,3,H
1960-04-02,1959,Scunthorpe United,Portsmouth,1-0,1,0,2,2,1,1,H
1960-04-02,1959,Sheffield United,Bristol Rovers,1-1,1,1,2,2,2,0,D
1960-04-06,1959,Liverpool,Derby County,4-1,4,1,2,2,5,3,H
1960-04-09,1959,Aston Villa,Bristol City,2-1,2,1,2,2,3,1,H
1960-04-09,1959,Brighton & Hove Albion,Hull City,1-1,1,1,2,2,2,0,D
1960-04-09,1959,Bristol Rovers,Middlesbrough,0-2,0,2,2,2,2,-2,A
1960-04-09,1959,Huddersfield Town,Plymouth Argyle,2-0,2,0,2,2,2,2,H
1960-04-09,1959,Ipswich Town,Derby County,1-1,1,1,2,2,2,0,D
1960-04-09,1959,Leyton Orient,Liverpool,2-0,2,0,2,2,2,2,H
1960-04-09,1959,Lincoln City,Charlton Athletic,5-3,5,3,2,2,8,2,H
1960-04-09,1959,Portsmouth,Rotherham United,2-0,2,0,2,2,2,2,H
1960-04-09,1959,Stoke City,Cardiff City,0-1,0,1,2,2,1,-1,A
1960-04-09,1959,Sunderland,Scunthorpe United,1-0,1,0,2,2,1,1,H
1960-04-09,1959,Swansea City,Sheffield United,2-1,2,1,2,2,3,1,H
1960-04-15,1959,Bristol Rovers,Huddersfield Town,2-0,2,0,2,2,2,2,H
1960-04-15,1959,Hull City,Derby County,1-1,1,1,2,2,2,0,D
1960-04-15,1959,Ipswich Town,Bristol City,1-3,1,3,2,2,4,-2,A
1960-04-15,1959,Leyton Orient,Swansea City,2-1,2,1,2,2,3,1,H
1960-04-15,1959,Lincoln City,Brighton & Hove Albion,2-1,2,1,2,2,3,1,H
1960-04-15,1959,Scunthorpe United,Charlton Athletic,1-1,1,1,2,2,2,0,D
1960-04-15,1959,Sunderland,Portsmouth,2-0,2,0,2,2,2,2,H
1960-04-16,1959,Bristol City,Huddersfield Town,2-3,2,3,2,2,5,-1,A
1960-04-16,1959,Cardiff City,Aston Villa,1-0,1,0,2,2,1,1,H
1960-04-16,1959,Charlton Athletic,Ipswich Town,1-3,1,3,2,2,4,-2,A
1960-04-16,1959,Derby County,Brighton & Hove Albion,0-1,0,1,2,2,1,-1,A
1960-04-16,1959,Hull City,Sunderland,0-0,0,0,2,2,0,0,D
1960-04-16,1959,Liverpool,Bristol Rovers,4-0,4,0,2,2,4,4,H
1960-04-16,1959,Middlesbrough,Stoke City,1-0,1,0,2,2,1,1,H
1960-04-16,1959,Plymouth Argyle,Swansea City,3-1,3,1,2,2,4,2,H
1960-04-16,1959,Rotherham United,Lincoln City,1-0,1,0,2,2,1,1,H
1960-04-16,1959,Scunthorpe United,Leyton Orient,2-1,2,1,2,2,3,1,H
1960-04-16,1959,Sheffield United,Portsmouth,0-0,0,0,2,2,0,0,D
1960-04-18,1959,Aston Villa,Stoke City,2-1,2,1,2,2,3,1,H
1960-04-18,1959,Brighton & Hove Albion,Lincoln City,3-3,3,3,2,2,6,0,D
1960-04-18,1959,Bristol City,Ipswich Town,5-1,5,1,2,2,6,4,H
1960-04-18,1959,Charlton Athletic,Scunthorpe United,5-2,5,2,2,2,7,3,H
1960-04-18,1959,Derby County,Hull City,1-3,1,3,2,2,4,-2,A
1960-04-18,1959,Huddersfield Town,Bristol Rovers,0-1,0,1,2,2,1,-1,A
1960-04-18,1959,Liverpool,Rotherham United,3-0,3,0,2,2,3,3,H
1960-04-18,1959,Middlesbrough,Sheffield United,1-2,1,2,2,2,3,-1,A
1960-04-18,1959,Portsmouth,Sunderland,1-2,1,2,2,2,3,-1,A
1960-04-18,1959,Swansea City,Leyton Orient,1-0,1,0,2,2,1,1,H
1960-04-19,1959,Cardiff City,Plymouth Argyle,0-1,0,1,2,2,1,-1,A
1960-04-19,1959,Rotherham United,Liverpool,2-2,2,2,2,2,4,0,D
1960-04-19,1959,Sheffield United,Middlesbrough,0-0,0,0,2,2,0,0,D
1960-04-23,1959,Aston Villa,Rotherham United,3-0,3,0,2,2,3,3,H
1960-04-23,1959,Brighton & Hove Albion,Middlesbrough,3-2,3,2,2,2,5,1,H
1960-04-23,1959,Bristol Rovers,Plymouth Argyle,2-0,2,0,2,2,2,2,H
1960-04-23,1959,Huddersfield Town,Charlton Athletic,4-0,4,0,2,2,4,4,H
1960-04-23,1959,Ipswich Town,Liverpool,0-1,0,1,2,2,1,-1,A
1960-04-23,1959,Leyton Orient,Bristol City,3-1,3,1,2,2,4,2,H
1960-04-23,1959,Lincoln City,Scunthorpe United,2-1,2,1,2,2,3,1,H
1960-04-23,1959,Portsmouth,Hull City,1-1,1,1,2,2,2,0,D
1960-04-23,1959,Stoke City,Sheffield United,1-2,1,2,2,2,3,-1,A
1960-04-23,1959,Sunderland,Cardiff City,1-1,1,1,2,2,2,0,D
1960-04-23,1959,Swansea City,Derby County,1-3,1,3,2,2,4,-2,A
1960-04-26,1959,Swansea City,Bristol City,6-1,6,1,2,2,7,5,H
1960-04-30,1959,Bristol City,Stoke City,1-2,1,2,2,2,3,-1,A
1960-04-30,1959,Cardiff City,Bristol Rovers,2-2,2,2,2,2,4,0,D
1960-04-30,1959,Charlton Athletic,Portsmouth,6-1,6,1,2,2,7,5,H
1960-04-30,1959,Derby County,Lincoln City,3-1,3,1,2,2,4,2,H
1960-04-30,1959,Hull City,Ipswich Town,2-0,2,0,2,2,2,2,H
1960-04-30,1959,Liverpool,Sunderland,3-0,3,0,2,2,3,3,H
1960-04-30,1959,Middlesbrough,Leyton Orient,2-2,2,2,2,2,4,0,D
1960-04-30,1959,Plymouth Argyle,Aston Villa,3-0,3,0,2,2,3,3,H
1960-04-30,1959,Rotherham United,Swansea City,1-1,1,1,2,2,2,0,D
1960-04-30,1959,Scunthorpe United,Brighton & Hove Albion,1-2,1,2,2,2,3,-1,A
1960-04-30,1959,Sheffield United,Huddersfield Town,2-0,2,0,2,2,2,2,H
1960-08-20,1960,Bristol Rovers,Middlesbrough,2-3,2,3,2,2,5,-1,A
1960-08-20,1960,Charlton Athletic,Scunthorpe United,1-1,1,1,2,2,2,0,D
1960-08-20,1960,Derby County,Brighton & Hove Albion,4-1,4,1,2,2,5,3,H
1960-08-20,1960,Huddersfield Town,Luton Town,1-1,1,1,2,2,2,0,D
1960-08-20,1960,Leyton Orient,Ipswich Town,1-3,1,3,2,2,4,-2,A
1960-08-20,1960,Liverpool,Leeds United,2-0,2,0,2,2,2,2,H
1960-08-20,1960,Norwich City,Sheffield United,1-1,1,1,2,2,2,0,D
1960-08-20,1960,Plymouth Argyle,Stoke City,3-1,3,1,2,2,4,2,H
1960-08-20,1960,Portsmouth,Lincoln City,3-0,3,0,2,2,3,3,H
1960-08-20,1960,Rotherham United,Southampton,1-0,1,0,2,2,1,1,H
1960-08-20,1960,Sunderland,Swansea City,2-1,2,1,2,2,3,1,H
1960-08-22,1960,Stoke City,Sunderland,0-0,0,0,2,2,0,0,D
1960-08-23,1960,Sheffield United,Plymouth Argyle,3-0,3,0,2,2,3,3,H
1960-08-23,1960,Swansea City,Huddersfield Town,2-0,2,0,2,2,2,2,H
1960-08-24,1960,Brighton & Hove Albion,Leyton Orient,1-1,1,1,2,2,2,0,D
1960-08-24,1960,Leeds United,Bristol Rovers,1-1,1,1,2,2,2,0,D
1960-08-24,1960,Lincoln City,Rotherham United,0-1,0,1,2,2,1,-1,A
1960-08-24,1960,Luton Town,Portsmouth,1-0,1,0,2,2,1,1,H
1960-08-24,1960,Middlesbrough,Derby County,1-2,1,2,2,2,3,-1,A
1960-08-24,1960,Norwich City,Charlton Athletic,4-0,4,0,2,2,4,4,H
1960-08-24,1960,Southampton,Liverpool,4-1,4,1,2,2,5,3,H
1960-08-25,1960,Scunthorpe United,Ipswich Town,4-0,4,0,2,2,4,4,H
1960-08-27,1960,Brighton & Hove Albion,Bristol Rovers,6-1,6,1,2,2,7,5,H
1960-08-27,1960,Ipswich Town,Derby County,4-1,4,1,2,2,5,3,H
1960-08-27,1960,Leeds United,Rotherham United,2-0,2,0,2,2,2,2,H
1960-08-27,1960,Lincoln City,Huddersfield Town,0-0,0,0,2,2,0,0,D
1960-08-27,1960,Luton Town,Sunderland,3-3,3,3,2,2,6,0,D
1960-08-27,1960,Middlesbrough,Liverpool,1-1,1,1,2,2,2,0,D
1960-08-27,1960,Scunthorpe United,Leyton Orient,2-2,2,2,2,2,4,0,D
1960-08-27,1960,Sheffield United,Charlton Athletic,1-0,1,0,2,2,1,1,H
1960-08-27,1960,Southampton,Portsmouth,5-1,5,1,2,2,6,4,H
1960-08-27,1960,Stoke City,Norwich City,1-1,1,1,2,2,2,0,D
1960-08-27,1960,Swansea City,Plymouth Argyle,1-2,1,2,2,2,3,-1,A
1960-08-29,1960,Bristol Rovers,Leeds United,4-4,4,4,2,2,8,0,D
1960-08-29,1960,Rotherham United,Lincoln City,2-0,2,0,2,2,2,2,H
1960-08-30,1960,Ipswich Town,Scunthorpe United,2-0,2,0,2,2,2,2,H
1960-08-31,1960,Charlton Athletic,Norwich City,0-1,0,1,2,2,1,-1,A
1960-08-31,1960,Derby County,Middlesbrough,1-0,1,0,2,2,1,1,H
1960-08-31,1960,Huddersfield Town,Swansea City,3-1,3,1,2,2,4,2,H
1960-08-31,1960,Leyton Orient,Brighton & Hove Albion,2-1,2,1,2,2,3,1,H
1960-08-31,1960,Liverpool,Southampton,0-1,0,1,2,2,1,-1,A
1960-08-31,1960,Plymouth Argyle,Sheffield United,2-0,2,0,2,2,2,2,H
1960-08-31,1960,Portsmouth,Luton Town,3-2,3,2,2,2,5,1,H
1960-08-31,1960,Sunderland,Stoke City,4-0,4,0,2,2,4,4,H
1960-09-03,1960,Bristol Rovers,Ipswich Town,1-1,1,1,2,2,2,0,D
1960-09-03,1960,Charlton Athletic,Stoke City,3-1,3,1,2,2,4,2,H
1960-09-03,1960,Derby County,Scunthorpe United,2-5,2,5,2,2,7,-3,A
1960-09-03,1960,Huddersfield Town,Portsmouth,3-3,3,3,2,2,6,0,D
1960-09-03,1960,Leyton Orient,Sheffield United,1-4,1,4,2,2,5,-3,A
1960-09-03,1960,Liverpool,Brighton & Hove Albion,2-0,2,0,2,2,2,2,H
1960-09-03,1960,Norwich City,Swansea City,0-0,0,0,2,2,0,0,D
1960-09-03,1960,Plymouth Argyle,Luton Town,1-1,1,1,2,2,2,0,D
1960-09-03,1960,Rotherham United,Middlesbrough,1-2,1,2,2,2,3,-1,A
1960-09-03,1960,Southampton,Leeds United,2-4,2,4,2,2,6,-2,A
1960-09-03,1960,Sunderland,Lincoln City,2-2,2,2,2,2,4,0,D
1960-09-06,1960,Sheffield United,Huddersfield Town,3-1,3,1,2,2,4,2,H
1960-09-06,1960,Swansea City,Lincoln City,1-2,1,2,2,2,3,-1,A
1960-09-07,1960,Brighton & Hove Albion,Ipswich Town,2-4,2,4,2,2,6,-2,A
1960-09-07,1960,Charlton Athletic,Sunderland,2-2,2,2,2,2,4,0,D
1960-09-07,1960,Leeds United,Leyton Orient,1-3,1,3,2,2,4,-2,A
1960-09-07,1960,Liverpool,Luton Town,2-2,2,2,2,2,4,0,D
1960-09-07,1960,Norwich City,Plymouth Argyle,1-0,1,0,2,2,1,1,H
1960-09-07,1960,Portsmouth,Stoke City,1-0,1,0,2,2,1,1,H
1960-09-07,1960,Rotherham United,Bristol Rovers,4-0,4,0,2,2,4,4,H
1960-09-07,1960,Southampton,Derby County,5-1,5,1,2,2,6,4,H
1960-09-10,1960,Brighton & Hove Albion,Rotherham United,1-0,1,0,2,2,1,1,H
1960-09-10,1960,Ipswich Town,Liverpool,1-0,1,0,2,2,1,1,H
1960-09-10,1960,Leeds United,Huddersfield Town,1-4,1,4,2,2,5,-3,A
1960-09-10,1960,Leyton Orient,Derby County,2-1,2,1,2,2,3,1,H
1960-09-10,1960,Lincoln City,Plymouth Argyle,3-1,3,1,2,2,4,2,H
1960-09-10,1960,Luton Town,Norwich City,0-2,0,2,2,2,2,-2,A
1960-09-10,1960,Middlesbrough,Southampton,5-0,5,0,2,2,5,5,H
1960-09-10,1960,Portsmouth,Sunderland,2-1,2,1,2,2,3,1,H
1960-09-10,1960,Scunthorpe United,Bristol Rovers,2-1,2,1,2,2,3,1,H
1960-09-10,1960,Stoke City,Sheffield United,2-0,2,0,2,2,2,2,H
1960-09-10,1960,Swansea City,Charlton Athletic,3-3,3,3,2,2,6,0,D
1960-09-12,1960,Bristol Rovers,Rotherham United,2-1,2,1,2,2,3,1,H
1960-09-12,1960,Stoke City,Portsmouth,1-0,1,0,2,2,1,1,H
1960-09-13,1960,Ipswich Town,Brighton & Hove Albion,4-0,4,0,2,2,4,4,H
1960-09-14,1960,Derby County,Southampton,2-2,2,2,2,2,4,0,D
1960-09-14,1960,Huddersfield Town,Sheffield United,0-1,0,1,2,2,1,-1,A
1960-09-14,1960,Leyton Orient,Leeds United,0-1,0,1,2,2,1,-1,A
1960-09-14,1960,Lincoln City,Swansea City,2-0,2,0,2,2,2,2,H
1960-09-14,1960,Luton Town,Liverpool,2-1,2,1,2,2,3,1,H
1960-09-14,1960,Plymouth Argyle,Norwich City,3-0,3,0,2,2,3,3,H
1960-09-14,1960,Sunderland,Charlton Athletic,2-2,2,2,2,2,4,0,D
1960-09-15,1960,Scunthorpe United,Middlesbrough,1-1,1,1,2,2,2,0,D
1960-09-17,1960,Bristol Rovers,Leyton Orient,4-2,4,2,2,2,6,2,H
1960-09-17,1960,Charlton Athletic,Luton Town,4-1,4,1,2,2,5,3,H
1960-09-17,1960,Derby County,Stoke City,1-1,1,1,2,2,2,0,D
1960-09-17,1960,Leeds United,Middlesbrough,4-4,4,4,2,2,8,0,D
1960-09-17,1960,Liverpool,Scunthorpe United,3-2,3,2,2,2,5,1,H
1960-09-17,1960,Norwich City,Lincoln City,5-1,5,1,2,2,6,4,H
1960-09-17,1960,Plymouth Argyle,Portsmouth,5-1,5,1,2,2,6,4,H
1960-09-17,1960,Rotherham United,Ipswich Town,1-1,1,1,2,2,2,0,D
1960-09-17,1960,Sheffield United,Swansea City,3-0,3,0,2,2,3,3,H
1960-09-17,1960,Southampton,Brighton & Hove Albion,4-2,4,2,2,2,6,2,H
1960-09-17,1960,Sunderland,Huddersfield Town,1-2,1,2,2,2,3,-1,A
1960-09-20,1960,Sheffield United,Portsmouth,3-1,3,1,2,2,4,2,H
1960-09-21,1960,Middlesbrough,Scunthorpe United,1-3,1,3,2,2,4,-2,A
1960-09-24,1960,Brighton & Hove Albion,Leeds United,2-1,2,1,2,2,3,1,H
1960-09-24,1960,Derby County,Bristol Rovers,1-1,1,1,2,2,2,0,D
1960-09-24,1960,Huddersfield Town,Plymouth Argyle,1-5,1,5,2,2,6,-4,A
1960-09-24,1960,Ipswich Town,Southampton,3-3,3,3,2,2,6,0,D
1960-09-24,1960,Leyton Orient,Liverpool,1-3,1,3,2,2,4,-2,A
1960-09-24,1960,Lincoln City,Charlton Athletic,2-2,2,2,2,2,4,0,D
1960-09-24,1960,Luton Town,Sheffield United,1-4,1,4,2,2,5,-3,A
1960-09-24,1960,Middlesbrough,Sunderland,1-0,1,0,2,2,1,1,H
1960-09-24,1960,Portsmouth,Norwich City,3-0,3,0,2,2,3,3,H
1960-09-24,1960,Scunthorpe United,Rotherham United,1-1,1,1,2,2,2,0,D
1960-09-24,1960,Swansea City,Stoke City,0-0,0,0,2,2,0,0,D
1960-10-01,1960,Bristol Rovers,Swansea City,4-2,4,2,2,2,6,2,H
1960-10-01,1960,Charlton Athletic,Portsmouth,7-4,7,4,2,2,11,3,H
1960-10-01,1960,Leeds United,Ipswich Town,2-5,2,5,2,2,7,-3,A
1960-10-01,1960,Liverpool,Derby County,1-0,1,0,2,2,1,1,H
1960-10-01,1960,Middlesbrough,Brighton & Hove Albion,2-2,2,2,2,2,4,0,D
1960-10-01,1960,Norwich City,Huddersfield Town,2-0,2,0,2,2,2,2,H
1960-10-01,1960,Plymouth Argyle,Sunderland,1-0,1,0,2,2,1,1,H
1960-10-01,1960,Rotherham United,Leyton Orient,2-1,2,1,2,2,3,1,H
1960-10-01,1960,Sheffield United,Lincoln City,2-1,2,1,2,2,3,1,H
1960-10-01,1960,Southampton,Scunthorpe United,4-2,4,2,2,2,6,2,H
1960-10-01,1960,Stoke City,Luton Town,3-0,3,0,2,2,3,3,H
1960-10-08,1960,Charlton Athletic,Ipswich Town,0-2,0,2,2,2,2,-2,A
1960-10-08,1960,Huddersfield Town,Southampton,3-1,3,1,2,2,4,2,H
1960-10-08,1960,Lincoln City,Liverpool,1-2,1,2,2,2,3,-1,A
1960-10-08,1960,Luton Town,Bristol Rovers,4-2,4,2,2,2,6,2,H
1960-10-08,1960,Norwich City,Brighton & Hove Albion,2-2,2,2,2,2,4,0,D
1960-10-08,1960,Plymouth Argyle,Middlesbrough,3-3,3,3,2,2,6,0,D
1960-10-08,1960,Portsmouth,Rotherham United,2-2,2,2,2,2,4,0,D
1960-10-08,1960,Sheffield United,Scunthorpe United,2-0,2,0,2,2,2,2,H
1960-10-08,1960,Stoke City,Leyton Orient,1-2,1,2,2,2,3,-1,A
1960-10-08,1960,Sunderland,Leeds United,2-3,2,3,2,2,5,-1,A
1960-10-08,1960,Swansea City,Derby County,2-1,2,1,2,2,3,1,H
1960-10-15,1960,Brighton & Hove Albion,Charlton Athletic,3-5,3,5,2,2,8,-2,A
1960-10-15,1960,Bristol Rovers,Lincoln City,3-1,3,1,2,2,4,2,H
1960-10-15,1960,Derby County,Luton Town,4-1,4,1,2,2,5,3,H
1960-10-15,1960,Ipswich Town,Sheffield United,0-1,0,1,2,2,1,-1,A
1960-10-15,1960,Leeds United,Plymouth Argyle,2-1,2,1,2,2,3,1,H
1960-10-15,1960,Leyton Orient,Swansea City,2-2,2,2,2,2,4,0,D
1960-10-15,1960,Liverpool,Portsmouth,3-3,3,3,2,2,6,0,D
1960-10-15,1960,Middlesbrough,Norwich City,2-0,2,0,2,2,2,2,H
1960-10-15,1960,Rotherham United,Huddersfield Town,2-2,2,2,2,2,4,0,D
1960-10-15,1960,Scunthorpe United,Stoke City,1-1,1,1,2,2,2,0,D
1960-10-15,1960,Southampton,Sunderland,3-2,3,2,2,2,5,1,H
1960-10-22,1960,Charlton Athletic,Middlesbrough,6-6,6,6,2,2,12,0,D
1960-10-22,1960,Huddersfield Town,Liverpool,2-4,2,4,2,2,6,-2,A
1960-10-22,1960,Lincoln City,Derby County,3-4,3,4,2,2,7,-1,A
1960-10-22,1960,Luton Town,Leyton Orient,0-1,0,1,2,2,1,-1,A
1960-10-22,1960,Norwich City,Leeds United,3-2,3,2,2,2,5,1,H
1960-10-22,1960,Plymouth Argyle,Southampton,1-3,1,3,2,2,4,-2,A
1960-10-22,1960,Sheffield United,Brighton & Hove Albion,2-1,2,1,2,2,3,1,H
1960-10-22,1960,Stoke City,Ipswich Town,2-4,2,4,2,2,6,-2,A
1960-10-22,1960,Sunderland,Rotherham United,1-1,1,1,2,2,2,0,D
1960-10-24,1960,Swansea City,Scunthorpe United,2-2,2,2,2,2,4,0,D
1960-10-29,1960,Brighton & Hove Albion,Stoke City,0-1,0,1,2,2,1,-1,A
1960-10-29,1960,Bristol Rovers,Huddersfield Town,1-2,1,2,2,2,3,-1,A
1960-10-29,1960,Derby County,Portsmouth,6-2,6,2,2,2,8,4,H
1960-10-29,1960,Ipswich Town,Swansea City,0-3,0,3,2,2,3,-3,A
1960-10-29,1960,Leeds United,Charlton Athletic,1-0,1,0,2,2,1,1,H
1960-10-29,1960,Leyton Orient,Lincoln City,1-2,1,2,2,2,3,-1,A
1960-10-29,1960,Liverpool,Sunderland,1-1,1,1,2,2,2,0,D
1960-10-29,1960,Middlesbrough,Sheffield United,3-1,3,1,2,2,4,2,H
1960-10-29,1960,Rotherham United,Plymouth Argyle,0-0,0,0,2,2,0,0,D
1960-10-29,1960,Scunthorpe United,Luton Town,1-0,1,0,2,2,1,1,H
1960-10-29,1960,Southampton,Norwich City,2-2,2,2,2,2,4,0,D
1960-11-05,1960,Charlton Athletic,Southampton,1-3,1,3,2,2,4,-2,A
1960-11-05,1960,Huddersfield Town,Derby County,1-3,1,3,2,2,4,-2,A
1960-11-05,1960,Lincoln City,Scunthorpe United,0-2,0,2,2,2,2,-2,A
1960-11-05,1960,Luton Town,Ipswich Town,3-2,3,2,2,2,5,1,H
1960-11-05,1960,Norwich City,Rotherham United,3-1,3,1,2,2,4,2,H
1960-11-05,1960,Plymouth Argyle,Liverpool,0-4,0,4,2,2,4,-4,A
1960-11-05,1960,Portsmouth,Leyton Orient,1-2,1,2,2,2,3,-1,A
1960-11-05,1960,Sheffield United,Leeds United,3-2,3,2,2,2,5,1,H
1960-11-05,1960,Stoke City,Middlesbrough,1-1,1,1,2,2,2,0,D
1960-11-05,1960,Sunderland,Bristol Rovers,2-0,2,0,2,2,2,2,H
1960-11-05,1960,Swansea City,Brighton & Hove Albion,2-3,2,3,2,2,5,-1,A
1960-11-12,1960,Brighton & Hove Albion,Luton Town,1-0,1,0,2,2,1,1,H
1960-11-12,1960,Bristol Rovers,Plymouth Argyle,2-5,2,5,2,2,7,-3,A
1960-11-12,1960,Derby County,Sunderland,1-1,1,1,2,2,2,0,D
1960-11-12,1960,Ipswich Town,Lincoln City,3-1,3,1,2,2,4,2,H
1960-11-12,1960,Leeds United,Stoke City,0-1,0,1,2,2,1,-1,A
1960-11-12,1960,Liverpool,Norwich City,2-1,2,1,2,2,3,1,H
1960-11-12,1960,Middlesbrough,Swansea City,3-1,3,1,2,2,4,2,H
1960-11-12,1960,Rotherham United,Charlton Athletic,2-3,2,3,2,2,5,-1,A
1960-11-12,1960,Scunthorpe United,Portsmouth,5-1,5,1,2,2,6,4,H
1960-11-12,1960,Southampton,Sheffield United,0-1,0,1,2,2,1,-1,A
1960-11-19,1960,Charlton Athletic,Liverpool,1-3,1,3,2,2,4,-2,A
1960-11-19,1960,Huddersfield Town,Scunthorpe United,1-2,1,2,2,2,3,-1,A
1960-11-19,1960,Lincoln City,Brighton & Hove Albion,2-1,2,1,2,2,3,1,H
1960-11-19,1960,Luton Town,Middlesbrough,6-1,6,1,2,2,7,5,H
1960-11-19,1960,Norwich City,Bristol Rovers,2-1,2,1,2,2,3,1,H
1960-11-19,1960,Plymouth Argyle,Derby County,4-2,4,2,2,2,6,2,H
1960-11-19,1960,Portsmouth,Ipswich Town,1-0,1,0,2,2,1,1,H
1960-11-19,1960,Sheffield United,Rotherham United,3-1,3,1,2,2,4,2,H
1960-11-19,1960,Stoke City,Southampton,1-2,1,2,2,2,3,-1,A
1960-11-19,1960,Sunderland,Leyton Orient,4-1,4,1,2,2,5,3,H
1960-11-19,1960,Swansea City,Leeds United,3-2,3,2,2,2,5,1,H
1960-11-26,1960,Brighton & Hove Albion,Portsmouth,2-2,2,2,2,2,4,0,D
1960-11-26,1960,Bristol Rovers,Charlton Athletic,3-1,3,1,2,2,4,2,H
1960-11-26,1960,Derby County,Norwich City,0-0,0,0,2,2,0,0,D
1960-11-26,1960,Ipswich Town,Huddersfield Town,4-2,4,2,2,2,6,2,H
1960-11-26,1960,Liverpool,Sheffield United,4-2,4,2,2,2,6,2,H
1960-11-26,1960,Middlesbrough,Lincoln City,1-1,1,1,2,2,2,0,D
1960-11-26,1960,Rotherham United,Stoke City,0-0,0,0,2,2,0,0,D
1960-11-26,1960,Scunthorpe United,Sunderland,3-3,3,3,2,2,6,0,D
1960-11-26,1960,Southampton,Swansea City,5-0,5,0,2,2,5,5,H
1960-12-03,1960,Charlton Athletic,Derby County,3-1,3,1,2,2,4,2,H
1960-12-03,1960,Huddersfield Town,Brighton & Hove Albion,0-1,0,1,2,2,1,-1,A
1960-12-03,1960,Lincoln City,Leeds United,2-3,2,3,2,2,5,-1,A
1960-12-03,1960,Luton Town,Southampton,4-1,4,1,2,2,5,3,H
1960-12-03,1960,Norwich City,Leyton Orient,3-2,3,2,2,2,5,1,H
1960-12-03,1960,Plymouth Argyle,Scunthorpe United,3-1,3,1,2,2,4,2,H
1960-12-03,1960,Sheffield United,Bristol Rovers,2-3,2,3,2,2,5,-1,A
1960-12-03,1960,Sunderland,Ipswich Town,2-0,2,0,2,2,2,2,H
1960-12-10,1960,Brighton & Hove Albion,Sunderland,1-2,1,2,2,2,3,-1,A
1960-12-10,1960,Bristol Rovers,Stoke City,1-0,1,0,2,2,1,1,H
1960-12-10,1960,Derby County,Sheffield United,2-0,2,0,2,2,2,2,H
1960-12-10,1960,Ipswich Town,Plymouth Argyle,3-1,3,1,2,2,4,2,H
1960-12-10,1960,Leeds United,Portsmouth,0-0,0,0,2,2,0,0,D
1960-12-10,1960,Leyton Orient,Charlton Athletic,1-1,1,1,2,2,2,0,D
1960-12-10,1960,Liverpool,Swansea City,4-0,4,0,2,2,4,4,H
1960-12-10,1960,Middlesbrough,Huddersfield Town,2-1,2,1,2,2,3,1,H
1960-12-10,1960,Rotherham United,Luton Town,5-2,5,2,2,2,7,3,H
1960-12-10,1960,Scunthorpe United,Norwich City,2-1,2,1,2,2,3,1,H
1960-12-10,1960,Southampton,Lincoln City,2-3,2,3,2,2,5,-1,A
1960-12-17,1960,Brighton & Hove Albion,Derby County,3-2,3,2,2,2,5,1,H
1960-12-17,1960,Ipswich Town,Leyton Orient,6-2,6,2,2,2,8,4,H
1960-12-17,1960,Leeds United,Liverpool,2-2,2,2,2,2,4,0,D
1960-12-17,1960,Lincoln City,Portsmouth,2-3,2,3,2,2,5,-1,A
1960-12-17,1960,Luton Town,Huddersfield Town,1-0,1,0,2,2,1,1,H
1960-12-17,1960,Middlesbrough,Bristol Rovers,1-1,1,1,2,2,2,0,D
1960-12-17,1960,Sheffield United,Norwich City,1-1,1,1,2,2,2,0,D
1960-12-17,1960,Southampton,Rotherham United,3-2,3,2,2,2,5,1,H
1960-12-17,1960,Stoke City,Plymouth Argyle,9-0,9,0,2,2,9,9,H
1960-12-17,1960,Swansea City,Sunderland,3-3,3,3,2,2,6,0,D
1960-12-23,1960,Scunthorpe United,Brighton & Hove Albion,2-2,2,2,2,2,4,0,D
1960-12-24,1960,Derby County,Leeds United,2-3,2,3,2,2,5,-1,A
1960-12-24,1960,Stoke City,Huddersfield Town,2-2,2,2,2,2,4,0,D
1960-12-26,1960,Charlton Athletic,Plymouth Argyle,6-4,6,4,2,2,10,2,H
1960-12-26,1960,Huddersfield Town,Stoke City,0-0,0,0,2,2,0,0,D
1960-12-26,1960,Liverpool,Rotherham United,2-1,2,1,2,2,3,1,H
1960-12-26,1960,Luton Town,Lincoln City,3-0,3,0,2,2,3,3,H
1960-12-26,1960,Middlesbrough,Leyton Orient,2-0,2,0,2,2,2,2,H
1960-12-26,1960,Norwich City,Ipswich Town,0-3,0,3,2,2,3,-3,A
1960-12-26,1960,Southampton,Bristol Rovers,4-2,4,2,2,2,6,2,H
1960-12-26,1960,Sunderland,Sheffield United,1-1,1,1,2,2,2,0,D
1960-12-26,1960,Swansea City,Portsmouth,4-0,4,0,2,2,4,4,H
1960-12-27,1960,Brighton & Hove Albion,Scunthorpe United,1-1,1,1,2,2,2,0,D
1960-12-27,1960,Ipswich Town,Norwich City,4-1,4,1,2,2,5,3,H
1960-12-27,1960,Leeds United,Derby County,3-3,3,3,2,2,6,0,D
1960-12-27,1960,Lincoln City,Luton Town,1-1,1,1,2,2,2,0,D
1960-12-27,1960,Plymouth Argyle,Charlton Athletic,6-4,6,4,2,2,10,2,H
1960-12-27,1960,Portsmouth,Swansea City,1-1,1,1,2,2,2,0,D
1960-12-27,1960,Rotherham United,Liverpool,1-0,1,0,2,2,1,1,H
1960-12-27,1960,Sheffield United,Sunderland,0-1,0,1,2,2,1,-1,A
1960-12-31,1960,Bristol Rovers,Brighton & Hove Albion,0-1,0,1,2,2,1,-1,A
1960-12-31,1960,Charlton Athletic,Sheffield United,2-3,2,3,2,2,5,-1,A
1960-12-31,1960,Huddersfield Town,Lincoln City,4-1,4,1,2,2,5,3,H
1960-12-31,1960,Leyton Orient,Scunthorpe United,2-1,2,1,2,2,3,1,H
1960-12-31,1960,Liverpool,Middlesbrough,3-4,3,4,2,2,7,-1,A
1960-12-31,1960,Norwich City,Stoke City,1-0,1,0,2,2,1,1,H
1960-12-31,1960,Plymouth Argyle,Swansea City,1-0,1,0,2,2,1,1,H
1960-12-31,1960,Portsmouth,Southampton,1-1,1,1,2,2,2,0,D
1960-12-31,1960,Rotherham United,Leeds United,1-3,1,3,2,2,4,-2,A
1960-12-31,1960,Sunderland,Luton Town,7-1,7,1,2,2,8,6,H
1961-01-14,1960,Brighton & Hove Albion,Liverpool,3-1,3,1,2,2,4,2,H
1961-01-14,1960,Ipswich Town,Bristol Rovers,3-2,3,2,2,2,5,1,H
1961-01-14,1960,Leeds United,Southampton,3-0,3,0,2,2,3,3,H
1961-01-14,1960,Lincoln City,Sunderland,1-2,1,2,2,2,3,-1,A
1961-01-14,1960,Luton Town,Plymouth Argyle,3-2,3,2,2,2,5,1,H
1961-01-14,1960,Middlesbrough,Rotherham United,2-2,2,2,2,2,4,0,D
1961-01-14,1960,Portsmouth,Huddersfield Town,1-3,1,3,2,2,4,-2,A
1961-01-14,1960,Scunthorpe United,Derby County,1-2,1,2,2,2,3,-1,A
1961-01-14,1960,Sheffield United,Leyton Orient,4-1,4,1,2,2,5,3,H
1961-01-14,1960,Swansea City,Norwich City,4-1,4,1,2,2,5,3,H
1961-01-16,1960,Stoke City,Charlton Athletic,5-3,5,3,2,2,8,2,H
1961-01-21,1960,Bristol Rovers,Scunthorpe United,3-3,3,3,2,2,6,0,D
1961-01-21,1960,Charlton Athletic,Swansea City,6-2,6,2,2,2,8,4,H
1961-01-21,1960,Derby County,Leyton Orient,3-1,3,1,2,2,4,2,H
1961-01-21,1960,Huddersfield Town,Leeds United,0-1,0,1,2,2,1,-1,A
1961-01-21,1960,Liverpool,Ipswich Town,1-1,1,1,2,2,2,0,D
1961-01-21,1960,Norwich City,Luton Town,2-1,2,1,2,2,3,1,H
1961-01-21,1960,Plymouth Argyle,Lincoln City,1-1,1,1,2,2,2,0,D
1961-01-21,1960,Sheffield United,Stoke City,4-1,4,1,2,2,5,3,H
1961-01-21,1960,Southampton,Middlesbrough,3-2,3,2,2,2,5,1,H
1961-01-21,1960,Sunderland,Portsmouth,4-1,4,1,2,2,5,3,H
1961-01-28,1960,Portsmouth,Middlesbrough,0-3,0,3,2,2,3,-3,A
1961-02-04,1960,Brighton & Hove Albion,Southampton,0-1,0,1,2,2,1,-1,A
1961-02-04,1960,Huddersfield Town,Sunderland,4-2,4,2,2,2,6,2,H
1961-02-04,1960,Ipswich Town,Rotherham United,1-1,1,1,2,2,2,0,D
1961-02-04,1960,Leyton Orient,Bristol Rovers,3-2,3,2,2,2,5,1,H
1961-02-04,1960,Lincoln City,Norwich City,1-4,1,4,2,2,5,-3,A
1961-02-04,1960,Middlesbrough,Leeds United,3-0,3,0,2,2,3,3,H
1961-02-04,1960,Portsmouth,Plymouth Argyle,0-2,0,2,2,2,2,-2,A
1961-02-04,1960,Scunthorpe United,Liverpool,2-3,2,3,2,2,5,-1,A
1961-02-04,1960,Swansea City,Sheffield United,3-0,3,0,2,2,3,3,H
1961-02-10,1960,Leeds United,Brighton & Hove Albion,3-2,3,2,2,2,5,1,H
1961-02-11,1960,Bristol Rovers,Derby County,1-1,1,1,2,2,2,0,D
1961-02-11,1960,Charlton Athletic,Lincoln City,3-0,3,0,2,2,3,3,H
1961-02-11,1960,Liverpool,Leyton Orient,5-0,5,0,2,2,5,5,H
1961-02-11,1960,Norwich City,Portsmouth,3-1,3,1,2,2,4,2,H
1961-02-11,1960,Plymouth Argyle,Huddersfield Town,2-1,2,1,2,2,3,1,H
1961-02-11,1960,Rotherham United,Scunthorpe United,4-0,4,0,2,2,4,4,H
1961-02-11,1960,Sheffield United,Luton Town,2-1,2,1,2,2,3,1,H
1961-02-11,1960,Southampton,Ipswich Town,1-1,1,1,2,2,2,0,D
1961-02-11,1960,Stoke City,Swansea City,1-3,1,3,2,2,4,-2,A
1961-02-11,1960,Sunderland,Middlesbrough,2-0,2,0,2,2,2,2,H
1961-02-18,1960,Brighton & Hove Albion,Middlesbrough,0-1,0,1,2,2,1,-1,A
1961-02-18,1960,Derby County,Liverpool,1-4,1,4,2,2,5,-3,A
1961-02-18,1960,Ipswich Town,Leeds United,4-0,4,0,2,2,4,4,H
1961-02-18,1960,Portsmouth,Charlton Athletic,1-1,1,1,2,2,2,0,D
1961-02-18,1960,Scunthorpe United,Southampton,2-0,2,0,2,2,2,2,H
1961-02-20,1960,Leyton Orient,Rotherham United,2-1,2,1,2,2,3,1,H
1961-02-21,1960,Huddersfield Town,Norwich City,1-1,1,1,2,2,2,0,D
1961-02-22,1960,Lincoln City,Sheffield United,0-5,0,5,2,2,5,-5,A
1961-02-22,1960,Sunderland,Plymouth Argyle,2-1,2,1,2,2,3,1,H
1961-02-23,1960,Luton Town,Stoke City,4-1,4,1,2,2,5,3,H
1961-02-25,1960,Brighton & Hove Albion,Norwich City,2-2,2,2,2,2,4,0,D
1961-02-25,1960,Bristol Rovers,Luton Town,4-1,4,1,2,2,5,3,H
1961-02-25,1960,Derby County,Swansea City,2-3,2,3,2,2,5,-1,A
1961-02-25,1960,Ipswich Town,Charlton Athletic,2-1,2,1,2,2,3,1,H
1961-02-25,1960,Leeds United,Sunderland,2-4,2,4,2,2,6,-2,A
1961-02-25,1960,Liverpool,Lincoln City,2-0,2,0,2,2,2,2,H
1961-02-25,1960,Middlesbrough,Plymouth Argyle,3-1,3,1,2,2,4,2,H
1961-02-25,1960,Rotherham United,Portsmouth,1-0,1,0,2,2,1,1,H
1961-02-25,1960,Scunthorpe United,Sheffield United,1-1,1,1,2,2,2,0,D
1961-02-25,1960,Southampton,Huddersfield Town,4-2,4,2,2,2,6,2,H
1961-02-28,1960,Swansea City,Bristol Rovers,2-1,2,1,2,2,3,1,H
1961-03-04,1960,Charlton Athletic,Brighton & Hove Albion,3-1,3,1,2,2,4,2,H
1961-03-04,1960,Huddersfield Town,Rotherham United,0-1,0,1,2,2,1,-1,A
1961-03-04,1960,Lincoln City,Bristol Rovers,1-2,1,2,2,2,3,-1,A
1961-03-04,1960,Luton Town,Derby County,1-1,1,1,2,2,2,0,D
1961-03-04,1960,Norwich City,Middlesbrough,4-1,4,1,2,2,5,3,H
1961-03-04,1960,Plymouth Argyle,Leeds United,3-1,3,1,2,2,4,2,H
1961-03-04,1960,Portsmouth,Liverpool,2-2,2,2,2,2,4,0,D
1961-03-04,1960,Stoke City,Scunthorpe United,2-0,2,0,2,2,2,2,H
1961-03-04,1960,Swansea City,Leyton Orient,1-0,1,0,2,2,1,1,H
1961-03-07,1960,Leyton Orient,Plymouth Argyle,1-1,1,1,2,2,2,0,D
1961-03-07,1960,Sheffield United,Ipswich Town,1-3,1,3,2,2,4,-2,A
1961-03-08,1960,Leeds United,Luton Town,1-2,1,2,2,2,3,-1,A
1961-03-11,1960,Brighton & Hove Albion,Sheffield United,0-0,0,0,2,2,0,0,D
1961-03-11,1960,Bristol Rovers,Portsmouth,2-0,2,0,2,2,2,2,H
1961-03-11,1960,Derby County,Lincoln City,3-1,3,1,2,2,4,2,H
1961-03-11,1960,Ipswich Town,Stoke City,2-1,2,1,2,2,3,1,H
1961-03-11,1960,Leeds United,Norwich City,1-0,1,0,2,2,1,1,H
1961-03-11,1960,Leyton Orient,Luton Town,2-1,2,1,2,2,3,1,H
1961-03-11,1960,Liverpool,Huddersfield Town,3-1,3,1,2,2,4,2,H
1961-03-11,1960,Middlesbrough,Charlton Athletic,2-2,2,2,2,2,4,0,D
1961-03-11,1960,Rotherham United,Sunderland,0-0,0,0,2,2,0,0,D
1961-03-11,1960,Scunthorpe United,Swansea City,1-2,1,2,2,2,3,-1,A
1961-03-11,1960,Southampton,Plymouth Argyle,1-1,1,1,2,2,2,0,D
1961-03-14,1960,Leyton Orient,Middlesbrough,1-1,1,1,2,2,2,0,D
1961-03-14,1960,Swansea City,Rotherham United,2-1,2,1,2,2,3,1,H
1961-03-18,1960,Charlton Athletic,Leyton Orient,2-0,2,0,2,2,2,2,H
1961-03-18,1960,Huddersfield Town,Middlesbrough,1-0,1,0,2,2,1,1,H
1961-03-18,1960,Lincoln City,Southampton,0-3,0,3,2,2,3,-3,A
1961-03-18,1960,Luton Town,Rotherham United,2-1,2,1,2,2,3,1,H
1961-03-18,1960,Norwich City,Scunthorpe United,0-1,0,1,2,2,1,-1,A
1961-03-18,1960,Plymouth Argyle,Ipswich Town,1-2,1,2,2,2,3,-1,A
1961-03-18,1960,Portsmouth,Leeds United,3-1,3,1,2,2,4,2,H
1961-03-18,1960,Stoke City,Bristol Rovers,2-0,2,0,2,2,2,2,H
1961-03-18,1960,Sunderland,Brighton & Hove Albion,2-1,2,1,2,2,3,1,H
1961-03-18,1960,Swansea City,Liverpool,2-0,2,0,2,2,2,2,H
1961-03-20,1960,Bristol Rovers,Southampton,4-2,4,2,2,2,6,2,H
1961-03-20,1960,Stoke City,Derby County,2-1,2,1,2,2,3,1,H
1961-03-21,1960,Leyton Orient,Huddersfield Town,2-0,2,0,2,2,2,2,H
1961-03-24,1960,Liverpool,Plymouth Argyle,1-1,1,1,2,2,2,0,D
1961-03-25,1960,Brighton & Hove Albion,Swansea City,0-0,0,0,2,2,0,0,D
1961-03-25,1960,Bristol Rovers,Sunderland,1-0,1,0,2,2,1,1,H
1961-03-25,1960,Derby County,Huddersfield Town,1-1,1,1,2,2,2,0,D
1961-03-25,1960,Ipswich Town,Luton Town,0-1,0,1,2,2,1,-1,A
1961-03-25,1960,Leeds United,Sheffield United,1-2,1,2,2,2,3,-1,A
1961-03-25,1960,Leyton Orient,Portsmouth,2-1,2,1,2,2,3,1,H
1961-03-25,1960,Middlesbrough,Stoke City,1-0,1,0,2,2,1,1,H
1961-03-25,1960,Rotherham United,Norwich City,0-2,0,2,2,2,2,-2,A
1961-03-25,1960,Scunthorpe United,Lincoln City,3-1,3,1,2,2,4,2,H
1961-03-25,1960,Southampton,Charlton Athletic,1-2,1,2,2,2,3,-1,A
1961-03-29,1960,Leyton Orient,Southampton,1-1,1,1,2,2,2,0,D
1961-03-31,1960,Brighton & Hove Albion,Plymouth Argyle,2-0,2,0,2,2,2,2,H
1961-03-31,1960,Charlton Athletic,Huddersfield Town,2-3,2,3,2,2,5,-1,A
1961-03-31,1960,Ipswich Town,Middlesbrough,3-1,3,1,2,2,4,2,H
1961-03-31,1960,Lincoln City,Stoke City,1-1,1,1,2,2,2,0,D
1961-03-31,1960,Liverpool,Bristol Rovers,3-0,3,0,2,2,3,3,H
1961-03-31,1960,Luton Town,Swansea City,2-2,2,2,2,2,4,0,D
1961-03-31,1960,Sunderland,Norwich City,0-3,0,3,2,2,3,-3,A
1961-04-01,1960,Charlton Athletic,Bristol Rovers,2-1,2,1,2,2,3,1,H
1961-04-01,1960,Huddersfield Town,Ipswich Town,1-3,1,3,2,2,4,-2,A
1961-04-01,1960,Lincoln City,Middlesbrough,5-2,5,2,2,2,7,3,H
1961-04-01,1960,Luton Town,Leeds United,1-1,1,1,2,2,2,0,D
1961-04-01,1960,Norwich City,Derby County,0-2,0,2,2,2,2,-2,A
1961-04-01,1960,Plymouth Argyle,Leyton Orient,3-2,3,2,2,2,5,1,H
1961-04-01,1960,Portsmouth,Brighton & Hove Albion,4-0,4,0,2,2,4,4,H
1961-04-01,1960,Sheffield United,Liverpool,1-1,1,1,2,2,2,0,D
1961-04-01,1960,Stoke City,Rotherham United,1-4,1,4,2,2,5,-3,A
1961-04-01,1960,Sunderland,Scunthorpe United,2-0,2,0,2,2,2,2,H
1961-04-01,1960,Swansea City,Southampton,4-1,4,1,2,2,5,3,H
1961-04-03,1960,Derby County,Rotherham United,3-0,3,0,2,2,3,3,H
1961-04-03,1960,Huddersfield Town,Charlton Athletic,2-2,2,2,2,2,4,0,D
1961-04-03,1960,Middlesbrough,Ipswich Town,3-1,3,1,2,2,4,2,H
1961-04-03,1960,Norwich City,Sunderland,3-0,3,0,2,2,3,3,H
1961-04-03,1960,Plymouth Argyle,Brighton & Hove Albion,1-2,1,2,2,2,3,-1,A
1961-04-03,1960,Portsmouth,Sheffield United,1-2,1,2,2,2,3,-1,A
1961-04-03,1960,Scunthorpe United,Leeds United,3-2,3,2,2,2,5,1,H
1961-04-03,1960,Southampton,Leyton Orient,1-1,1,1,2,2,2,0,D
1961-04-03,1960,Stoke City,Lincoln City,0-0,0,0,2,2,0,0,D
1961-04-03,1960,Swansea City,Luton Town,3-1,3,1,2,2,4,2,H
1961-04-04,1960,Bristol Rovers,Liverpool,4-3,4,3,2,2,7,1,H
1961-04-04,1960,Rotherham United,Derby County,1-1,1,1,2,2,2,0,D
1961-04-08,1960,Brighton & Hove Albion,Lincoln City,1-0,1,0,2,2,1,1,H
1961-04-08,1960,Bristol Rovers,Norwich City,3-1,3,1,2,2,4,2,H
1961-04-08,1960,Derby County,Plymouth Argyle,4-1,4,1,2,2,5,3,H
1961-04-08,1960,Ipswich Town,Portsmouth,2-2,2,2,2,2,4,0,D
1961-04-08,1960,Leeds United,Swansea City,2-2,2,2,2,2,4,0,D
1961-04-08,1960,Leyton Orient,Sunderland,0-1,0,1,2,2,1,-1,A
1961-04-08,1960,Liverpool,Charlton Athletic,2-1,2,1,2,2,3,1,H
1961-04-08,1960,Middlesbrough,Luton Town,2-1,2,1,2,2,3,1,H
1961-04-08,1960,Rotherham United,Sheffield United,1-2,1,2,2,2,3,-1,A
1961-04-08,1960,Scunthorpe United,Huddersfield Town,0-1,0,1,2,2,1,-1,A
1961-04-08,1960,Southampton,Stoke City,0-1,0,1,2,2,1,-1,A
1961-04-10,1960,Leyton Orient,Stoke City,3-1,3,1,2,2,4,2,H
1961-04-11,1960,Scunthorpe United,Charlton Athletic,0-0,0,0,2,2,0,0,D
1961-04-15,1960,Charlton Athletic,Rotherham United,4-3,4,3,2,2,7,1,H
1961-04-15,1960,Huddersfield Town,Leyton Orient,1-0,1,0,2,2,1,1,H
1961-04-15,1960,Lincoln City,Ipswich Town,1-4,1,4,2,2,5,-3,A
1961-04-15,1960,Luton Town,Brighton & Hove Albion,3-1,3,1,2,2,4,2,H
1961-04-15,1960,Norwich City,Liverpool,2-1,2,1,2,2,3,1,H
1961-04-15,1960,Plymouth Argyle,Bristol Rovers,5-0,5,0,2,2,5,5,H
1961-04-15,1960,Portsmouth,Scunthorpe United,2-2,2,2,2,2,4,0,D
1961-04-15,1960,Sheffield United,Southampton,2-1,2,1,2,2,3,1,H
1961-04-15,1960,Stoke City,Leeds United,0-0,0,0,2,2,0,0,D
1961-04-15,1960,Sunderland,Derby County,1-2,1,2,2,2,3,-1,A
1961-04-15,1960,Swansea City,Middlesbrough,3-2,3,2,2,2,5,1,H
1961-04-17,1960,Sunderland,Southampton,3-1,3,1,2,2,4,2,H
1961-04-18,1960,Rotherham United,Brighton & Hove Albion,5-2,5,2,2,2,7,3,H
1961-04-19,1960,Portsmouth,Bristol Rovers,3-0,3,0,2,2,3,3,H
1961-04-19,1960,Sheffield United,Derby County,3-1,3,1,2,2,4,2,H
1961-04-22,1960,Brighton & Hove Albion,Huddersfield Town,2-1,2,1,2,2,3,1,H
1961-04-22,1960,Bristol Rovers,Sheffield United,3-1,3,1,2,2,4,2,H
1961-04-22,1960,Derby County,Charlton Athletic,2-3,2,3,2,2,5,-1,A
1961-04-22,1960,Ipswich Town,Sunderland,4-0,4,0,2,2,4,4,H
1961-04-22,1960,Leeds United,Lincoln City,7-0,7,0,2,2,7,7,H
1961-04-22,1960,Leyton Orient,Norwich City,1-0,1,0,2,2,1,1,H
1961-04-22,1960,Liverpool,Stoke City,3-0,3,0,2,2,3,3,H
1961-04-22,1960,Middlesbrough,Portsmouth,3-0,3,0,2,2,3,3,H
1961-04-22,1960,Rotherham United,Swansea City,3-3,3,3,2,2,6,0,D
1961-04-22,1960,Scunthorpe United,Plymouth Argyle,2-0,2,0,2,2,2,2,H
1961-04-22,1960,Southampton,Luton Town,3-2,3,2,2,2,5,1,H
1961-04-24,1960,Derby County,Ipswich Town,1-4,1,4,2,2,5,-3,A
1961-04-25,1960,Leeds United,Scunthorpe United,2-2,2,2,2,2,4,0,D
1961-04-26,1960,Luton Town,Charlton Athletic,4-1,4,1,2,2,5,3,H
1961-04-29,1960,Charlton Athletic,Leeds United,2-0,2,0,2,2,2,2,H
1961-04-29,1960,Huddersfield Town,Bristol Rovers,4-0,4,0,2,2,4,4,H
1961-04-29,1960,Lincoln City,Leyton Orient,2-0,2,0,2,2,2,2,H
1961-04-29,1960,Luton Town,Scunthorpe United,0-0,0,0,2,2,0,0,D
1961-04-29,1960,Norwich City,Southampton,5-0,5,0,2,2,5,5,H
1961-04-29,1960,Plymouth Argyle,Rotherham United,3-3,3,3,2,2,6,0,D
1961-04-29,1960,Portsmouth,Derby County,3-2,3,2,2,2,5,1,H
1961-04-29,1960,Sheffield United,Middlesbrough,4-1,4,1,2,2,5,3,H
1961-04-29,1960,Stoke City,Brighton & Hove Albion,0-2,0,2,2,2,2,-2,A
1961-04-29,1960,Sunderland,Liverpool,1-1,1,1,2,2,2,0,D
1961-04-29,1960,Swansea City,Ipswich Town,2-1,2,1,2,2,3,1,H
1961-05-03,1960,Stoke City,Liverpool,3-1,3,1,2,2,4,2,H
1961-08-19,1961,Bristol Rovers,Liverpool,0-2,0,2,2,2,2,-2,A
1961-08-19,1961,Leeds United,Charlton Athletic,1-0,1,0,2,2,1,1,H
1961-08-19,1961,Luton Town,Preston North End,4-1,4,1,2,2,5,3,H
1961-08-19,1961,Middlesbrough,Derby County,3-4,3,4,2,2,7,-1,A
1961-08-19,1961,Newcastle United,Leyton Orient,0-0,0,0,2,2,0,0,D
1961-08-19,1961,Norwich City,Bury,3-1,3,1,2,2,4,2,H
1961-08-19,1961,Scunthorpe United,Brighton & Hove Albion,3-3,3,3,2,2,6,0,D
1961-08-19,1961,Southampton,Plymouth Argyle,1-2,1,2,2,2,3,-1,A
1961-08-19,1961,Stoke City,Rotherham United,1-2,1,2,2,2,3,-1,A
1961-08-19,1961,Swansea City,Huddersfield Town,1-1,1,1,2,2,2,0,D
1961-08-19,1961,Walsall,Sunderland,4-3,4,3,2,2,7,1,H
1961-08-21,1961,Leyton Orient,Southampton,1-3,1,3,2,2,4,-2,A
1961-08-22,1961,Brighton & Hove Albion,Leeds United,1-3,1,3,2,2,4,-2,A
1961-08-22,1961,Bury,Bristol Rovers,2-0,2,0,2,2,2,2,H
1961-08-22,1961,Charlton Athletic,Stoke City,2-2,2,2,2,2,4,0,D
1961-08-22,1961,Preston North End,Swansea City,1-1,1,1,2,2,2,0,D
1961-08-23,1961,Derby County,Luton Town,2-0,2,0,2,2,2,2,H
1961-08-23,1961,Huddersfield Town,Plymouth Argyle,5-1,5,1,2,2,6,4,H
1961-08-23,1961,Liverpool,Sunderland,3-0,3,0,2,2,3,3,H
1961-08-23,1961,Newcastle United,Walsall,1-0,1,0,2,2,1,1,H
1961-08-23,1961,Norwich City,Scunthorpe United,2-2,2,2,2,2,4,0,D
1961-08-26,1961,Brighton & Hove Albion,Swansea City,2-2,2,2,2,2,4,0,D
1961-08-26,1961,Bury,Scunthorpe United,4-1,4,1,2,2,5,3,H
1961-08-26,1961,Charlton Athletic,Norwich City,2-2,2,2,2,2,4,0,D
1961-08-26,1961,Derby County,Walsall,1-3,1,3,2,2,4,-2,A
1961-08-26,1961,Huddersfield Town,Southampton,1-0,1,0,2,2,1,1,H
1961-08-26,1961,Leyton Orient,Middlesbrough,2-0,2,0,2,2,2,2,H
1961-08-26,1961,Liverpool,Leeds United,5-0,5,0,2,2,5,5,H
1961-08-26,1961,Plymouth Argyle,Luton Town,0-3,0,3,2,2,3,-3,A
1961-08-26,1961,Preston North End,Newcastle United,0-1,0,1,2,2,1,-1,A
1961-08-26,1961,Rotherham United,Bristol Rovers,4-0,4,0,2,2,4,4,H
1961-08-26,1961,Sunderland,Stoke City,2-1,2,1,2,2,3,1,H
1961-08-28,1961,Bristol Rovers,Bury,0-1,0,1,2,2,1,-1,A
1961-08-28,1961,Stoke City,Charlton Athletic,4-0,4,0,2,2,4,4,H
1961-08-29,1961,Scunthorpe United,Norwich City,2-0,2,0,2,2,2,2,H
1961-08-29,1961,Swansea City,Preston North End,1-2,1,2,2,2,3,-1,A
1961-08-29,1961,Walsall,Newcastle United,1-0,1,0,2,2,1,1,H
1961-08-30,1961,Leeds United,Brighton & Hove Albion,1-1,1,1,2,2,2,0,D
1961-08-30,1961,Luton Town,Derby County,4-2,4,2,2,2,6,2,H
1961-08-30,1961,Middlesbrough,Rotherham United,5-1,5,1,2,2,6,4,H
1961-08-30,1961,Plymouth Argyle,Huddersfield Town,4-2,4,2,2,2,6,2,H
1961-08-30,1961,Southampton,Leyton Orient,1-2,1,2,2,2,3,-1,A
1961-08-30,1961,Sunderland,Liverpool,1-4,1,4,2,2,5,-3,A
1961-09-01,1961,Scunthorpe United,Charlton Athletic,6-1,6,1,2,2,7,5,H
1961-09-02,1961,Brighton & Hove Albion,Bury,0-2,0,2,2,2,2,-2,A
1961-09-02,1961,Bristol Rovers,Sunderland,2-3,2,3,2,2,5,-1,A
1961-09-02,1961,Leeds United,Rotherham United,1-3,1,3,2,2,4,-2,A
1961-09-02,1961,Luton Town,Huddersfield Town,3-4,3,4,2,2,7,-1,A
1961-09-02,1961,Middlesbrough,Preston North End,1-0,1,0,2,2,1,1,H
1961-09-02,1961,Newcastle United,Plymouth Argyle,0-2,0,2,2,2,2,-2,A
1961-09-02,1961,Norwich City,Liverpool,1-2,1,2,2,2,3,-1,A
1961-09-02,1961,Southampton,Swansea City,5-1,5,1,2,2,6,4,H
1961-09-02,1961,Stoke City,Derby County,1-1,1,1,2,2,2,0,D
1961-09-02,1961,Walsall,Leyton Orient,1-5,1,5,2,2,6,-4,A
1961-09-05,1961,Brighton & Hove Albion,Stoke City,2-1,2,1,2,2,3,1,H
1961-09-05,1961,Scunthorpe United,Bristol Rovers,2-1,2,1,2,2,3,1,H
1961-09-06,1961,Derby County,Swansea City,6-3,6,3,2,2,9,3,H
1961-09-06,1961,Norwich City,Leeds United,2-0,2,0,2,2,2,2,H
1961-09-06,1961,Southampton,Walsall,1-1,1,1,2,2,2,0,D
1961-09-09,1961,Bury,Southampton,0-2,0,2,2,2,2,-2,A
1961-09-09,1961,Charlton Athletic,Brighton & Hove Albion,2-3,2,3,2,2,5,-1,A
1961-09-09,1961,Huddersfield Town,Newcastle United,2-1,2,1,2,2,3,1,H
1961-09-09,1961,Leyton Orient,Derby County,2-0,2,0,2,2,2,2,H
1961-09-09,1961,Liverpool,Scunthorpe United,2-1,2,1,2,2,3,1,H
1961-09-09,1961,Plymouth Argyle,Middlesbrough,1-1,1,1,2,2,2,0,D
1961-09-09,1961,Preston North End,Walsall,2-3,2,3,2,2,5,-1,A
1961-09-09,1961,Rotherham United,Norwich City,3-1,3,1,2,2,4,2,H
1961-09-09,1961,Stoke City,Bristol Rovers,2-1,2,1,2,2,3,1,H
1961-09-09,1961,Sunderland,Leeds United,2-1,2,1,2,2,3,1,H
1961-09-09,1961,Swansea City,Luton Town,3-2,3,2,2,2,5,1,H
1961-09-15,1961,Bury,Charlton Athletic,1-2,1,2,2,2,3,-1,A
1961-09-15,1961,Scunthorpe United,Rotherham United,5-2,5,2,2,2,7,3,H
1961-09-16,1961,Brighton & Hove Albion,Liverpool,0-0,0,0,2,2,0,0,D
1961-09-16,1961,Bristol Rovers,Leyton Orient,2-1,2,1,2,2,3,1,H
1961-09-16,1961,Derby County,Preston North End,3-2,3,2,2,2,5,1,H
1961-09-16,1961,Leeds United,Stoke City,3-1,3,1,2,2,4,2,H
1961-09-16,1961,Luton Town,Southampton,1-4,1,4,2,2,5,-3,A
1961-09-16,1961,Middlesbrough,Huddersfield Town,1-0,1,0,2,2,1,1,H
1961-09-16,1961,Newcastle United,Swansea City,2-2,2,2,2,2,4,0,D
1961-09-16,1961,Norwich City,Sunderland,3-1,3,1,2,2,4,2,H
1961-09-16,1961,Walsall,Plymouth Argyle,1-0,1,0,2,2,1,1,H
1961-09-18,1961,Bristol Rovers,Scunthorpe United,2-1,2,1,2,2,3,1,H
1961-09-18,1961,Stoke City,Brighton & Hove Albion,0-1,0,1,2,2,1,-1,A
1961-09-19,1961,Bury,Sunderland,3-2,3,2,2,2,5,1,H
1961-09-19,1961,Swansea City,Derby County,3-1,3,1,2,2,4,2,H
1961-09-19,1961,Walsall,Southampton,0-2,0,2,2,2,2,-2,A
1961-09-20,1961,Charlton Athletic,Rotherham United,0-2,0,2,2,2,2,-2,A
1961-09-20,1961,Leeds United,Norwich City,0-1,0,1,2,2,1,-1,A
1961-09-20,1961,Leyton Orient,Huddersfield Town,3-0,3,0,2,2,3,3,H
1961-09-20,1961,Middlesbrough,Luton Town,2-4,2,4,2,2,6,-2,A
1961-09-20,1961,Newcastle United,Liverpool,1-2,1,2,2,2,3,-1,A
1961-09-20,1961,Plymouth Argyle,Preston North End,1-0,1,0,2,2,1,1,H
1961-09-23,1961,Bristol Rovers,Leeds United,4-0,4,0,2,2,4,4,H
1961-09-23,1961,Charlton Athletic,Luton Town,0-1,0,1,2,2,1,-1,A
1961-09-23,1961,Huddersfield Town,Walsall,4-2,4,2,2,2,6,2,H
1961-09-23,1961,Liverpool,Bury,5-0,5,0,2,2,5,5,H
1961-09-23,1961,Plymouth Argyle,Derby County,2-3,2,3,2,2,5,-1,A
1961-09-23,1961,Preston North End,Leyton Orient,3-2,3,2,2,2,5,1,H
1961-09-23,1961,Rotherham United,Brighton & Hove Albion,2-1,2,1,2,2,3,1,H
1961-09-23,1961,Southampton,Newcastle United,1-0,1,0,2,2,1,1,H
1961-09-23,1961,Stoke City,Norwich City,3-1,3,1,2,2,4,2,H
1961-09-23,1961,Sunderland,Scunthorpe United,4-0,4,0,2,2,4,4,H
1961-09-23,1961,Swansea City,Middlesbrough,3-3,3,3,2,2,6,0,D
1961-09-26,1961,Preston North End,Plymouth Argyle,1-1,1,1,2,2,2,0,D
1961-09-26,1961,Rotherham United,Charlton Athletic,3-2,3,2,2,2,5,1,H
1961-09-27,1961,Huddersfield Town,Leyton Orient,1-1,1,1,2,2,2,0,D
1961-09-27,1961,Luton Town,Middlesbrough,3-2,3,2,2,2,5,1,H
1961-09-27,1961,Sunderland,Bury,3-0,3,0,2,2,3,3,H
1961-09-29,1961,Leyton Orient,Plymouth Argyle,1-2,1,2,2,2,3,-1,A
1961-09-29,1961,Scunthorpe United,Stoke City,2-2,2,2,2,2,4,0,D
1961-09-30,1961,Brighton & Hove Albion,Sunderland,1-1,1,1,2,2,2,0,D
1961-09-30,1961,Bury,Rotherham United,2-1,2,1,2,2,3,1,H
1961-09-30,1961,Charlton Athletic,Liverpool,0-4,0,4,2,2,4,-4,A
1961-09-30,1961,Derby County,Huddersfield Town,1-0,1,0,2,2,1,1,H
1961-09-30,1961,Leeds United,Preston North End,1-2,1,2,2,2,3,-1,A
1961-09-30,1961,Middlesbrough,Southampton,1-1,1,1,2,2,2,0,D
1961-09-30,1961,Newcastle United,Luton Town,4-1,4,1,2,2,5,3,H
1961-09-30,1961,Norwich City,Bristol Rovers,2-2,2,2,2,2,4,0,D
1961-09-30,1961,Walsall,Swansea City,0-0,0,0,2,2,0,0,D
1961-10-04,1961,Liverpool,Newcastle United,2-0,2,0,2,2,2,2,H
1961-10-07,1961,Derby County,Sunderland,1-1,1,1,2,2,2,0,D
1961-10-07,1961,Huddersfield Town,Norwich City,1-1,1,1,2,2,2,0,D
1961-10-07,1961,Leyton Orient,Stoke City,3-0,3,0,2,2,3,3,H
1961-10-07,1961,Luton Town,Bury,4-0,4,0,2,2,4,4,H
1961-10-07,1961,Middlesbrough,Liverpool,2-0,2,0,2,2,2,2,H
1961-10-07,1961,Newcastle United,Charlton Athletic,4-1,4,1,2,2,5,3,H
1961-10-07,1961,Plymouth Argyle,Leeds United,1-1,1,1,2,2,2,0,D
1961-10-07,1961,Preston North End,Bristol Rovers,1-0,1,0,2,2,1,1,H
1961-10-07,1961,Southampton,Brighton & Hove Albion,6-1,6,1,2,2,7,5,H
1961-10-07,1961,Swansea City,Scunthorpe United,2-1,2,1,2,2,3,1,H
1961-10-07,1961,Walsall,Rotherham United,5-0,5,0,2,2,5,5,H
1961-10-13,1961,Scunthorpe United,Southampton,5-1,5,1,2,2,6,4,H
1961-10-14,1961,Brighton & Hove Albion,Luton Town,2-1,2,1,2,2,3,1,H
1961-10-14,1961,Bristol Rovers,Plymouth Argyle,4-3,4,3,2,2,7,1,H
1961-10-14,1961,Bury,Newcastle United,2-7,2,7,2,2,9,-5,A
1961-10-14,1961,Charlton Athletic,Middlesbrough,1-0,1,0,2,2,1,1,H
1961-10-14,1961,Leeds United,Huddersfield Town,1-0,1,0,2,2,1,1,H
1961-10-14,1961,Liverpool,Walsall,6-1,6,1,2,2,7,5,H
1961-10-14,1961,Norwich City,Swansea City,2-1,2,1,2,2,3,1,H
1961-10-14,1961,Rotherham United,Derby County,2-2,2,2,2,2,4,0,D
1961-10-14,1961,Stoke City,Preston North End,1-1,1,1,2,2,2,0,D
1961-10-14,1961,Sunderland,Leyton Orient,2-1,2,1,2,2,3,1,H
1961-10-18,1961,Southampton,Preston North End,0-0,0,0,2,2,0,0,D
1961-10-21,1961,Derby County,Liverpool,2-0,2,0,2,2,2,2,H
1961-10-21,1961,Huddersfield Town,Bristol Rovers,4-1,4,1,2,2,5,3,H
1961-10-21,1961,Leyton Orient,Rotherham United,1-1,1,1,2,2,2,0,D
1961-10-21,1961,Luton Town,Scunthorpe United,1-2,1,2,2,2,3,-1,A
1961-10-21,1961,Middlesbrough,Bury,2-1,2,1,2,2,3,1,H
1961-10-21,1961,Newcastle United,Brighton & Hove Albion,5-0,5,0,2,2,5,5,H
1961-10-21,1961,Plymouth Argyle,Stoke City,3-1,3,1,2,2,4,2,H
1961-10-21,1961,Preston North End,Sunderland,0-1,0,1,2,2,1,-1,A
1961-10-21,1961,Southampton,Norwich City,2-2,2,2,2,2,4,0,D
1961-10-21,1961,Swansea City,Leeds United,2-1,2,1,2,2,3,1,H
1961-10-21,1961,Walsall,Charlton Athletic,2-2,2,2,2,2,4,0,D
1961-10-24,1961,Bury,Walsall,2-1,2,1,2,2,3,1,H
1961-10-27,1961,Scunthorpe United,Newcastle United,3-2,3,2,2,2,5,1,H
1961-10-28,1961,Brighton & Hove Albion,Middlesbrough,2-0,2,0,2,2,2,2,H
1961-10-28,1961,Bristol Rovers,Swansea City,4-1,4,1,2,2,5,3,H
1961-10-28,1961,Charlton Athletic,Derby County,4-0,4,0,2,2,4,4,H
1961-10-28,1961,Leeds United,Southampton,1-1,1,1,2,2,2,0,D
1961-10-28,1961,Liverpool,Leyton Orient,3-3,3,3,2,2,6,0,D
1961-10-28,1961,Norwich City,Luton Town,0-4,0,4,2,2,4,-4,A
1961-10-28,1961,Rotherham United,Preston North End,2-2,2,2,2,2,4,0,D
1961-10-28,1961,Stoke City,Huddersfield Town,3-0,3,0,2,2,3,3,H
1961-10-28,1961,Sunderland,Plymouth Argyle,5-0,5,0,2,2,5,5,H
1961-11-04,1961,Derby County,Bury,3-0,3,0,2,2,3,3,H
1961-11-04,1961,Huddersfield Town,Sunderland,0-0,0,0,2,2,0,0,D
1961-11-04,1961,Leyton Orient,Charlton Athletic,2-1,2,1,2,2,3,1,H
1961-11-04,1961,Luton Town,Leeds United,3-2,3,2,2,2,5,1,H
1961-11-04,1961,Middlesbrough,Scunthorpe United,1-2,1,2,2,2,3,-1,A
1961-11-04,1961,Newcastle United,Norwich City,0-0,0,0,2,2,0,0,D
1961-11-04,1961,Plymouth Argyle,Rotherham United,2-5,2,5,2,2,7,-3,A
1961-11-04,1961,Preston North End,Liverpool,1-3,1,3,2,2,4,-2,A
1961-11-04,1961,Southampton,Bristol Rovers,0-2,0,2,2,2,2,-2,A
1961-11-04,1961,Swansea City,Stoke City,1-0,1,0,2,2,1,1,H
1961-11-04,1961,Walsall,Brighton & Hove Albion,2-2,2,2,2,2,4,0,D
1961-11-11,1961,Brighton & Hove Albion,Huddersfield Town,2-2,2,2,2,2,4,0,D
1961-11-11,1961,Bristol Rovers,Derby County,1-4,1,4,2,2,5,-3,A
1961-11-11,1961,Bury,Swansea City,1-1,1,1,2,2,2,0,D
1961-11-11,1961,Leeds United,Leyton Orient,0-0,0,0,2,2,0,0,D
1961-11-11,1961,Liverpool,Luton Town,1-1,1,1,2,2,2,0,D
1961-11-11,1961,Norwich City,Preston North End,2-0,2,0,2,2,2,2,H
1961-11-11,1961,Rotherham United,Newcastle United,0-0,0,0,2,2,0,0,D
1961-11-11,1961,Scunthorpe United,Plymouth Argyle,5-1,5,1,2,2,6,4,H
1961-11-11,1961,Stoke City,Walsall,2-1,2,1,2,2,3,1,H
1961-11-11,1961,Sunderland,Middlesbrough,2-1,2,1,2,2,3,1,H
1961-11-18,1961,Derby County,Scunthorpe United,2-2,2,2,2,2,4,0,D
1961-11-18,1961,Huddersfield Town,Liverpool,1-2,1,2,2,2,3,-1,A
1961-11-18,1961,Leyton Orient,Brighton & Hove Albion,4-1,4,1,2,2,5,3,H
1961-11-18,1961,Luton Town,Stoke City,0-0,0,0,2,2,0,0,D
1961-11-18,1961,Middlesbrough,Leeds United,1-3,1,3,2,2,4,-2,A
1961-11-18,1961,Newcastle United,Bristol Rovers,5-2,5,2,2,2,7,3,H
1961-11-18,1961,Plymouth Argyle,Charlton Athletic,2-1,2,1,2,2,3,1,H
1961-11-18,1961,Preston North End,Bury,1-2,1,2,2,2,3,-1,A
1961-11-18,1961,Southampton,Sunderland,2-0,2,0,2,2,2,2,H
1961-11-18,1961,Swansea City,Rotherham United,2-2,2,2,2,2,4,0,D
1961-11-18,1961,Walsall,Norwich City,5-0,5,0,2,2,5,5,H
1961-11-24,1961,Scunthorpe United,Leyton Orient,0-2,0,2,2,2,2,-2,A
1961-11-25,1961,Brighton & Hove Albion,Preston North End,0-0,0,0,2,2,0,0,D
1961-11-25,1961,Bristol Rovers,Middlesbrough,0-2,0,2,2,2,2,-2,A
1961-11-25,1961,Bury,Plymouth Argyle,1-1,1,1,2,2,2,0,D
1961-11-25,1961,Charlton Athletic,Huddersfield Town,0-2,0,2,2,2,2,-2,A
1961-11-25,1961,Leeds United,Walsall,4-1,4,1,2,2,5,3,H
1961-11-25,1961,Liverpool,Swansea City,5-0,5,0,2,2,5,5,H
1961-11-25,1961,Norwich City,Derby County,3-2,3,2,2,2,5,1,H
1961-11-25,1961,Rotherham United,Southampton,4-2,4,2,2,2,6,2,H
1961-11-25,1961,Stoke City,Newcastle United,3-1,3,1,2,2,4,2,H
1961-11-25,1961,Sunderland,Luton Town,2-2,2,2,2,2,4,0,D
1961-12-02,1961,Derby County,Leeds United,3-3,3,3,2,2,6,0,D
1961-12-02,1961,Huddersfield Town,Bury,2-0,2,0,2,2,2,2,H
1961-12-02,1961,Leyton Orient,Norwich City,2-0,2,0,2,2,2,2,H
1961-12-02,1961,Luton Town,Rotherham United,4-3,4,3,2,2,7,1,H
1961-12-02,1961,Middlesbrough,Stoke City,2-2,2,2,2,2,4,0,D
1961-12-02,1961,Newcastle United,Sunderland,2-2,2,2,2,2,4,0,D
1961-12-02,1961,Plymouth Argyle,Brighton & Hove Albion,5-0,5,0,2,2,5,5,H
1961-12-02,1961,Preston North End,Scunthorpe United,4-1,4,1,2,2,5,3,H
1961-12-02,1961,Southampton,Liverpool,2-0,2,0,2,2,2,2,H
1961-12-02,1961,Swansea City,Charlton Athletic,1-0,1,0,2,2,1,1,H
1961-12-02,1961,Walsall,Bristol Rovers,0-0,0,0,2,2,0,0,D
1961-12-08,1961,Rotherham United,Huddersfield Town,3-3,3,3,2,2,6,0,D
1961-12-09,1961,Brighton & Hove Albion,Derby County,1-2,1,2,2,2,3,-1,A
1961-12-09,1961,Bristol Rovers,Luton Town,1-0,1,0,2,2,1,1,H
1961-12-09,1961,Charlton Athletic,Preston North End,4-0,4,0,2,2,4,4,H
1961-12-09,1961,Liverpool,Plymouth Argyle,2-1,2,1,2,2,3,1,H
1961-12-09,1961,Norwich City,Middlesbrough,5-4,5,4,2,2,9,1,H
1961-12-09,1961,Stoke City,Southampton,3-2,3,2,2,2,5,1,H
1961-12-09,1961,Sunderland,Swansea City,7-2,7,2,2,2,9,5,H
1961-12-16,1961,Brighton & Hove Albion,Scunthorpe United,0-3,0,3,2,2,3,-3,A
1961-12-16,1961,Bury,Norwich City,2-3,2,3,2,2,5,-1,A
1961-12-16,1961,Charlton Athletic,Leeds United,3-1,3,1,2,2,4,2,H
1961-12-16,1961,Derby County,Middlesbrough,3-2,3,2,2,2,5,1,H
1961-12-16,1961,Leyton Orient,Newcastle United,2-0,2,0,2,2,2,2,H
1961-12-16,1961,Liverpool,Bristol Rovers,2-0,2,0,2,2,2,2,H
1961-12-16,1961,Plymouth Argyle,Southampton,4-0,4,0,2,2,4,4,H
1961-12-16,1961,Preston North End,Luton Town,2-0,2,0,2,2,2,2,H
1961-12-16,1961,Rotherham United,Stoke City,1-2,1,2,2,2,3,-1,A
1961-12-16,1961,Sunderland,Walsall,3-0,3,0,2,2,3,3,H
1961-12-22,1961,Bristol Rovers,Rotherham United,4-2,4,2,2,2,6,2,H
1961-12-22,1961,Scunthorpe United,Bury,1-2,1,2,2,2,3,-1,A
1961-12-23,1961,Leeds United,Liverpool,1-0,1,0,2,2,1,1,H
1961-12-23,1961,Luton Town,Plymouth Argyle,0-2,0,2,2,2,2,-2,A
1961-12-23,1961,Middlesbrough,Leyton Orient,2-3,2,3,2,2,5,-1,A
1961-12-23,1961,Newcastle United,Preston North End,0-2,0,2,2,2,2,-2,A
1961-12-23,1961,Norwich City,Charlton Athletic,2-2,2,2,2,2,4,0,D
1961-12-23,1961,Southampton,Huddersfield Town,3-1,3,1,2,2,4,2,H
1961-12-23,1961,Stoke City,Sunderland,1-0,1,0,2,2,1,1,H
1961-12-23,1961,Swansea City,Brighton & Hove Albion,3-0,3,0,2,2,3,3,H
1961-12-23,1961,Walsall,Derby County,2-0,2,0,2,2,2,2,H
1961-12-26,1961,Bristol Rovers,Brighton & Hove Albion,0-1,0,1,2,2,1,-1,A
1961-12-26,1961,Bury,Stoke City,0-2,0,2,2,2,2,-2,A
1961-12-26,1961,Charlton Athletic,Sunderland,2-0,2,0,2,2,2,2,H
1961-12-26,1961,Derby County,Southampton,1-1,1,1,2,2,2,0,D
1961-12-26,1961,Leeds United,Scunthorpe United,1-4,1,4,2,2,5,-3,A
1961-12-26,1961,Leyton Orient,Swansea City,1-0,1,0,2,2,1,1,H
1961-12-26,1961,Newcastle United,Middlesbrough,3-4,3,4,2,2,7,-1,A
1961-12-26,1961,Norwich City,Plymouth Argyle,0-2,0,2,2,2,2,-2,A
1961-12-26,1961,Preston North End,Huddersfield Town,1-0,1,0,2,2,1,1,H
1961-12-26,1961,Rotherham United,Liverpool,1-0,1,0,2,2,1,1,H
1961-12-26,1961,Walsall,Luton Town,2-0,2,0,2,2,2,2,H
1961-12-30,1961,Brighton & Hove Albion,Bristol Rovers,1-0,1,0,2,2,1,1,H
1961-12-30,1961,Plymouth Argyle,Norwich City,3-1,3,1,2,2,4,2,H
1961-12-30,1961,Southampton,Derby County,2-1,2,1,2,2,3,1,H
1961-12-30,1961,Swansea City,Leyton Orient,1-3,1,3,2,2,4,-2,A
1962-01-12,1961,Rotherham United,Leeds United,2-1,2,1,2,2,3,1,H
1962-01-13,1961,Bury,Brighton & Hove Albion,2-1,2,1,2,2,3,1,H
1962-01-13,1961,Charlton Athletic,Scunthorpe United,3-3,3,3,2,2,6,0,D
1962-01-13,1961,Derby County,Stoke City,2-0,2,0,2,2,2,2,H
1962-01-13,1961,Huddersfield Town,Luton Town,1-2,1,2,2,2,3,-1,A
1962-01-13,1961,Leyton Orient,Walsall,3-0,3,0,2,2,3,3,H
1962-01-13,1961,Liverpool,Norwich City,5-4,5,4,2,2,9,1,H
1962-01-13,1961,Plymouth Argyle,Newcastle United,1-1,1,1,2,2,2,0,D
1962-01-13,1961,Preston North End,Middlesbrough,4-3,4,3,2,2,7,1,H
1962-01-13,1961,Sunderland,Bristol Rovers,6-1,6,1,2,2,7,5,H
1962-01-13,1961,Swansea City,Southampton,0-1,0,1,2,2,1,-1,A
1962-01-20,1961,Bristol Rovers,Stoke City,0-2,0,2,2,2,2,-2,A
1962-01-20,1961,Derby County,Leyton Orient,1-2,1,2,2,2,3,-1,A
1962-01-20,1961,Leeds United,Sunderland,1-0,1,0,2,2,1,1,H
1962-01-20,1961,Luton Town,Swansea City,5-1,5,1,2,2,6,4,H
1962-01-20,1961,Middlesbrough,Plymouth Argyle,1-1,1,1,2,2,2,0,D
1962-01-20,1961,Newcastle United,Huddersfield Town,1-1,1,1,2,2,2,0,D
1962-01-20,1961,Norwich City,Rotherham United,0-1,0,1,2,2,1,-1,A
1962-01-20,1961,Scunthorpe United,Liverpool,1-1,1,1,2,2,2,0,D
1962-01-20,1961,Southampton,Bury,5-3,5,3,2,2,8,2,H
1962-01-20,1961,Walsall,Preston North End,2-1,2,1,2,2,3,1,H
1962-01-27,1961,Leeds United,Newcastle United,0-1,0,1,2,2,1,-1,A
1962-02-02,1961,Rotherham United,Scunthorpe United,0-1,0,1,2,2,1,-1,A
1962-02-02,1961,Swansea City,Newcastle United,3-2,3,2,2,2,5,1,H
1962-02-03,1961,Charlton Athletic,Bury,1-0,1,0,2,2,1,1,H
1962-02-03,1961,Huddersfield Town,Middlesbrough,0-0,0,0,2,2,0,0,D
1962-02-03,1961,Leyton Orient,Bristol Rovers,2-3,2,3,2,2,5,-1,A
1962-02-03,1961,Liverpool,Brighton & Hove Albion,3-1,3,1,2,2,4,2,H
1962-02-03,1961,Plymouth Argyle,Walsall,2-1,2,1,2,2,3,1,H
1962-02-03,1961,Preston North End,Derby County,1-0,1,0,2,2,1,1,H
1962-02-03,1961,Southampton,Luton Town,3-0,3,0,2,2,3,3,H
1962-02-03,1961,Stoke City,Leeds United,2-1,2,1,2,2,3,1,H
1962-02-03,1961,Sunderland,Norwich City,2-0,2,0,2,2,2,2,H
1962-02-09,1961,Leyton Orient,Preston North End,0-2,0,2,2,2,2,-2,A
1962-02-10,1961,Brighton & Hove Albion,Rotherham United,0-3,0,3,2,2,3,-3,A
1962-02-10,1961,Bury,Liverpool,0-3,0,3,2,2,3,-3,A
1962-02-10,1961,Derby County,Plymouth Argyle,2-2,2,2,2,2,4,0,D
1962-02-10,1961,Leeds United,Bristol Rovers,0-0,0,0,2,2,0,0,D
1962-02-10,1961,Luton Town,Charlton Athletic,1-6,1,6,2,2,7,-5,A
1962-02-10,1961,Middlesbrough,Swansea City,1-3,1,3,2,2,4,-2,A
1962-02-10,1961,Newcastle United,Southampton,3-2,3,2,2,2,5,1,H
1962-02-10,1961,Norwich City,Stoke City,1-0,1,0,2,2,1,1,H
1962-02-10,1961,Scunthorpe United,Sunderland,3-1,3,1,2,2,4,2,H
1962-02-10,1961,Walsall,Huddersfield Town,2-2,2,2,2,2,4,0,D
1962-02-17,1961,Luton Town,Newcastle United,1-0,1,0,2,2,1,1,H
1962-02-17,1961,Plymouth Argyle,Leyton Orient,2-1,2,1,2,2,3,1,H
1962-02-17,1961,Rotherham United,Bury,2-0,2,0,2,2,2,2,H
1962-02-17,1961,Stoke City,Scunthorpe United,1-0,1,0,2,2,1,1,H
1962-02-17,1961,Sunderland,Brighton & Hove Albion,0-0,0,0,2,2,0,0,D
1962-02-17,1961,Swansea City,Walsall,1-3,1,3,2,2,4,-2,A
1962-02-20,1961,Scunthorpe United,Leeds United,2-1,2,1,2,2,3,1,H
1962-02-21,1961,Southampton,Middlesbrough,1-3,1,3,2,2,4,-2,A
1962-02-23,1961,Scunthorpe United,Swansea City,2-0,2,0,2,2,2,2,H
1962-02-24,1961,Brighton & Hove Albion,Southampton,0-0,0,0,2,2,0,0,D
1962-02-24,1961,Bristol Rovers,Preston North End,2-1,2,1,2,2,3,1,H
1962-02-24,1961,Bury,Luton Town,2-1,2,1,2,2,3,1,H
1962-02-24,1961,Charlton Athletic,Newcastle United,1-1,1,1,2,2,2,0,D
1962-02-24,1961,Leeds United,Plymouth Argyle,2-3,2,3,2,2,5,-1,A
1962-02-24,1961,Liverpool,Middlesbrough,5-1,5,1,2,2,6,4,H
1962-02-24,1961,Norwich City,Huddersfield Town,1-2,1,2,2,2,3,-1,A
1962-02-24,1961,Rotherham United,Walsall,2-2,2,2,2,2,4,0,D
1962-02-24,1961,Stoke City,Leyton Orient,0-1,0,1,2,2,1,-1,A
1962-02-24,1961,Sunderland,Derby County,2-1,2,1,2,2,3,1,H
1962-02-27,1961,Bristol Rovers,Norwich City,2-1,2,1,2,2,3,1,H
1962-03-03,1961,Derby County,Rotherham United,1-1,1,1,2,2,2,0,D
1962-03-03,1961,Huddersfield Town,Leeds United,2-1,2,1,2,2,3,1,H
1962-03-03,1961,Leyton Orient,Sunderland,1-1,1,1,2,2,2,0,D
1962-03-03,1961,Luton Town,Brighton & Hove Albion,2-1,2,1,2,2,3,1,H
1962-03-03,1961,Middlesbrough,Charlton Athletic,3-2,3,2,2,2,5,1,H
1962-03-03,1961,Newcastle United,Bury,1-2,1,2,2,2,3,-1,A
1962-03-03,1961,Plymouth Argyle,Bristol Rovers,3-1,3,1,2,2,4,2,H
1962-03-03,1961,Preston North End,Stoke City,1-2,1,2,2,2,3,-1,A
1962-03-03,1961,Southampton,Scunthorpe United,6-4,6,4,2,2,10,2,H
1962-03-03,1961,Swansea City,Norwich City,0-3,0,3,2,2,3,-3,A
1962-03-03,1961,Walsall,Liverpool,1-1,1,1,2,2,2,0,D
1962-03-06,1961,Charlton Athletic,Southampton,1-0,1,0,2,2,1,1,H
1962-03-06,1961,Scunthorpe United,Walsall,2-1,2,1,2,2,3,1,H
1962-03-07,1961,Middlesbrough,Newcastle United,3-0,3,0,2,2,3,3,H
1962-03-09,1961,Rotherham United,Leyton Orient,2-1,2,1,2,2,3,1,H
1962-03-10,1961,Brighton & Hove Albion,Newcastle United,0-4,0,4,2,2,4,-4,A
1962-03-10,1961,Bristol Rovers,Huddersfield Town,1-1,1,1,2,2,2,0,D
1962-03-10,1961,Bury,Middlesbrough,2-1,2,1,2,2,3,1,H
1962-03-10,1961,Charlton Athletic,Walsall,3-3,3,3,2,2,6,0,D
1962-03-10,1961,Leeds United,Swansea City,2-0,2,0,2,2,2,2,H
1962-03-10,1961,Liverpool,Derby County,4-1,4,1,2,2,5,3,H
1962-03-10,1961,Norwich City,Southampton,1-1,1,1,2,2,2,0,D
1962-03-10,1961,Scunthorpe United,Luton Town,2-0,2,0,2,2,2,2,H
1962-03-10,1961,Stoke City,Plymouth Argyle,2-0,2,0,2,2,2,2,H
1962-03-13,1961,Bury,Leyton Orient,0-1,0,1,2,2,1,-1,A
1962-03-14,1961,Sunderland,Charlton Athletic,4-1,4,1,2,2,5,3,H
1962-03-16,1961,Middlesbrough,Brighton & Hove Albion,4-0,4,0,2,2,4,4,H
1962-03-17,1961,Derby County,Charlton Athletic,0-1,0,1,2,2,1,-1,A
1962-03-17,1961,Huddersfield Town,Stoke City,3-0,3,0,2,2,3,3,H
1962-03-17,1961,Leyton Orient,Liverpool,2-2,2,2,2,2,4,0,D
1962-03-17,1961,Luton Town,Norwich City,1-2,1,2,2,2,3,-1,A
1962-03-17,1961,Newcastle United,Scunthorpe United,2-1,2,1,2,2,3,1,H
1962-03-17,1961,Plymouth Argyle,Sunderland,3-2,3,2,2,2,5,1,H
1962-03-17,1961,Preston North End,Rotherham United,2-0,2,0,2,2,2,2,H
1962-03-17,1961,Southampton,Leeds United,4-1,4,1,2,2,5,3,H
1962-03-17,1961,Swansea City,Bristol Rovers,1-1,1,1,2,2,2,0,D
1962-03-17,1961,Walsall,Bury,3-0,3,0,2,2,3,3,H
1962-03-21,1961,Sunderland,Preston North End,0-0,0,0,2,2,0,0,D
1962-03-23,1961,Scunthorpe United,Middlesbrough,1-1,1,1,2,2,2,0,D
1962-03-24,1961,Brighton & Hove Albion,Walsall,3-2,3,2,2,2,5,1,H
1962-03-24,1961,Bristol Rovers,Southampton,1-0,1,0,2,2,1,1,H
1962-03-24,1961,Bury,Derby County,2-2,2,2,2,2,4,0,D
1962-03-24,1961,Charlton Athletic,Leyton Orient,1-2,1,2,2,2,3,-1,A
1962-03-24,1961,Leeds United,Luton Town,2-1,2,1,2,2,3,1,H
1962-03-24,1961,Liverpool,Preston North End,4-1,4,1,2,2,5,3,H
1962-03-24,1961,Norwich City,Newcastle United,0-0,0,0,2,2,0,0,D
1962-03-24,1961,Rotherham United,Plymouth Argyle,1-3,1,3,2,2,4,-2,A
1962-03-24,1961,Stoke City,Swansea City,0-0,0,0,2,2,0,0,D
1962-03-24,1961,Sunderland,Huddersfield Town,3-1,3,1,2,2,4,2,H
1962-03-26,1961,Huddersfield Town,Swansea City,3-1,3,1,2,2,4,2,H
1962-03-28,1961,Liverpool,Rotherham United,4-1,4,1,2,2,5,3,H
1962-03-30,1961,Preston North End,Norwich City,2-0,2,0,2,2,2,2,H
1962-03-30,1961,Walsall,Stoke City,3-1,3,1,2,2,4,2,H
1962-03-31,1961,Derby County,Bristol Rovers,4-1,4,1,2,2,5,3,H
1962-03-31,1961,Huddersfield Town,Brighton & Hove Albion,2-0,2,0,2,2,2,2,H
1962-03-31,1961,Leyton Orient,Leeds United,0-0,0,0,2,2,0,0,D
1962-03-31,1961,Luton Town,Liverpool,1-0,1,0,2,2,1,1,H
1962-03-31,1961,Middlesbrough,Sunderland,0-1,0,1,2,2,1,-1,A
1962-03-31,1961,Newcastle United,Rotherham United,1-0,1,0,2,2,1,1,H
1962-03-31,1961,Plymouth Argyle,Scunthorpe United,3-1,3,1,2,2,4,2,H
1962-03-31,1961,Southampton,Charlton Athletic,1-2,1,2,2,2,3,-1,A
1962-03-31,1961,Swansea City,Bury,0-1,0,1,2,2,1,-1,A
1962-04-02,1961,Huddersfield Town,Preston North End,2-2,2,2,2,2,4,0,D
1962-04-03,1961,Rotherham United,Middlesbrough,0-1,0,1,2,2,1,-1,A
1962-04-06,1961,Scunthorpe United,Derby County,2-0,2,0,2,2,2,2,H
1962-04-07,1961,Brighton & Hove Albion,Leyton Orient,0-1,0,1,2,2,1,-1,A
1962-04-07,1961,Bristol Rovers,Newcastle United,2-1,2,1,2,2,3,1,H
1962-04-07,1961,Bury,Preston North End,2-1,2,1,2,2,3,1,H
1962-04-07,1961,Charlton Athletic,Plymouth Argyle,3-1,3,1,2,2,4,2,H
1962-04-07,1961,Leeds United,Middlesbrough,2-0,2,0,2,2,2,2,H
1962-04-07,1961,Liverpool,Huddersfield Town,1-1,1,1,2,2,2,0,D
1962-04-07,1961,Norwich City,Walsall,3-1,3,1,2,2,4,2,H
1962-04-07,1961,Rotherham United,Swansea City,1-2,1,2,2,2,3,-1,A
1962-04-07,1961,Stoke City,Luton Town,2-1,2,1,2,2,3,1,H
1962-04-07,1961,Sunderland,Southampton,3-0,3,0,2,2,3,3,H
1962-04-09,1961,Huddersfield Town,Derby County,4-0,4,0,2,2,4,4,H
1962-04-09,1961,Preston North End,Leeds United,1-1,1,1,2,2,2,0,D
1962-04-10,1961,Brighton & Hove Albion,Charlton Athletic,2-2,2,2,2,2,4,0,D
1962-04-11,1961,Luton Town,Walsall,2-0,2,0,2,2,2,2,H
1962-04-11,1961,Stoke City,Bury,1-3,1,3,2,2,4,-2,A
1962-04-14,1961,Derby County,Norwich City,1-1,1,1,2,2,2,0,D
1962-04-14,1961,Huddersfield Town,Charlton Athletic,0-2,0,2,2,2,2,-2,A
1962-04-14,1961,Leyton Orient,Scunthorpe United,0-1,0,1,2,2,1,-1,A
1962-04-14,1961,Luton Town,Sunderland,1-2,1,2,2,2,3,-1,A
1962-04-14,1961,Middlesbrough,Bristol Rovers,5-0,5,0,2,2,5,5,H
1962-04-14,1961,Newcastle United,Stoke City,2-0,2,0,2,2,2,2,H
1962-04-14,1961,Plymouth Argyle,Bury,1-2,1,2,2,2,3,-1,A
1962-04-14,1961,Preston North End,Brighton & Hove Albion,3-1,3,1,2,2,4,2,H
1962-04-14,1961,Southampton,Rotherham United,2-1,2,1,2,2,3,1,H
1962-04-14,1961,Walsall,Leeds United,1-1,1,1,2,2,2,0,D
1962-04-20,1961,Brighton & Hove Albion,Norwich City,2-1,2,1,2,2,3,1,H
1962-04-20,1961,Bristol Rovers,Charlton Athletic,2-2,2,2,2,2,4,0,D
1962-04-20,1961,Bury,Leeds United,1-1,1,1,2,2,2,0,D
1962-04-20,1961,Leyton Orient,Luton Town,0-0,0,0,2,2,0,0,D
1962-04-20,1961,Newcastle United,Derby County,3-0,3,0,2,2,3,3,H
1962-04-20,1961,Scunthorpe United,Preston North End,2-1,2,1,2,2,3,1,H
1962-04-21,1961,Brighton & Hove Albion,Plymouth Argyle,3-2,3,2,2,2,5,1,H
1962-04-21,1961,Bristol Rovers,Walsall,2-2,2,2,2,2,4,0,D
1962-04-21,1961,Bury,Huddersfield Town,1-2,1,2,2,2,3,-1,A
1962-04-21,1961,Charlton Athletic,Swansea City,3-2,3,2,2,2,5,1,H
1962-04-21,1961,Leeds United,Derby County,0-0,0,0,2,2,0,0,D
1962-04-21,1961,Liverpool,Southampton,2-0,2,0,2,2,2,2,H
1962-04-21,1961,Norwich City,Leyton Orient,0-0,0,0,2,2,0,0,D
1962-04-21,1961,Rotherham United,Luton Town,1-1,1,1,2,2,2,0,D
1962-04-21,1961,Stoke City,Middlesbrough,2-0,2,0,2,2,2,2,H
1962-04-21,1961,Sunderland,Newcastle United,3-0,3,0,2,2,3,3,H
1962-04-23,1961,Charlton Athletic,Bristol Rovers,2-1,2,1,2,2,3,1,H
1962-04-23,1961,Derby County,Newcastle United,1-2,1,2,2,2,3,-1,A
1962-04-23,1961,Huddersfield Town,Scunthorpe United,1-2,1,2,2,2,3,-1,A
1962-04-23,1961,Liverpool,Stoke City,2-1,2,1,2,2,3,1,H
1962-04-23,1961,Luton Town,Leyton Orient,1-3,1,3,2,2,4,-2,A
1962-04-23,1961,Norwich City,Brighton & Hove Albion,3-0,3,0,2,2,3,3,H
1962-04-23,1961,Plymouth Argyle,Swansea City,0-0,0,0,2,2,0,0,D
1962-04-23,1961,Preston North End,Southampton,1-1,1,1,2,2,2,0,D
1962-04-23,1961,Sunderland,Rotherham United,4-0,4,0,2,2,4,4,H
1962-04-23,1961,Walsall,Middlesbrough,1-2,1,2,2,2,3,-1,A
1962-04-24,1961,Leeds United,Bury,0-0,0,0,2,2,0,0,D
1962-04-24,1961,Middlesbrough,Walsall,3-0,3,0,2,2,3,3,H
1962-04-24,1961,Rotherham United,Sunderland,0-3,0,3,2,2,3,-3,A
1962-04-24,1961,Scunthorpe United,Huddersfield Town,1-3,1,3,2,2,4,-2,A
1962-04-24,1961,Stoke City,Liverpool,0-0,0,0,2,2,0,0,D
1962-04-24,1961,Swansea City,Plymouth Argyle,5-0,5,0,2,2,5,5,H
1962-04-28,1961,Derby County,Brighton & Hove Albion,2-0,2,0,2,2,2,2,H
1962-04-28,1961,Huddersfield Town,Rotherham United,0-3,0,3,2,2,3,-3,A
1962-04-28,1961,Leyton Orient,Bury,2-0,2,0,2,2,2,2,H
1962-04-28,1961,Luton Town,Bristol Rovers,2-0,2,0,2,2,2,2,H
1962-04-28,1961,Middlesbrough,Norwich City,2-1,2,1,2,2,3,1,H
1962-04-28,1961,Newcastle United,Leeds United,0-3,0,3,2,2,3,-3,A
1962-04-28,1961,Plymouth Argyle,Liverpool,2-3,2,3,2,2,5,-1,A
1962-04-28,1961,Preston North End,Charlton Athletic,2-0,2,0,2,2,2,2,H
1962-04-28,1961,Southampton,Stoke City,5-1,5,1,2,2,6,4,H
1962-04-28,1961,Swansea City,Sunderland,1-1,1,1,2,2,2,0,D
1962-04-28,1961,Walsall,Scunthorpe United,4-1,4,1,2,2,5,3,H
1962-04-30,1961,Liverpool,Charlton Athletic,2-1,2,1,2,2,3,1,H
1962-05-04,1961,Swansea City,Liverpool,4-2,4,2,2,2,6,2,H
1962-08-18,1962,Bury,Luton Town,1-0,1,0,2,2,1,1,H
1962-08-18,1962,Cardiff City,Newcastle United,4-4,4,4,2,2,8,0,D
1962-08-18,1962,Charlton Athletic,Swansea City,2-2,2,2,2,2,4,0,D
1962-08-18,1962,Huddersfield Town,Derby County,3-3,3,3,2,2,6,0,D
1962-08-18,1962,Plymouth Argyle,Grimsby Town,2-0,2,0,2,2,2,2,H
1962-08-18,1962,Portsmouth,Walsall,4-1,4,1,2,2,5,3,H
1962-08-18,1962,Preston North End,Norwich City,2-2,2,2,2,2,4,0,D
1962-08-18,1962,Rotherham United,Chelsea,0-1,0,1,2,2,1,-1,A
1962-08-18,1962,Scunthorpe United,Southampton,2-1,2,1,2,2,3,1,H
1962-08-18,1962,Stoke City,Leeds United,0-1,0,1,2,2,1,-1,A
1962-08-18,1962,Sunderland,Middlesbrough,3-1,3,1,2,2,4,2,H
1962-08-21,1962,Grimsby Town,Portsmouth,1-1,1,1,2,2,2,0,D
1962-08-21,1962,Walsall,Huddersfield Town,1-1,1,1,2,2,2,0,D
1962-08-22,1962,Chelsea,Scunthorpe United,3-0,3,0,2,2,3,3,H
1962-08-22,1962,Derby County,Stoke City,1-1,1,1,2,2,2,0,D
1962-08-22,1962,Leeds United,Rotherham United,3-4,3,4,2,2,7,-1,A
1962-08-22,1962,Middlesbrough,Newcastle United,4-2,4,2,2,2,6,2,H
1962-08-22,1962,Norwich City,Cardiff City,0-0,0,0,2,2,0,0,D
1962-08-22,1962,Plymouth Argyle,Preston North End,7-1,7,1,2,2,8,6,H
1962-08-22,1962,Southampton,Luton Town,2-2,2,2,2,2,4,0,D
1962-08-22,1962,Sunderland,Charlton Athletic,1-0,1,0,2,2,1,1,H
1962-08-23,1962,Swansea City,Bury,3-0,3,0,2,2,3,3,H
1962-08-25,1962,Chelsea,Charlton Athletic,5-0,5,0,2,2,5,5,H
1962-08-25,1962,Derby County,Cardiff City,1-2,1,2,2,2,3,-1,A
1962-08-25,1962,Grimsby Town,Scunthorpe United,3-0,3,0,2,2,3,3,H
1962-08-25,1962,Leeds United,Sunderland,1-0,1,0,2,2,1,1,H
1962-08-25,1962,Luton Town,Rotherham United,2-3,2,3,2,2,5,-1,A
1962-08-25,1962,Middlesbrough,Huddersfield Town,0-5,0,5,2,2,5,-5,A
1962-08-25,1962,Newcastle United,Portsmouth,1-1,1,1,2,2,2,0,D
1962-08-25,1962,Norwich City,Plymouth Argyle,2-1,2,1,2,2,3,1,H
1962-08-25,1962,Southampton,Bury,0-3,0,3,2,2,3,-3,A
1962-08-25,1962,Swansea City,Stoke City,2-1,2,1,2,2,3,1,H
1962-08-25,1962,Walsall,Preston North End,4-1,4,1,2,2,5,3,H
1962-08-28,1962,Charlton Athletic,Sunderland,2-2,2,2,2,2,4,0,D
1962-08-28,1962,Preston North End,Plymouth Argyle,0-0,0,0,2,2,0,0,D
1962-08-28,1962,Rotherham United,Leeds United,2-1,2,1,2,2,3,1,H
1962-08-28,1962,Scunthorpe United,Chelsea,3-0,3,0,2,2,3,3,H
1962-08-29,1962,Cardiff City,Norwich City,2-4,2,4,2,2,6,-2,A
1962-08-29,1962,Huddersfield Town,Walsall,4-0,4,0,2,2,4,4,H
1962-08-29,1962,Luton Town,Southampton,3-2,3,2,2,2,5,1,H
1962-08-29,1962,Newcastle United,Middlesbrough,6-1,6,1,2,2,7,5,H
1962-08-29,1962,Portsmouth,Grimsby Town,2-1,2,1,2,2,3,1,H
1962-08-29,1962,Stoke City,Derby County,3-3,3,3,2,2,6,0,D
1962-08-30,1962,Bury,Swansea City,2-0,2,0,2,2,2,2,H
1962-09-01,1962,Bury,Scunthorpe United,0-2,0,2,2,2,2,-2,A
1962-09-01,1962,Cardiff City,Middlesbrough,1-2,1,2,2,2,3,-1,A
1962-09-01,1962,Charlton Athletic,Luton Town,2-0,2,0,2,2,2,2,H
1962-09-01,1962,Grimsby Town,Norwich City,0-2,0,2,2,2,2,-2,A
1962-09-01,1962,Huddersfield Town,Leeds United,1-1,1,1,2,2,2,0,D
1962-09-01,1962,Plymouth Argyle,Walsall,3-0,3,0,2,2,3,3,H
1962-09-01,1962,Portsmouth,Derby County,1-0,1,0,2,2,1,1,H
1962-09-01,1962,Preston North End,Newcastle United,2-1,2,1,2,2,3,1,H
1962-09-01,1962,Rotherham United,Southampton,2-0,2,0,2,2,2,2,H
1962-09-01,1962,Stoke City,Chelsea,0-0,0,0,2,2,0,0,D
1962-09-01,1962,Sunderland,Swansea City,3-1,3,1,2,2,4,2,H
1962-09-04,1962,Scunthorpe United,Newcastle United,2-1,2,1,2,2,3,1,H
1962-09-04,1962,Swansea City,Cardiff City,2-1,2,1,2,2,3,1,H
1962-09-04,1962,Walsall,Middlesbrough,1-0,1,0,2,2,1,1,H
1962-09-05,1962,Leeds United,Bury,1-2,1,2,2,2,3,-1,A
1962-09-05,1962,Luton Town,Preston North End,0-2,0,2,2,2,2,-2,A
1962-09-05,1962,Norwich City,Huddersfield Town,2-3,2,3,2,2,5,-1,A
1962-09-05,1962,Sunderland,Rotherham United,2-0,2,0,2,2,2,2,H
1962-09-07,1962,Middlesbrough,Portsmouth,4-2,4,2,2,2,6,2,H
1962-09-08,1962,Chelsea,Sunderland,1-0,1,0,2,2,1,1,H
1962-09-08,1962,Derby County,Preston North End,1-0,1,0,2,2,1,1,H
1962-09-08,1962,Huddersfield Town,Cardiff City,1-0,1,0,2,2,1,1,H
1962-09-08,1962,Luton Town,Stoke City,0-0,0,0,2,2,0,0,D
1962-09-08,1962,Newcastle United,Plymouth Argyle,3-1,3,1,2,2,4,2,H
1962-09-08,1962,Norwich City,Bury,1-1,1,1,2,2,2,0,D
1962-09-08,1962,Scunthorpe United,Rotherham United,1-0,1,0,2,2,1,1,H
1962-09-08,1962,Southampton,Charlton Athletic,1-0,1,0,2,2,1,1,H
1962-09-08,1962,Swansea City,Leeds United,0-2,0,2,2,2,2,-2,A
1962-09-08,1962,Walsall,Grimsby Town,4-1,4,1,2,2,5,3,H
1962-09-10,1962,Chelsea,Southampton,2-0,2,0,2,2,2,2,H
1962-09-11,1962,Preston North End,Luton Town,3-1,3,1,2,2,4,2,H
1962-09-11,1962,Rotherham United,Sunderland,4-2,4,2,2,2,6,2,H
1962-09-11,1962,Scunthorpe United,Swansea City,1-0,1,0,2,2,1,1,H
1962-09-12,1962,Cardiff City,Grimsby Town,5-3,5,3,2,2,8,2,H
1962-09-12,1962,Huddersfield Town,Norwich City,0-0,0,0,2,2,0,0,D
1962-09-12,1962,Middlesbrough,Walsall,2-3,2,3,2,2,5,-1,A
1962-09-12,1962,Newcastle United,Derby County,0-0,0,0,2,2,0,0,D
1962-09-12,1962,Portsmouth,Plymouth Argyle,1-2,1,2,2,2,3,-1,A
1962-09-12,1962,Stoke City,Charlton Athletic,6-3,6,3,2,2,9,3,H
1962-09-15,1962,Cardiff City,Swansea City,5-2,5,2,2,2,7,3,H
1962-09-15,1962,Charlton Athletic,Scunthorpe United,1-0,1,0,2,2,1,1,H
1962-09-15,1962,Grimsby Town,Newcastle United,0-1,0,1,2,2,1,-1,A
1962-09-15,1962,Leeds United,Chelsea,2-0,2,0,2,2,2,2,H
1962-09-15,1962,Norwich City,Walsall,2-1,2,1,2,2,3,1,H
1962-09-15,1962,Plymouth Argyle,Derby County,2-1,2,1,2,2,3,1,H
1962-09-15,1962,Portsmouth,Huddersfield Town,1-1,1,1,2,2,2,0,D
1962-09-15,1962,Preston North End,Middlesbrough,0-1,0,1,2,2,1,-1,A
1962-09-15,1962,Rotherham United,Bury,1-5,1,5,2,2,6,-4,A
1962-09-15,1962,Stoke City,Southampton,3-1,3,1,2,2,4,2,H
1962-09-15,1962,Sunderland,Luton Town,3-1,3,1,2,2,4,2,H
1962-09-18,1962,Bury,Leeds United,3-1,3,1,2,2,4,2,H
1962-09-18,1962,Charlton Athletic,Stoke City,0-3,0,3,2,2,3,-3,A
1962-09-18,1962,Grimsby Town,Cardiff City,1-2,1,2,2,2,3,-1,A
1962-09-18,1962,Swansea City,Scunthorpe United,1-0,1,0,2,2,1,1,H
1962-09-19,1962,Derby County,Newcastle United,0-1,0,1,2,2,1,-1,A
1962-09-19,1962,Plymouth Argyle,Portsmouth,2-0,2,0,2,2,2,2,H
1962-09-19,1962,Southampton,Chelsea,2-1,2,1,2,2,3,1,H
1962-09-22,1962,Bury,Charlton Athletic,3-1,3,1,2,2,4,2,H
1962-09-22,1962,Cardiff City,Portsmouth,1-2,1,2,2,2,3,-1,A
1962-09-22,1962,Chelsea,Swansea City,2-2,2,2,2,2,4,0,D
1962-09-22,1962,Derby County,Grimsby Town,2-4,2,4,2,2,6,-2,A
1962-09-22,1962,Huddersfield Town,Preston North End,1-0,1,0,2,2,1,1,H
1962-09-22,1962,Luton Town,Leeds United,2-2,2,2,2,2,4,0,D
1962-09-22,1962,Middlesbrough,Plymouth Argyle,3-0,3,0,2,2,3,3,H
1962-09-22,1962,Newcastle United,Norwich City,2-1,2,1,2,2,3,1,H
1962-09-22,1962,Scunthorpe United,Stoke City,0-0,0,0,2,2,0,0,D
1962-09-22,1962,Southampton,Sunderland,2-4,2,4,2,2,6,-2,A
1962-09-22,1962,Walsall,Rotherham United,1-0,1,0,2,2,1,1,H
1962-09-29,1962,Charlton Athletic,Rotherham United,2-3,2,3,2,2,5,-1,A
1962-09-29,1962,Grimsby Town,Middlesbrough,3-4,3,4,2,2,7,-1,A
1962-09-29,1962,Leeds United,Southampton,1-1,1,1,2,2,2,0,D
1962-09-29,1962,Norwich City,Derby County,2-0,2,0,2,2,2,2,H
1962-09-29,1962,Plymouth Argyle,Huddersfield Town,1-1,1,1,2,2,2,0,D
1962-09-29,1962,Portsmouth,Chelsea,0-2,0,2,2,2,2,-2,A
1962-09-29,1962,Preston North End,Cardiff City,2-6,2,6,2,2,8,-4,A
1962-09-29,1962,Stoke City,Bury,2-0,2,0,2,2,2,2,H
1962-09-29,1962,Sunderland,Scunthorpe United,0-0,0,0,2,2,0,0,D
1962-09-29,1962,Swansea City,Luton Town,1-0,1,0,2,2,1,1,H
1962-09-29,1962,Walsall,Newcastle United,0-6,0,6,2,2,6,-6,A
1962-10-05,1962,Rotherham United,Norwich City,0-3,0,3,2,2,3,-3,A
1962-10-06,1962,Bury,Grimsby Town,2-0,2,0,2,2,2,2,H
1962-10-06,1962,Charlton Athletic,Walsall,3-2,3,2,2,2,5,1,H
1962-10-06,1962,Chelsea,Cardiff City,6-0,6,0,2,2,6,6,H
1962-10-06,1962,Leeds United,Middlesbrough,2-3,2,3,2,2,5,-1,A
1962-10-06,1962,Luton Town,Portsmouth,3-3,3,3,2,2,6,0,D
1962-10-06,1962,Scunthorpe United,Plymouth Argyle,2-2,2,2,2,2,4,0,D
1962-10-06,1962,Southampton,Preston North End,1-0,1,0,2,2,1,1,H
1962-10-06,1962,Stoke City,Newcastle United,3-1,3,1,2,2,4,2,H
1962-10-06,1962,Sunderland,Derby County,3-0,3,0,2,2,3,3,H
1962-10-06,1962,Swansea City,Huddersfield Town,1-2,1,2,2,2,3,-1,A
1962-10-13,1962,Cardiff City,Luton Town,1-0,1,0,2,2,1,1,H
1962-10-13,1962,Derby County,Leeds United,0-0,0,0,2,2,0,0,D
1962-10-13,1962,Grimsby Town,Rotherham United,1-2,1,2,2,2,3,-1,A
1962-10-13,1962,Huddersfield Town,Chelsea,1-0,1,0,2,2,1,1,H
1962-10-13,1962,Middlesbrough,Swansea City,2-2,2,2,2,2,4,0,D
1962-10-13,1962,Newcastle United,Sunderland,1-1,1,1,2,2,2,0,D
1962-10-13,1962,Norwich City,Charlton Athletic,1-4,1,4,2,2,5,-3,A
1962-10-13,1962,Plymouth Argyle,Bury,0-0,0,0,2,2,0,0,D
1962-10-13,1962,Portsmouth,Southampton,1-1,1,1,2,2,2,0,D
1962-10-13,1962,Preston North End,Scunthorpe United,3-1,3,1,2,2,4,2,H
1962-10-13,1962,Walsall,Stoke City,0-0,0,0,2,2,0,0,D
1962-10-19,1962,Scunthorpe United,Portsmouth,1-2,1,2,2,2,3,-1,A
1962-10-19,1962,Swansea City,Derby County,2-0,2,0,2,2,2,2,H
1962-10-20,1962,Bury,Preston North End,0-0,0,0,2,2,0,0,D
1962-10-20,1962,Charlton Athletic,Grimsby Town,0-3,0,3,2,2,3,-3,A
1962-10-20,1962,Chelsea,Middlesbrough,3-2,3,2,2,2,5,1,H
1962-10-20,1962,Leeds United,Newcastle United,1-0,1,0,2,2,1,1,H
1962-10-20,1962,Rotherham United,Plymouth Argyle,3-2,3,2,2,2,5,1,H
1962-10-20,1962,Stoke City,Norwich City,3-0,3,0,2,2,3,3,H
1962-10-20,1962,Sunderland,Walsall,5-0,5,0,2,2,5,5,H
1962-10-27,1962,Cardiff City,Scunthorpe United,4-0,4,0,2,2,4,4,H
1962-10-27,1962,Derby County,Chelsea,1-3,1,3,2,2,4,-2,A
1962-10-27,1962,Grimsby Town,Stoke City,1-1,1,1,2,2,2,0,D
1962-10-27,1962,Huddersfield Town,Southampton,2-3,2,3,2,2,5,-1,A
1962-10-27,1962,Middlesbrough,Luton Town,0-2,0,2,2,2,2,-2,A
1962-10-27,1962,Newcastle United,Swansea City,6-0,6,0,2,2,6,6,H
1962-10-27,1962,Norwich City,Sunderland,4-2,4,2,2,2,6,2,H
1962-10-27,1962,Plymouth Argyle,Charlton Athletic,6-1,6,1,2,2,7,5,H
1962-10-27,1962,Portsmouth,Bury,2-1,2,1,2,2,3,1,H
1962-10-27,1962,Preston North End,Rotherham United,2-2,2,2,2,2,4,0,D
1962-10-27,1962,Walsall,Leeds United,1-1,1,1,2,2,2,0,D
1962-10-31,1962,Southampton,Cardiff City,3-5,3,5,2,2,8,-2,A
1962-11-02,1962,Scunthorpe United,Huddersfield Town,2-2,2,2,2,2,4,0,D
1962-11-03,1962,Bury,Cardiff City,1-0,1,0,2,2,1,1,H
1962-11-03,1962,Charlton Athletic,Preston North End,2-1,2,1,2,2,3,1,H
1962-11-03,1962,Chelsea,Newcastle United,4-2,4,2,2,2,6,2,H
1962-11-03,1962,Leeds United,Norwich City,3-0,3,0,2,2,3,3,H
1962-11-03,1962,Luton Town,Derby County,1-2,1,2,2,2,3,-1,A
1962-11-03,1962,Rotherham United,Portsmouth,0-0,0,0,2,2,0,0,D
1962-11-03,1962,Southampton,Middlesbrough,6-0,6,0,2,2,6,6,H
1962-11-03,1962,Stoke City,Plymouth Argyle,2-2,2,2,2,2,4,0,D
1962-11-03,1962,Sunderland,Grimsby Town,6-2,6,2,2,2,8,4,H
1962-11-03,1962,Swansea City,Walsall,3-0,3,0,2,2,3,3,H
1962-11-10,1962,Cardiff City,Rotherham United,4-1,4,1,2,2,5,3,H
1962-11-10,1962,Derby County,Southampton,3-1,3,1,2,2,4,2,H
1962-11-10,1962,Grimsby Town,Leeds United,1-1,1,1,2,2,2,0,D
1962-11-10,1962,Huddersfield Town,Bury,0-1,0,1,2,2,1,-1,A
1962-11-10,1962,Middlesbrough,Scunthorpe United,4-3,4,3,2,2,7,1,H
1962-11-10,1962,Newcastle United,Luton Town,3-1,3,1,2,2,4,2,H
1962-11-10,1962,Norwich City,Swansea City,5-0,5,0,2,2,5,5,H
1962-11-10,1962,Plymouth Argyle,Sunderland,1-1,1,1,2,2,2,0,D
1962-11-10,1962,Portsmouth,Charlton Athletic,3-3,3,3,2,2,6,0,D
1962-11-10,1962,Preston North End,Stoke City,1-1,1,1,2,2,2,0,D
1962-11-10,1962,Walsall,Chelsea,1-5,1,5,2,2,6,-4,A
1962-11-16,1962,Scunthorpe United,Derby County,2-1,2,1,2,2,3,1,H
1962-11-17,1962,Bury,Middlesbrough,1-0,1,0,2,2,1,1,H
1962-11-17,1962,Charlton Athletic,Cardiff City,2-4,2,4,2,2,6,-2,A
1962-11-17,1962,Chelsea,Norwich City,2-0,2,0,2,2,2,2,H
1962-11-17,1962,Leeds United,Plymouth Argyle,6-1,6,1,2,2,7,5,H
1962-11-17,1962,Luton Town,Walsall,4-3,4,3,2,2,7,1,H
1962-11-17,1962,Rotherham United,Huddersfield Town,0-2,0,2,2,2,2,-2,A
1962-11-17,1962,Southampton,Newcastle United,3-0,3,0,2,2,3,3,H
1962-11-17,1962,Stoke City,Portsmouth,3-1,3,1,2,2,4,2,H
1962-11-17,1962,Sunderland,Preston North End,2-1,2,1,2,2,3,1,H
1962-11-17,1962,Swansea City,Grimsby Town,1-0,1,0,2,2,1,1,H
1962-11-24,1962,Cardiff City,Stoke City,1-1,1,1,2,2,2,0,D
1962-11-24,1962,Derby County,Bury,0-0,0,0,2,2,0,0,D
1962-11-24,1962,Grimsby Town,Chelsea,0-3,0,3,2,2,3,-3,A
1962-11-24,1962,Huddersfield Town,Charlton Athletic,2-0,2,0,2,2,2,2,H
1962-11-24,1962,Middlesbrough,Rotherham United,2-1,2,1,2,2,3,1,H
1962-11-24,1962,Newcastle United,Scunthorpe United,1-1,1,1,2,2,2,0,D
1962-11-24,1962,Norwich City,Luton Town,3-3,3,3,2,2,6,0,D
1962-11-24,1962,Plymouth Argyle,Swansea City,1-0,1,0,2,2,1,1,H
1962-11-24,1962,Portsmouth,Sunderland,3-1,3,1,2,2,4,2,H
1962-11-24,1962,Preston North End,Leeds United,4-1,4,1,2,2,5,3,H
1962-11-24,1962,Walsall,Southampton,1-1,1,1,2,2,2,0,D
1962-11-30,1962,Rotherham United,Derby County,2-2,2,2,2,2,4,0,D
1962-11-30,1962,Scunthorpe United,Walsall,2-0,2,0,2,2,2,2,H
1962-12-01,1962,Bury,Newcastle United,0-0,0,0,2,2,0,0,D
1962-12-01,1962,Charlton Athletic,Middlesbrough,3-4,3,4,2,2,7,-1,A
1962-12-01,1962,Chelsea,Plymouth Argyle,1-1,1,1,2,2,2,0,D
1962-12-01,1962,Leeds United,Portsmouth,3-3,3,3,2,2,6,0,D
1962-12-01,1962,Luton Town,Grimsby Town,2-2,2,2,2,2,4,0,D
1962-12-01,1962,Southampton,Norwich City,3-1,3,1,2,2,4,2,H
1962-12-01,1962,Stoke City,Huddersfield Town,2-1,2,1,2,2,3,1,H
1962-12-01,1962,Sunderland,Cardiff City,2-1,2,1,2,2,3,1,H
1962-12-01,1962,Swansea City,Preston North End,1-1,1,1,2,2,2,0,D
1962-12-08,1962,Cardiff City,Leeds United,0-0,0,0,2,2,0,0,D
1962-12-08,1962,Derby County,Charlton Athletic,2-3,2,3,2,2,5,-1,A
1962-12-08,1962,Grimsby Town,Southampton,4-1,4,1,2,2,5,3,H
1962-12-08,1962,Huddersfield Town,Sunderland,0-3,0,3,2,2,3,-3,A
1962-12-08,1962,Middlesbrough,Stoke City,2-2,2,2,2,2,4,0,D
1962-12-08,1962,Newcastle United,Rotherham United,4-1,4,1,2,2,5,3,H
1962-12-08,1962,Norwich City,Scunthorpe United,3-3,3,3,2,2,6,0,D
1962-12-08,1962,Plymouth Argyle,Luton Town,3-1,3,1,2,2,4,2,H
1962-12-08,1962,Portsmouth,Swansea City,0-0,0,0,2,2,0,0,D
1962-12-08,1962,Preston North End,Chelsea,1-3,1,3,2,2,4,-2,A
1962-12-08,1962,Walsall,Bury,3-1,3,1,2,2,4,2,H
1962-12-15,1962,Chelsea,Rotherham United,3-0,3,0,2,2,3,3,H
1962-12-15,1962,Derby County,Huddersfield Town,2-1,2,1,2,2,3,1,H
1962-12-15,1962,Grimsby Town,Plymouth Argyle,1-1,1,1,2,2,2,0,D
1962-12-15,1962,Leeds United,Stoke City,3-1,3,1,2,2,4,2,H
1962-12-15,1962,Luton Town,Bury,2-1,2,1,2,2,3,1,H
1962-12-15,1962,Middlesbrough,Sunderland,3-3,3,3,2,2,6,0,D
1962-12-15,1962,Newcastle United,Cardiff City,2-1,2,1,2,2,3,1,H
1962-12-15,1962,Norwich City,Preston North End,1-1,1,1,2,2,2,0,D
1962-12-15,1962,Southampton,Scunthorpe United,1-1,1,1,2,2,2,0,D
1962-12-15,1962,Swansea City,Charlton Athletic,2-1,2,1,2,2,3,1,H
1962-12-15,1962,Walsall,Portsmouth,3-5,3,5,2,2,8,-2,A
1962-12-21,1962,Rotherham United,Luton Town,2-1,2,1,2,2,3,1,H
1962-12-21,1962,Scunthorpe United,Grimsby Town,1-1,1,1,2,2,2,0,D
1962-12-22,1962,Cardiff City,Derby County,1-0,1,0,2,2,1,1,H
1962-12-22,1962,Charlton Athletic,Chelsea,1-4,1,4,2,2,5,-3,A
1962-12-22,1962,Plymouth Argyle,Norwich City,1-0,1,0,2,2,1,1,H
1962-12-22,1962,Portsmouth,Newcastle United,3-1,3,1,2,2,4,2,H
1962-12-22,1962,Sunderland,Leeds United,2-1,2,1,2,2,3,1,H
1962-12-26,1962,Luton Town,Chelsea,0-2,0,2,2,2,2,-2,A
1962-12-26,1962,Plymouth Argyle,Cardiff City,4-2,4,2,2,2,6,2,H
1962-12-26,1962,Preston North End,Portsmouth,4-2,4,2,2,2,6,2,H
1962-12-26,1962,Rotherham United,Stoke City,1-2,1,2,2,2,3,-1,A
1962-12-26,1962,Sunderland,Bury,0-1,0,1,2,2,1,-1,A
1962-12-26,1962,Swansea City,Southampton,1-1,1,1,2,2,2,0,D
1962-12-29,1962,Bury,Sunderland,3-0,3,0,2,2,3,3,H
1962-12-29,1962,Grimsby Town,Huddersfield Town,1-1,1,1,2,2,2,0,D
1962-12-29,1962,Norwich City,Middlesbrough,3-4,3,4,2,2,7,-1,A
1963-01-19,1962,Bury,Norwich City,0-3,0,3,2,2,3,-3,A
1963-01-19,1962,Plymouth Argyle,Newcastle United,0-2,0,2,2,2,2,-2,A
1963-02-09,1962,Charlton Athletic,Bury,0-0,0,0,2,2,0,0,D
1963-02-09,1962,Plymouth Argyle,Middlesbrough,4-5,4,5,2,2,9,-1,A
1963-02-09,1962,Swansea City,Chelsea,2-0,2,0,2,2,2,2,H
1963-02-16,1962,Middlesbrough,Grimsby Town,0-1,0,1,2,2,1,-1,A
1963-02-23,1962,Cardiff City,Chelsea,1-0,1,0,2,2,1,1,H
1963-02-23,1962,Derby County,Sunderland,2-2,2,2,2,2,4,0,D
1963-02-23,1962,Norwich City,Rotherham United,4-2,4,2,2,2,6,2,H
1963-02-23,1962,Plymouth Argyle,Scunthorpe United,2-3,2,3,2,2,5,-1,A
1963-02-23,1962,Portsmouth,Luton Town,3-1,3,1,2,2,4,2,H
1963-02-23,1962,Preston North End,Southampton,1-0,1,0,2,2,1,1,H
1963-03-02,1962,Bury,Plymouth Argyle,1-2,1,2,2,2,3,-1,A
1963-03-02,1962,Charlton Athletic,Norwich City,0-2,0,2,2,2,2,-2,A
1963-03-02,1962,Chelsea,Huddersfield Town,1-2,1,2,2,2,3,-1,A
1963-03-02,1962,Leeds United,Derby County,3-1,3,1,2,2,4,2,H
1963-03-02,1962,Southampton,Portsmouth,4-2,4,2,2,2,6,2,H
1963-03-02,1962,Stoke City,Walsall,3-0,3,0,2,2,3,3,H
1963-03-02,1962,Sunderland,Newcastle United,0-0,0,0,2,2,0,0,D
1963-03-02,1962,Swansea City,Middlesbrough,1-1,1,1,2,2,2,0,D
1963-03-09,1962,Cardiff City,Southampton,3-1,3,1,2,2,4,2,H
1963-03-09,1962,Derby County,Swansea City,0-2,0,2,2,2,2,-2,A
1963-03-09,1962,Grimsby Town,Charlton Athletic,2-1,2,1,2,2,3,1,H
1963-03-09,1962,Huddersfield Town,Luton Town,2-0,2,0,2,2,2,2,H
1963-03-09,1962,Middlesbrough,Chelsea,1-0,1,0,2,2,1,1,H
1963-03-09,1962,Newcastle United,Leeds United,1-1,1,1,2,2,2,0,D
1963-03-09,1962,Norwich City,Stoke City,6-0,6,0,2,2,6,6,H
1963-03-09,1962,Plymouth Argyle,Rotherham United,2-2,2,2,2,2,4,0,D
1963-03-09,1962,Portsmouth,Scunthorpe United,1-2,1,2,2,2,3,-1,A
1963-03-09,1962,Preston North End,Bury,0-2,0,2,2,2,2,-2,A
1963-03-09,1962,Walsall,Sunderland,2-3,2,3,2,2,5,-1,A
1963-03-13,1962,Leeds United,Walsall,3-0,3,0,2,2,3,3,H
1963-03-15,1962,Scunthorpe United,Cardiff City,2-2,2,2,2,2,4,0,D
1963-03-16,1962,Charlton Athletic,Plymouth Argyle,6-3,6,3,2,2,9,3,H
1963-03-16,1962,Luton Town,Huddersfield Town,3-2,3,2,2,2,5,1,H
1963-03-16,1962,Rotherham United,Preston North End,3-1,3,1,2,2,4,2,H
1963-03-16,1962,Stoke City,Grimsby Town,4-1,4,1,2,2,5,3,H
1963-03-16,1962,Swansea City,Newcastle United,1-0,1,0,2,2,1,1,H
1963-03-16,1962,Walsall,Derby County,1-3,1,3,2,2,4,-2,A
1963-03-19,1962,Bury,Rotherham United,0-5,0,5,2,2,5,-5,A
1963-03-19,1962,Preston North End,Walsall,4-2,4,2,2,2,6,2,H
1963-03-20,1962,Derby County,Plymouth Argyle,3-2,3,2,2,2,5,1,H
1963-03-20,1962,Southampton,Huddersfield Town,3-1,3,1,2,2,4,2,H
1963-03-20,1962,Sunderland,Norwich City,7-1,7,1,2,2,8,6,H
1963-03-23,1962,Cardiff City,Bury,3-1,3,1,2,2,4,2,H
1963-03-23,1962,Derby County,Luton Town,1-0,1,0,2,2,1,1,H
1963-03-23,1962,Grimsby Town,Sunderland,1-2,1,2,2,2,3,-1,A
1963-03-23,1962,Huddersfield Town,Scunthorpe United,2-0,2,0,2,2,2,2,H
1963-03-23,1962,Middlesbrough,Southampton,1-2,1,2,2,2,3,-1,A
1963-03-23,1962,Newcastle United,Chelsea,2-0,2,0,2,2,2,2,H
1963-03-23,1962,Norwich City,Leeds United,3-2,3,2,2,2,5,1,H
1963-03-23,1962,Plymouth Argyle,Stoke City,0-1,0,1,2,2,1,-1,A
1963-03-23,1962,Portsmouth,Rotherham United,1-2,1,2,2,2,3,-1,A
1963-03-23,1962,Preston North End,Charlton Athletic,4-1,4,1,2,2,5,3,H
1963-03-23,1962,Walsall,Swansea City,0-1,0,1,2,2,1,-1,A
1963-03-25,1962,Luton Town,Middlesbrough,4-3,4,3,2,2,7,1,H
1963-03-26,1962,Scunthorpe United,Preston North End,4-1,4,1,2,2,5,3,H
1963-03-26,1962,Walsall,Plymouth Argyle,2-2,2,2,2,2,4,0,D
1963-03-27,1962,Chelsea,Derby County,3-1,3,1,2,2,4,2,H
1963-03-27,1962,Newcastle United,Grimsby Town,0-0,0,0,2,2,0,0,D
1963-03-27,1962,Stoke City,Swansea City,2-0,2,0,2,2,2,2,H
1963-03-29,1962,Rotherham United,Cardiff City,2-1,2,1,2,2,3,1,H
1963-03-29,1962,Scunthorpe United,Middlesbrough,1-1,1,1,2,2,2,0,D
1963-03-30,1962,Bury,Huddersfield Town,1-1,1,1,2,2,2,0,D
1963-03-30,1962,Charlton Athletic,Portsmouth,2-0,2,0,2,2,2,2,H
1963-03-30,1962,Chelsea,Walsall,0-1,0,1,2,2,1,-1,A
1963-03-30,1962,Leeds United,Grimsby Town,3-0,3,0,2,2,3,3,H
1963-03-30,1962,Luton Town,Newcastle United,2-3,2,3,2,2,5,-1,A
1963-03-30,1962,Stoke City,Preston North End,3-0,3,0,2,2,3,3,H
1963-03-30,1962,Sunderland,Plymouth Argyle,1-1,1,1,2,2,2,0,D
1963-04-01,1962,Chelsea,Luton Town,3-1,3,1,2,2,4,2,H
1963-04-01,1962,Huddersfield Town,Plymouth Argyle,4-2,4,2,2,2,6,2,H
1963-04-01,1962,Stoke City,Rotherham United,3-1,3,1,2,2,4,2,H
1963-04-02,1962,Bury,Portsmouth,2-0,2,0,2,2,2,2,H
1963-04-03,1962,Leeds United,Scunthorpe United,1-0,1,0,2,2,1,1,H
1963-04-03,1962,Newcastle United,Charlton Athletic,3-2,3,2,2,2,5,1,H
1963-04-06,1962,Cardiff City,Charlton Athletic,1-2,1,2,2,2,3,-1,A
1963-04-06,1962,Derby County,Scunthorpe United,6-2,6,2,2,2,8,4,H
1963-04-06,1962,Grimsby Town,Swansea City,1-0,1,0,2,2,1,1,H
1963-04-06,1962,Huddersfield Town,Rotherham United,1-0,1,0,2,2,1,1,H
1963-04-06,1962,Middlesbrough,Bury,0-0,0,0,2,2,0,0,D
1963-04-06,1962,Newcastle United,Southampton,4-1,4,1,2,2,5,3,H
1963-04-06,1962,Norwich City,Chelsea,4-1,4,1,2,2,5,3,H
1963-04-06,1962,Plymouth Argyle,Leeds United,3-1,3,1,2,2,4,2,H
1963-04-06,1962,Portsmouth,Stoke City,0-3,0,3,2,2,3,-3,A
1963-04-06,1962,Preston North End,Sunderland,1-1,1,1,2,2,2,0,D
1963-04-06,1962,Walsall,Luton Town,1-1,1,1,2,2,2,0,D
1963-04-09,1962,Swansea City,Norwich City,2-0,2,0,2,2,2,2,H
1963-04-12,1962,Chelsea,Bury,2-0,2,0,2,2,2,2,H
1963-04-12,1962,Grimsby Town,Preston North End,2-0,2,0,2,2,2,2,H
1963-04-12,1962,Middlesbrough,Derby County,5-1,5,1,2,2,6,4,H
1963-04-12,1962,Newcastle United,Huddersfield Town,1-1,1,1,2,2,2,0,D
1963-04-12,1962,Plymouth Argyle,Southampton,2-1,2,1,2,2,3,1,H
1963-04-12,1962,Scunthorpe United,Luton Town,2-0,2,0,2,2,2,2,H
1963-04-12,1962,Sunderland,Stoke City,0-0,0,0,2,2,0,0,D
1963-04-13,1962,Bury,Derby County,3-3,3,3,2,2,6,0,D
1963-04-13,1962,Charlton Athletic,Huddersfield Town,1-0,1,0,2,2,1,1,H
1963-04-13,1962,Chelsea,Grimsby Town,2-1,2,1,2,2,3,1,H
1963-04-13,1962,Leeds United,Preston North End,4-1,4,1,2,2,5,3,H
1963-04-13,1962,Luton Town,Norwich City,4-2,4,2,2,2,6,2,H
1963-04-13,1962,Rotherham United,Middlesbrough,4-1,4,1,2,2,5,3,H
1963-04-13,1962,Southampton,Walsall,2-0,2,0,2,2,2,2,H
1963-04-13,1962,Stoke City,Cardiff City,1-0,1,0,2,2,1,1,H
1963-04-13,1962,Sunderland,Portsmouth,1-0,1,0,2,2,1,1,H
1963-04-13,1962,Swansea City,Plymouth Argyle,2-1,2,1,2,2,3,1,H
1963-04-15,1962,Cardiff City,Walsall,2-2,2,2,2,2,4,0,D
1963-04-15,1962,Charlton Athletic,Leeds United,1-2,1,2,2,2,3,-1,A
1963-04-15,1962,Derby County,Middlesbrough,3-3,3,3,2,2,6,0,D
1963-04-15,1962,Luton Town,Scunthorpe United,1-0,1,0,2,2,1,1,H
1963-04-15,1962,Portsmouth,Norwich City,0-2,0,2,2,2,2,-2,A
1963-04-15,1962,Preston North End,Grimsby Town,0-0,0,0,2,2,0,0,D
1963-04-15,1962,Rotherham United,Swansea City,2-1,2,1,2,2,3,1,H
1963-04-15,1962,Southampton,Plymouth Argyle,1-1,1,1,2,2,2,0,D
1963-04-15,1962,Stoke City,Sunderland,2-1,2,1,2,2,3,1,H
1963-04-16,1962,Bury,Chelsea,2-0,2,0,2,2,2,2,H
1963-04-16,1962,Huddersfield Town,Newcastle United,2-1,2,1,2,2,3,1,H
1963-04-16,1962,Leeds United,Charlton Athletic,4-1,4,1,2,2,5,3,H
1963-04-16,1962,Norwich City,Portsmouth,5-3,5,3,2,2,8,2,H
1963-04-16,1962,Swansea City,Rotherham United,2-2,2,2,2,2,4,0,D
1963-04-16,1962,Walsall,Cardiff City,2-1,2,1,2,2,3,1,H
1963-04-20,1962,Cardiff City,Sunderland,5-2,5,2,2,2,7,3,H
1963-04-20,1962,Derby County,Rotherham United,3-2,3,2,2,2,5,1,H
1963-04-20,1962,Grimsby Town,Luton Town,3-1,3,1,2,2,4,2,H
1963-04-20,1962,Huddersfield Town,Stoke City,3-3,3,3,2,2,6,0,D
1963-04-20,1962,Middlesbrough,Charlton Athletic,2-1,2,1,2,2,3,1,H
1963-04-20,1962,Newcastle United,Bury,1-3,1,3,2,2,4,-2,A
1963-04-20,1962,Norwich City,Southampton,1-0,1,0,2,2,1,1,H
1963-04-20,1962,Plymouth Argyle,Chelsea,2-1,2,1,2,2,3,1,H
1963-04-20,1962,Portsmouth,Leeds United,3-0,3,0,2,2,3,3,H
1963-04-20,1962,Preston North End,Swansea City,6-3,6,3,2,2,9,3,H
1963-04-20,1962,Walsall,Scunthorpe United,1-1,1,1,2,2,2,0,D
1963-04-22,1962,Southampton,Swansea City,3-0,3,0,2,2,3,3,H
1963-04-23,1962,Charlton Athletic,Newcastle United,1-2,1,2,2,2,3,-1,A
1963-04-23,1962,Scunthorpe United,Leeds United,0-2,0,2,2,2,2,-2,A
1963-04-24,1962,Derby County,Walsall,2-0,2,0,2,2,2,2,H
1963-04-24,1962,Huddersfield Town,Grimsby Town,0-0,0,0,2,2,0,0,D
1963-04-24,1962,Luton Town,Cardiff City,2-3,2,3,2,2,5,-1,A
1963-04-26,1962,Scunthorpe United,Norwich City,3-1,3,1,2,2,4,2,H
1963-04-27,1962,Bury,Walsall,0-0,0,0,2,2,0,0,D
1963-04-27,1962,Charlton Athletic,Derby County,0-0,0,0,2,2,0,0,D
1963-04-27,1962,Chelsea,Preston North End,2-0,2,0,2,2,2,2,H
1963-04-27,1962,Leeds United,Cardiff City,3-0,3,0,2,2,3,3,H
1963-04-27,1962,Luton Town,Plymouth Argyle,3-0,3,0,2,2,3,3,H
1963-04-27,1962,Rotherham United,Newcastle United,3-1,3,1,2,2,4,2,H
1963-04-27,1962,Stoke City,Middlesbrough,0-1,0,1,2,2,1,-1,A
1963-04-27,1962,Sunderland,Huddersfield Town,1-1,1,1,2,2,2,0,D
1963-04-27,1962,Swansea City,Portsmouth,0-0,0,0,2,2,0,0,D
1963-04-29,1962,Huddersfield Town,Middlesbrough,0-0,0,0,2,2,0,0,D
1963-04-30,1962,Chelsea,Leeds United,2-2,2,2,2,2,4,0,D
1963-04-30,1962,Grimsby Town,Walsall,3-1,3,1,2,2,4,2,H
1963-04-30,1962,Rotherham United,Charlton Athletic,1-2,1,2,2,2,3,-1,A
1963-04-30,1962,Scunthorpe United,Sunderland,1-1,1,1,2,2,2,0,D
1963-05-01,1962,Cardiff City,Plymouth Argyle,2-1,2,1,2,2,3,1,H
1963-05-01,1962,Luton Town,Swansea City,3-1,3,1,2,2,4,2,H
1963-05-01,1962,Newcastle United,Stoke City,5-2,5,2,2,2,7,3,H
1963-05-01,1962,Portsmouth,Preston North End,1-2,1,2,2,2,3,-1,A
1963-05-01,1962,Southampton,Derby County,5-0,5,0,2,2,5,5,H
1963-05-04,1962,Grimsby Town,Derby County,0-0,0,0,2,2,0,0,D
1963-05-04,1962,Leeds United,Luton Town,3-0,3,0,2,2,3,3,H
1963-05-04,1962,Norwich City,Newcastle United,1-2,1,2,2,2,3,-1,A
1963-05-04,1962,Portsmouth,Cardiff City,2-0,2,0,2,2,2,2,H
1963-05-04,1962,Preston North End,Huddersfield Town,2-0,2,0,2,2,2,2,H
1963-05-04,1962,Rotherham United,Walsall,1-2,1,2,2,2,3,-1,A
1963-05-04,1962,Stoke City,Scunthorpe United,2-3,2,3,2,2,5,-1,A
1963-05-04,1962,Sunderland,Southampton,4-0,4,0,2,2,4,4,H
1963-05-06,1962,Cardiff City,Preston North End,1-1,1,1,2,2,2,0,D
1963-05-06,1962,Derby County,Norwich City,3-0,3,0,2,2,3,3,H
1963-05-06,1962,Huddersfield Town,Swansea City,4-1,4,1,2,2,5,3,H
1963-05-06,1962,Middlesbrough,Leeds United,2-1,2,1,2,2,3,1,H
1963-05-07,1962,Bury,Southampton,1-1,1,1,2,2,2,0,D
1963-05-07,1962,Rotherham United,Grimsby Town,0-0,0,0,2,2,0,0,D
1963-05-07,1962,Scunthorpe United,Charlton Athletic,2-0,2,0,2,2,2,2,H
1963-05-08,1962,Newcastle United,Walsall,0-2,0,2,2,2,2,-2,A
1963-05-10,1962,Derby County,Portsmouth,4-0,4,0,2,2,4,4,H
1963-05-10,1962,Scunthorpe United,Bury,1-0,1,0,2,2,1,1,H
1963-05-11,1962,Chelsea,Stoke City,0-1,0,1,2,2,1,-1,A
1963-05-11,1962,Leeds United,Huddersfield Town,0-1,0,1,2,2,1,-1,A
1963-05-11,1962,Luton Town,Charlton Athletic,4-1,4,1,2,2,5,3,H
1963-05-11,1962,Middlesbrough,Cardiff City,3-2,3,2,2,2,5,1,H
1963-05-11,1962,Newcastle United,Preston North End,2-2,2,2,2,2,4,0,D
1963-05-11,1962,Norwich City,Grimsby Town,0-0,0,0,2,2,0,0,D
1963-05-11,1962,Southampton,Rotherham United,1-0,1,0,2,2,1,1,H
1963-05-11,1962,Swansea City,Sunderland,3-4,3,4,2,2,7,-1,A
1963-05-13,1962,Huddersfield Town,Portsmouth,1-3,1,3,2,2,4,-2,A
1963-05-13,1962,Luton Town,Sunderland,0-3,0,3,2,2,3,-3,A
1963-05-13,1962,Southampton,Grimsby Town,4-1,4,1,2,2,5,3,H
1963-05-14,1962,Bury,Stoke City,2-1,2,1,2,2,3,1,H
1963-05-14,1962,Walsall,Norwich City,3-1,3,1,2,2,4,2,H
1963-05-15,1962,Middlesbrough,Preston North End,2-0,2,0,2,2,2,2,H
1963-05-15,1962,Southampton,Leeds United,3-1,3,1,2,2,4,2,H
1963-05-17,1962,Rotherham United,Scunthorpe United,1-0,1,0,2,2,1,1,H
1963-05-18,1962,Cardiff City,Huddersfield Town,3-0,3,0,2,2,3,3,H
1963-05-18,1962,Charlton Athletic,Southampton,2-1,2,1,2,2,3,1,H
1963-05-18,1962,Grimsby Town,Bury,5-1,5,1,2,2,6,4,H
1963-05-18,1962,Leeds United,Swansea City,5-0,5,0,2,2,5,5,H
1963-05-18,1962,Portsmouth,Middlesbrough,1-1,1,1,2,2,2,0,D
1963-05-18,1962,Preston North End,Derby County,1-0,1,0,2,2,1,1,H
1963-05-18,1962,Stoke City,Luton Town,2-0,2,0,2,2,2,2,H
1963-05-18,1962,Sunderland,Chelsea,0-1,0,1,2,2,1,-1,A
1963-05-21,1962,Chelsea,Portsmouth,7-0,7,0,2,2,7,7,H
1963-05-21,1962,Middlesbrough,Norwich City,6-2,6,2,2,2,8,4,H
1963-05-22,1962,Southampton,Stoke City,2-0,2,0,2,2,2,2,H
1963-05-24,1962,Walsall,Charlton Athletic,1-2,1,2,2,2,3,-1,A
1963-08-24,1963,Bury,Rotherham United,4-2,4,2,2,2,6,2,H
1963-08-24,1963,Cardiff City,Norwich City,3-1,3,1,2,2,4,2,H
1963-08-24,1963,Huddersfield Town,Sunderland,0-2,0,2,2,2,2,-2,A
1963-08-24,1963,Leyton Orient,Preston North End,2-2,2,2,2,2,4,0,D
1963-08-24,1963,Manchester City,Portsmouth,0-2,0,2,2,2,2,-2,A
1963-08-24,1963,Middlesbrough,Plymouth Argyle,5-0,5,0,2,2,5,5,H
1963-08-24,1963,Newcastle United,Derby County,3-1,3,1,2,2,4,2,H
1963-08-24,1963,Southampton,Charlton Athletic,6-1,6,1,2,2,7,5,H
1963-08-24,1963,Swansea City,Grimsby Town,1-1,1,1,2,2,2,0,D
1963-08-24,1963,Swindon Town,Scunthorpe United,3-0,3,0,2,2,3,3,H
1963-08-26,1963,Middlesbrough,Newcastle United,3-0,3,0,2,2,3,3,H
1963-08-27,1963,Preston North End,Charlton Athletic,3-1,3,1,2,2,4,2,H
1963-08-27,1963,Scunthorpe United,Northampton Town,1-2,1,2,2,2,3,-1,A
1963-08-28,1963,Cardiff City,Manchester City,2-2,2,2,2,2,4,0,D
1963-08-28,1963,Derby County,Swansea City,3-0,3,0,2,2,3,3,H
1963-08-28,1963,Grimsby Town,Swindon Town,1-2,1,2,2,2,3,-1,A
1963-08-28,1963,Leeds United,Rotherham United,1-0,1,0,2,2,1,1,H
1963-08-28,1963,Norwich City,Bury,0-1,0,1,2,2,1,-1,A
1963-08-28,1963,Plymouth Argyle,Leyton Orient,2-2,2,2,2,2,4,0,D
1963-08-28,1963,Southampton,Huddersfield Town,1-1,1,1,2,2,2,0,D
1963-08-28,1963,Sunderland,Portsmouth,3-0,3,0,2,2,3,3,H
1963-08-30,1963,Scunthorpe United,Cardiff City,1-2,1,2,2,2,3,-1,A
1963-08-31,1963,Charlton Athletic,Middlesbrough,2-4,2,4,2,2,6,-2,A
1963-08-31,1963,Derby County,Huddersfield Town,2-0,2,0,2,2,2,2,H
1963-08-31,1963,Grimsby Town,Southampton,2-2,2,2,2,2,4,0,D
1963-08-31,1963,Leeds United,Bury,3-0,3,0,2,2,3,3,H
1963-08-31,1963,Norwich City,Leyton Orient,1-2,1,2,2,2,3,-1,A
1963-08-31,1963,Plymouth Argyle,Newcastle United,3-4,3,4,2,2,7,-1,A
1963-08-31,1963,Portsmouth,Swindon Town,1-4,1,4,2,2,5,-3,A
1963-08-31,1963,Preston North End,Swansea City,3-3,3,3,2,2,6,0,D
1963-08-31,1963,Rotherham United,Manchester City,1-2,1,2,2,2,3,-1,A
1963-08-31,1963,Sunderland,Northampton Town,0-2,0,2,2,2,2,-2,A
1963-09-03,1963,Bury,Norwich City,4-2,4,2,2,2,6,2,H
1963-09-03,1963,Charlton Athletic,Preston North End,3-0,3,0,2,2,3,3,H
1963-09-03,1963,Huddersfield Town,Southampton,4-0,4,0,2,2,4,4,H
1963-09-03,1963,Leyton Orient,Plymouth Argyle,1-0,1,0,2,2,1,1,H
1963-09-03,1963,Northampton Town,Scunthorpe United,2-0,2,0,2,2,2,2,H
1963-09-03,1963,Rotherham United,Leeds United,2-2,2,2,2,2,4,0,D
1963-09-03,1963,Swansea City,Derby County,2-1,2,1,2,2,3,1,H
1963-09-03,1963,Swindon Town,Grimsby Town,2-1,2,1,2,2,3,1,H
1963-09-04,1963,Manchester City,Cardiff City,4-0,4,0,2,2,4,4,H
1963-09-04,1963,Newcastle United,Middlesbrough,2-0,2,0,2,2,2,2,H
1963-09-04,1963,Portsmouth,Sunderland,2-4,2,4,2,2,6,-2,A
1963-09-07,1963,Bury,Sunderland,0-1,0,1,2,2,1,-1,A
1963-09-07,1963,Cardiff City,Portsmouth,1-2,1,2,2,2,3,-1,A
1963-09-07,1963,Huddersfield Town,Plymouth Argyle,4-3,4,3,2,2,7,1,H
1963-09-07,1963,Manchester City,Leeds United,3-2,3,2,2,2,5,1,H
1963-09-07,1963,Middlesbrough,Grimsby Town,6-0,6,0,2,2,6,6,H
1963-09-07,1963,Newcastle United,Charlton Athletic,5-0,5,0,2,2,5,5,H
1963-09-07,1963,Northampton Town,Derby County,0-1,0,1,2,2,1,-1,A
1963-09-07,1963,Norwich City,Scunthorpe United,2-1,2,1,2,2,3,1,H
1963-09-07,1963,Southampton,Preston North End,4-5,4,5,2,2,9,-1,A
1963-09-07,1963,Swansea City,Leyton Orient,1-0,1,0,2,2,1,1,H
1963-09-07,1963,Swindon Town,Rotherham United,3-1,3,1,2,2,4,2,H
1963-09-09,1963,Middlesbrough,Rotherham United,2-2,2,2,2,2,4,0,D
1963-09-09,1963,Preston North End,Plymouth Argyle,0-0,0,0,2,2,0,0,D
1963-09-09,1963,Scunthorpe United,Sunderland,1-1,1,1,2,2,2,0,D
1963-09-10,1963,Grimsby Town,Charlton Athletic,0-2,0,2,2,2,2,-2,A
1963-09-10,1963,Huddersfield Town,Swansea City,1-0,1,0,2,2,1,1,H
1963-09-10,1963,Swindon Town,Manchester City,3-0,3,0,2,2,3,3,H
1963-09-11,1963,Cardiff City,Bury,2-1,2,1,2,2,3,1,H
1963-09-11,1963,Derby County,Leyton Orient,1-0,1,0,2,2,1,1,H
1963-09-11,1963,Leeds United,Portsmouth,3-1,3,1,2,2,4,2,H
1963-09-11,1963,Newcastle United,Southampton,2-2,2,2,2,2,4,0,D
1963-09-11,1963,Norwich City,Northampton Town,3-3,3,3,2,2,6,0,D
1963-09-12,1963,Scunthorpe United,Swansea City,2-2,2,2,2,2,4,0,D
1963-09-13,1963,Northampton Town,Bury,1-2,1,2,2,2,3,-1,A
1963-09-13,1963,Rotherham United,Cardiff City,1-0,1,0,2,2,1,1,H
1963-09-14,1963,Charlton Athletic,Huddersfield Town,5-2,5,2,2,2,7,3,H
1963-09-14,1963,Grimsby Town,Newcastle United,2-1,2,1,2,2,3,1,H
1963-09-14,1963,Leeds United,Swindon Town,0-0,0,0,2,2,0,0,D
1963-09-14,1963,Leyton Orient,Southampton,1-0,1,0,2,2,1,1,H
1963-09-14,1963,Plymouth Argyle,Derby County,0-0,0,0,2,2,0,0,D
1963-09-14,1963,Portsmouth,Norwich City,1-1,1,1,2,2,2,0,D
1963-09-14,1963,Preston North End,Middlesbrough,2-2,2,2,2,2,4,0,D
1963-09-14,1963,Sunderland,Manchester City,2-0,2,0,2,2,2,2,H
1963-09-16,1963,Northampton Town,Norwich City,3-2,3,2,2,2,5,1,H
1963-09-17,1963,Bury,Cardiff City,4-1,4,1,2,2,5,3,H
1963-09-17,1963,Charlton Athletic,Grimsby Town,2-1,2,1,2,2,3,1,H
1963-09-17,1963,Rotherham United,Middlesbrough,2-1,2,1,2,2,3,1,H
1963-09-17,1963,Swansea City,Huddersfield Town,1-2,1,2,2,2,3,-1,A
1963-09-18,1963,Leyton Orient,Derby County,3-0,3,0,2,2,3,3,H
1963-09-18,1963,Manchester City,Swindon Town,0-0,0,0,2,2,0,0,D
1963-09-18,1963,Plymouth Argyle,Preston North End,0-2,0,2,2,2,2,-2,A
1963-09-18,1963,Portsmouth,Leeds United,1-1,1,1,2,2,2,0,D
1963-09-18,1963,Southampton,Newcastle United,2-0,2,0,2,2,2,2,H
1963-09-18,1963,Sunderland,Scunthorpe United,1-0,1,0,2,2,1,1,H
1963-09-21,1963,Bury,Plymouth Argyle,2-2,2,2,2,2,4,0,D
1963-09-21,1963,Cardiff City,Leeds United,0-0,0,0,2,2,0,0,D
1963-09-21,1963,Derby County,Charlton Athletic,1-1,1,1,2,2,2,0,D
1963-09-21,1963,Huddersfield Town,Grimsby Town,1-2,1,2,2,2,3,-1,A
1963-09-21,1963,Manchester City,Northampton Town,3-0,3,0,2,2,3,3,H
1963-09-21,1963,Middlesbrough,Leyton Orient,2-0,2,0,2,2,2,2,H
1963-09-21,1963,Newcastle United,Preston North End,2-4,2,4,2,2,6,-2,A
1963-09-21,1963,Norwich City,Rotherham United,2-2,2,2,2,2,4,0,D
1963-09-21,1963,Scunthorpe United,Portsmouth,1-1,1,1,2,2,2,0,D
1963-09-21,1963,Southampton,Swansea City,4-0,4,0,2,2,4,4,H
1963-09-21,1963,Swindon Town,Sunderland,1-0,1,0,2,2,1,1,H
1963-09-28,1963,Bury,Manchester City,1-1,1,1,2,2,2,0,D
1963-09-28,1963,Charlton Athletic,Plymouth Argyle,1-0,1,0,2,2,1,1,H
1963-09-28,1963,Grimsby Town,Derby County,1-3,1,3,2,2,4,-2,A
1963-09-28,1963,Leeds United,Norwich City,4-2,4,2,2,2,6,2,H
1963-09-28,1963,Leyton Orient,Newcastle United,1-0,1,0,2,2,1,1,H
1963-09-28,1963,Northampton Town,Swindon Town,4-0,4,0,2,2,4,4,H
1963-09-28,1963,Portsmouth,Southampton,2-0,2,0,2,2,2,2,H
1963-09-28,1963,Preston North End,Huddersfield Town,2-1,2,1,2,2,3,1,H
1963-09-28,1963,Rotherham United,Scunthorpe United,2-1,2,1,2,2,3,1,H
1963-09-28,1963,Sunderland,Cardiff City,3-3,3,3,2,2,6,0,D
1963-09-28,1963,Swansea City,Middlesbrough,2-1,2,1,2,2,3,1,H
1963-10-01,1963,Northampton Town,Leeds United,0-3,0,3,2,2,3,-3,A
1963-10-01,1963,Rotherham United,Southampton,2-3,2,3,2,2,5,-1,A
1963-10-01,1963,Scunthorpe United,Leyton Orient,0-0,0,0,2,2,0,0,D
1963-10-01,1963,Swindon Town,Charlton Athletic,2-2,2,2,2,2,4,0,D
1963-10-02,1963,Cardiff City,Grimsby Town,0-0,0,0,2,2,0,0,D
1963-10-02,1963,Newcastle United,Portsmouth,1-0,1,0,2,2,1,1,H
1963-10-02,1963,Norwich City,Preston North End,2-1,2,1,2,2,3,1,H
1963-10-02,1963,Plymouth Argyle,Sunderland,1-1,1,1,2,2,2,0,D
1963-10-05,1963,Cardiff City,Northampton Town,1-0,1,0,2,2,1,1,H
1963-10-05,1963,Derby County,Preston North End,1-2,1,2,2,2,3,-1,A
1963-10-05,1963,Huddersfield Town,Leyton Orient,2-1,2,1,2,2,3,1,H
1963-10-05,1963,Manchester City,Charlton Athletic,1-3,1,3,2,2,4,-2,A
1963-10-05,1963,Middlesbrough,Southampton,1-0,1,0,2,2,1,1,H
1963-10-05,1963,Newcastle United,Swansea City,4-1,4,1,2,2,5,3,H
1963-10-05,1963,Norwich City,Sunderland,2-3,2,3,2,2,5,-1,A
1963-10-05,1963,Plymouth Argyle,Grimsby Town,3-2,3,2,2,2,5,1,H
1963-10-05,1963,Portsmouth,Rotherham United,2-1,2,1,2,2,3,1,H
1963-10-05,1963,Scunthorpe United,Leeds United,0-1,0,1,2,2,1,-1,A
1963-10-05,1963,Swindon Town,Bury,2-1,2,1,2,2,3,1,H
1963-10-08,1963,Bury,Derby County,1-2,1,2,2,2,3,-1,A
1963-10-08,1963,Northampton Town,Huddersfield Town,1-0,1,0,2,2,1,1,H
1963-10-09,1963,Leeds United,Middlesbrough,2-0,2,0,2,2,2,2,H
1963-10-09,1963,Manchester City,Plymouth Argyle,1-1,1,1,2,2,2,0,D
1963-10-09,1963,Portsmouth,Swansea City,0-0,0,0,2,2,0,0,D
1963-10-09,1963,Sunderland,Newcastle United,2-1,2,1,2,2,3,1,H
1963-10-12,1963,Charlton Athletic,Bury,3-0,3,0,2,2,3,3,H
1963-10-12,1963,Grimsby Town,Manchester City,1-1,1,1,2,2,2,0,D
1963-10-12,1963,Huddersfield Town,Leeds United,0-2,0,2,2,2,2,-2,A
1963-10-12,1963,Middlesbrough,Portsmouth,3-1,3,1,2,2,4,2,H
1963-10-12,1963,Plymouth Argyle,Northampton Town,0-3,0,3,2,2,3,-3,A
1963-10-12,1963,Preston North End,Swindon Town,1-0,1,0,2,2,1,1,H
1963-10-15,1963,Swansea City,Norwich City,3-1,3,1,2,2,4,2,H
1963-10-16,1963,Derby County,Sunderland,0-3,0,3,2,2,3,-3,A
1963-10-19,1963,Bury,Grimsby Town,1-1,1,1,2,2,2,0,D
1963-10-19,1963,Cardiff City,Swansea City,1-1,1,1,2,2,2,0,D
1963-10-19,1963,Leeds United,Derby County,2-2,2,2,2,2,4,0,D
1963-10-19,1963,Manchester City,Preston North End,2-3,2,3,2,2,5,-1,A
1963-10-19,1963,Northampton Town,Charlton Athletic,1-2,1,2,2,2,3,-1,A
1963-10-19,1963,Norwich City,Southampton,1-1,1,1,2,2,2,0,D
1963-10-19,1963,Portsmouth,Newcastle United,5-2,5,2,2,2,7,3,H
1963-10-19,1963,Rotherham United,Huddersfield Town,3-1,3,1,2,2,4,2,H
1963-10-19,1963,Scunthorpe United,Middlesbrough,1-0,1,0,2,2,1,1,H
1963-10-19,1963,Sunderland,Plymouth Argyle,1-0,1,0,2,2,1,1,H
1963-10-19,1963,Swindon Town,Leyton Orient,5-0,5,0,2,2,5,5,H
1963-10-26,1963,Charlton Athletic,Cardiff City,5-2,5,2,2,2,7,3,H
1963-10-26,1963,Derby County,Manchester City,1-3,1,3,2,2,4,-2,A
1963-10-26,1963,Grimsby Town,Norwich City,3-1,3,1,2,2,4,2,H
1963-10-26,1963,Huddersfield Town,Bury,2-1,2,1,2,2,3,1,H
1963-10-26,1963,Leyton Orient,Portsmouth,3-6,3,6,2,2,9,-3,A
1963-10-26,1963,Middlesbrough,Sunderland,2-0,2,0,2,2,2,2,H
1963-10-26,1963,Newcastle United,Northampton Town,2-3,2,3,2,2,5,-1,A
1963-10-26,1963,Plymouth Argyle,Swindon Town,2-4,2,4,2,2,6,-2,A
1963-10-26,1963,Preston North End,Scunthorpe United,1-0,1,0,2,2,1,1,H
1963-10-26,1963,Southampton,Leeds United,1-4,1,4,2,2,5,-3,A
1963-10-26,1963,Swansea City,Rotherham United,4-2,4,2,2,2,6,2,H
1963-11-02,1963,Bury,Leyton Orient,1-2,1,2,2,2,3,-1,A
1963-11-02,1963,Cardiff City,Middlesbrough,1-1,1,1,2,2,2,0,D
1963-11-02,1963,Leeds United,Charlton Athletic,1-1,1,1,2,2,2,0,D
1963-11-02,1963,Manchester City,Swansea City,1-0,1,0,2,2,1,1,H
1963-11-02,1963,Northampton Town,Preston North End,0-3,0,3,2,2,3,-3,A
1963-11-02,1963,Norwich City,Newcastle United,3-1,3,1,2,2,4,2,H
1963-11-02,1963,Portsmouth,Derby County,1-1,1,1,2,2,2,0,D
1963-11-02,1963,Rotherham United,Plymouth Argyle,3-1,3,1,2,2,4,2,H
1963-11-02,1963,Scunthorpe United,Huddersfield Town,1-0,1,0,2,2,1,1,H
1963-11-02,1963,Sunderland,Grimsby Town,3-0,3,0,2,2,3,3,H
1963-11-02,1963,Swindon Town,Southampton,1-2,1,2,2,2,3,-1,A
1963-11-09,1963,Charlton Athletic,Rotherham United,4-3,4,3,2,2,7,1,H
1963-11-09,1963,Grimsby Town,Leeds United,0-2,0,2,2,2,2,-2,A
1963-11-09,1963,Huddersfield Town,Norwich City,1-1,1,1,2,2,2,0,D
1963-11-09,1963,Leyton Orient,Northampton Town,0-0,0,0,2,2,0,0,D
1963-11-09,1963,Middlesbrough,Swindon Town,1-1,1,1,2,2,2,0,D
1963-11-09,1963,Newcastle United,Cardiff City,0-4,0,4,2,2,4,-4,A
1963-11-09,1963,Plymouth Argyle,Portsmouth,0-4,0,4,2,2,4,-4,A
1963-11-09,1963,Preston North End,Sunderland,1-1,1,1,2,2,2,0,D
1963-11-09,1963,Southampton,Manchester City,4-2,4,2,2,2,6,2,H
1963-11-09,1963,Swansea City,Bury,0-2,0,2,2,2,2,-2,A
1963-11-16,1963,Cardiff City,Huddersfield Town,2-1,2,1,2,2,3,1,H
1963-11-16,1963,Leeds United,Preston North End,1-1,1,1,2,2,2,0,D
1963-11-16,1963,Northampton Town,Swansea City,2-3,2,3,2,2,5,-1,A
1963-11-16,1963,Norwich City,Derby County,3-0,3,0,2,2,3,3,H
1963-11-16,1963,Portsmouth,Charlton Athletic,4-1,4,1,2,2,5,3,H
1963-11-16,1963,Rotherham United,Grimsby Town,1-0,1,0,2,2,1,1,H
1963-11-16,1963,Scunthorpe United,Plymouth Argyle,1-0,1,0,2,2,1,1,H
1963-11-16,1963,Sunderland,Leyton Orient,4-1,4,1,2,2,5,3,H
1963-11-16,1963,Swindon Town,Newcastle United,0-0,0,0,2,2,0,0,D
1963-11-23,1963,Charlton Athletic,Scunthorpe United,0-1,0,1,2,2,1,-1,A
1963-11-23,1963,Derby County,Cardiff City,2-1,2,1,2,2,3,1,H
1963-11-23,1963,Grimsby Town,Portsmouth,0-3,0,3,2,2,3,-3,A
1963-11-23,1963,Huddersfield Town,Swindon Town,2-0,2,0,2,2,2,2,H
1963-11-23,1963,Leyton Orient,Leeds United,0-2,0,2,2,2,2,-2,A
1963-11-23,1963,Middlesbrough,Bury,2-0,2,0,2,2,2,2,H
1963-11-23,1963,Newcastle United,Manchester City,3-1,3,1,2,2,4,2,H
1963-11-23,1963,Plymouth Argyle,Norwich City,1-2,1,2,2,2,3,-1,A
1963-11-23,1963,Preston North End,Rotherham United,2-2,2,2,2,2,4,0,D
1963-11-23,1963,Southampton,Northampton Town,3-1,3,1,2,2,4,2,H
1963-11-23,1963,Swansea City,Sunderland,1-2,1,2,2,2,3,-1,A
1963-11-30,1963,Bury,Newcastle United,1-2,1,2,2,2,3,-1,A
1963-11-30,1963,Cardiff City,Plymouth Argyle,3-1,3,1,2,2,4,2,H
1963-11-30,1963,Leeds United,Swansea City,2-1,2,1,2,2,3,1,H
1963-11-30,1963,Manchester City,Huddersfield Town,5-2,5,2,2,2,7,3,H
1963-11-30,1963,Northampton Town,Middlesbrough,3-2,3,2,2,2,5,1,H
1963-11-30,1963,Norwich City,Charlton Athletic,1-3,1,3,2,2,4,-2,A
1963-11-30,1963,Portsmouth,Preston North End,1-2,1,2,2,2,3,-1,A
1963-11-30,1963,Rotherham United,Leyton Orient,2-4,2,4,2,2,6,-2,A
1963-11-30,1963,Scunthorpe United,Grimsby Town,2-2,2,2,2,2,4,0,D
1963-11-30,1963,Sunderland,Southampton,1-2,1,2,2,2,3,-1,A
1963-11-30,1963,Swindon Town,Derby County,0-0,0,0,2,2,0,0,D
1963-12-07,1963,Charlton Athletic,Sunderland,0-0,0,0,2,2,0,0,D
1963-12-07,1963,Derby County,Rotherham United,1-4,1,4,2,2,5,-3,A
1963-12-07,1963,Grimsby Town,Northampton Town,4-1,4,1,2,2,5,3,H
1963-12-07,1963,Huddersfield Town,Portsmouth,1-1,1,1,2,2,2,0,D
1963-12-07,1963,Leyton Orient,Manchester City,0-2,0,2,2,2,2,-2,A
1963-12-07,1963,Middlesbrough,Norwich City,0-1,0,1,2,2,1,-1,A
1963-12-07,1963,Newcastle United,Scunthorpe United,3-1,3,1,2,2,4,2,H
1963-12-07,1963,Plymouth Argyle,Leeds United,0-1,0,1,2,2,1,-1,A
1963-12-07,1963,Preston North End,Bury,3-0,3,0,2,2,3,3,H
1963-12-07,1963,Southampton,Cardiff City,3-2,3,2,2,2,5,1,H
1963-12-07,1963,Swansea City,Swindon Town,3-0,3,0,2,2,3,3,H
1963-12-13,1963,Grimsby Town,Swansea City,1-1,1,1,2,2,2,0,D
1963-12-14,1963,Charlton Athletic,Southampton,2-2,2,2,2,2,4,0,D
1963-12-14,1963,Derby County,Newcastle United,1-2,1,2,2,2,3,-1,A
1963-12-14,1963,Leeds United,Northampton Town,0-0,0,0,2,2,0,0,D
1963-12-14,1963,Norwich City,Cardiff City,5-1,5,1,2,2,6,4,H
1963-12-14,1963,Plymouth Argyle,Middlesbrough,2-0,2,0,2,2,2,2,H
1963-12-14,1963,Portsmouth,Manchester City,2-2,2,2,2,2,4,0,D
1963-12-14,1963,Preston North End,Leyton Orient,0-0,0,0,2,2,0,0,D
1963-12-14,1963,Rotherham United,Bury,6-2,6,2,2,2,8,4,H
1963-12-14,1963,Scunthorpe United,Swindon Town,3-0,3,0,2,2,3,3,H
1963-12-14,1963,Sunderland,Huddersfield Town,3-2,3,2,2,2,5,1,H
1963-12-20,1963,Swansea City,Preston North End,5-1,5,1,2,2,6,4,H
1963-12-21,1963,Bury,Leeds United,1-2,1,2,2,2,3,-1,A
1963-12-21,1963,Huddersfield Town,Derby County,0-0,0,0,2,2,0,0,D
1963-12-21,1963,Leyton Orient,Norwich City,1-1,1,1,2,2,2,0,D
1963-12-21,1963,Manchester City,Rotherham United,6-1,6,1,2,2,7,5,H
1963-12-21,1963,Middlesbrough,Charlton Athletic,2-3,2,3,2,2,5,-1,A
1963-12-21,1963,Newcastle United,Plymouth Argyle,1-1,1,1,2,2,2,0,D
1963-12-21,1963,Northampton Town,Sunderland,5-1,5,1,2,2,6,4,H
1963-12-21,1963,Southampton,Grimsby Town,6-0,6,0,2,2,6,6,H
1963-12-21,1963,Swindon Town,Portsmouth,2-0,2,0,2,2,2,2,H
1963-12-26,1963,Cardiff City,Preston North End,0-4,0,4,2,2,4,-4,A
1963-12-26,1963,Grimsby Town,Leyton Orient,1-1,1,1,2,2,2,0,D
1963-12-26,1963,Leeds United,Sunderland,1-1,1,1,2,2,2,0,D
1963-12-26,1963,Manchester City,Scunthorpe United,8-1,8,1,2,2,9,7,H
1963-12-26,1963,Middlesbrough,Derby County,3-0,3,0,2,2,3,3,H
1963-12-26,1963,Newcastle United,Huddersfield Town,2-0,2,0,2,2,2,2,H
1963-12-26,1963,Northampton Town,Rotherham United,1-3,1,3,2,2,4,-2,A
1963-12-26,1963,Norwich City,Swindon Town,3-2,3,2,2,2,5,1,H
1963-12-26,1963,Southampton,Plymouth Argyle,1-2,1,2,2,2,3,-1,A
1963-12-26,1963,Swansea City,Charlton Athletic,1-2,1,2,2,2,3,-1,A
1963-12-28,1963,Charlton Athletic,Swansea City,3-1,3,1,2,2,4,2,H
1963-12-28,1963,Derby County,Middlesbrough,2-2,2,2,2,2,4,0,D
1963-12-28,1963,Huddersfield Town,Newcastle United,3-0,3,0,2,2,3,3,H
1963-12-28,1963,Leyton Orient,Grimsby Town,0-0,0,0,2,2,0,0,D
1963-12-28,1963,Plymouth Argyle,Southampton,1-1,1,1,2,2,2,0,D
1963-12-28,1963,Portsmouth,Bury,3-3,3,3,2,2,6,0,D
1963-12-28,1963,Preston North End,Cardiff City,4-0,4,0,2,2,4,4,H
1963-12-28,1963,Rotherham United,Northampton Town,1-0,1,0,2,2,1,1,H
1963-12-28,1963,Scunthorpe United,Manchester City,2-4,2,4,2,2,6,-2,A
1963-12-28,1963,Sunderland,Leeds United,2-0,2,0,2,2,2,2,H
1963-12-28,1963,Swindon Town,Norwich City,2-2,2,2,2,2,4,0,D
1964-01-11,1963,Charlton Athletic,Newcastle United,1-2,1,2,2,2,3,-1,A
1964-01-11,1963,Derby County,Northampton Town,0-0,0,0,2,2,0,0,D
1964-01-11,1963,Grimsby Town,Middlesbrough,3-1,3,1,2,2,4,2,H
1964-01-11,1963,Leeds United,Manchester City,1-0,1,0,2,2,1,1,H
1964-01-11,1963,Leyton Orient,Swansea City,4-0,4,0,2,2,4,4,H
1964-01-11,1963,Plymouth Argyle,Huddersfield Town,0-0,0,0,2,2,0,0,D
1964-01-11,1963,Portsmouth,Cardiff City,5-0,5,0,2,2,5,5,H
1964-01-11,1963,Preston North End,Southampton,2-1,2,1,2,2,3,1,H
1964-01-11,1963,Rotherham United,Swindon Town,0-0,0,0,2,2,0,0,D
1964-01-11,1963,Scunthorpe United,Norwich City,2-2,2,2,2,2,4,0,D
1964-01-11,1963,Sunderland,Bury,4-1,4,1,2,2,5,3,H
1964-01-16,1963,Swansea City,Scunthorpe United,4-1,4,1,2,2,5,3,H
1964-01-17,1963,Cardiff City,Rotherham United,2-1,2,1,2,2,3,1,H
1964-01-18,1963,Bury,Northampton Town,1-1,1,1,2,2,2,0,D
1964-01-18,1963,Derby County,Plymouth Argyle,3-1,3,1,2,2,4,2,H
1964-01-18,1963,Manchester City,Sunderland,0-3,0,3,2,2,3,-3,A
1964-01-18,1963,Middlesbrough,Preston North End,3-0,3,0,2,2,3,3,H
1964-01-18,1963,Newcastle United,Grimsby Town,4-0,4,0,2,2,4,4,H
1964-01-18,1963,Norwich City,Portsmouth,3-1,3,1,2,2,4,2,H
1964-01-18,1963,Southampton,Leyton Orient,3-0,3,0,2,2,3,3,H
1964-01-18,1963,Swindon Town,Leeds United,2-2,2,2,2,2,4,0,D
1964-01-25,1963,Derby County,Scunthorpe United,2-2,2,2,2,2,4,0,D
1964-01-29,1963,Southampton,Scunthorpe United,7-2,7,2,2,2,9,5,H
1964-02-01,1963,Charlton Athletic,Derby County,2-0,2,0,2,2,2,2,H
1964-02-01,1963,Grimsby Town,Huddersfield Town,2-2,2,2,2,2,4,0,D
1964-02-01,1963,Leeds United,Cardiff City,1-1,1,1,2,2,2,0,D
1964-02-01,1963,Leyton Orient,Middlesbrough,3-2,3,2,2,2,5,1,H
1964-02-01,1963,Northampton Town,Manchester City,2-1,2,1,2,2,3,1,H
1964-02-01,1963,Plymouth Argyle,Bury,1-0,1,0,2,2,1,1,H
1964-02-01,1963,Portsmouth,Scunthorpe United,3-4,3,4,2,2,7,-1,A
1964-02-01,1963,Preston North End,Newcastle United,3-0,3,0,2,2,3,3,H
1964-02-01,1963,Rotherham United,Norwich City,4-0,4,0,2,2,4,4,H
1964-02-01,1963,Sunderland,Swindon Town,6-0,6,0,2,2,6,6,H
1964-02-08,1963,Cardiff City,Sunderland,0-2,0,2,2,2,2,-2,A
1964-02-08,1963,Derby County,Grimsby Town,0-0,0,0,2,2,0,0,D
1964-02-08,1963,Huddersfield Town,Preston North End,2-2,2,2,2,2,4,0,D
1964-02-08,1963,Manchester City,Bury,1-1,1,1,2,2,2,0,D
1964-02-08,1963,Middlesbrough,Swansea City,2-1,2,1,2,2,3,1,H
1964-02-08,1963,Newcastle United,Leyton Orient,3-0,3,0,2,2,3,3,H
1964-02-08,1963,Norwich City,Leeds United,2-2,2,2,2,2,4,0,D
1964-02-08,1963,Plymouth Argyle,Charlton Athletic,1-1,1,1,2,2,2,0,D
1964-02-08,1963,Scunthorpe United,Rotherham United,4-3,4,3,2,2,7,1,H
1964-02-08,1963,Southampton,Portsmouth,2-3,2,3,2,2,5,-1,A
1964-02-08,1963,Swindon Town,Northampton Town,2-3,2,3,2,2,5,-1,A
1964-02-15,1963,Charlton Athletic,Manchester City,4-3,4,3,2,2,7,1,H
1964-02-15,1963,Grimsby Town,Plymouth Argyle,1-1,1,1,2,2,2,0,D
1964-02-15,1963,Leeds United,Scunthorpe United,1-0,1,0,2,2,1,1,H
1964-02-15,1963,Northampton Town,Cardiff City,2-1,2,1,2,2,3,1,H
1964-02-15,1963,Rotherham United,Portsmouth,4-2,4,2,2,2,6,2,H
1964-02-15,1963,Southampton,Middlesbrough,2-2,2,2,2,2,4,0,D
1964-02-17,1963,Preston North End,Derby County,0-2,0,2,2,2,2,-2,A
1964-02-18,1963,Bury,Swindon Town,1-0,1,0,2,2,1,1,H
1964-02-18,1963,Northampton Town,Plymouth Argyle,0-0,0,0,2,2,0,0,D
1964-02-19,1963,Sunderland,Norwich City,0-0,0,0,2,2,0,0,D
1964-02-22,1963,Bury,Charlton Athletic,0-2,0,2,2,2,2,-2,A
1964-02-22,1963,Cardiff City,Leyton Orient,2-1,2,1,2,2,3,1,H
1964-02-22,1963,Leeds United,Huddersfield Town,1-1,1,1,2,2,2,0,D
1964-02-22,1963,Manchester City,Grimsby Town,0-4,0,4,2,2,4,-4,A
1964-02-22,1963,Norwich City,Swansea City,3-0,3,0,2,2,3,3,H
1964-02-22,1963,Portsmouth,Middlesbrough,1-0,1,0,2,2,1,1,H
1964-02-22,1963,Rotherham United,Newcastle United,2-3,2,3,2,2,5,-1,A
1964-02-22,1963,Scunthorpe United,Southampton,1-2,1,2,2,2,3,-1,A
1964-02-22,1963,Sunderland,Derby County,3-0,3,0,2,2,3,3,H
1964-02-22,1963,Swindon Town,Preston North End,1-4,1,4,2,2,5,-3,A
1964-02-24,1963,Leyton Orient,Huddersfield Town,2-3,2,3,2,2,5,-1,A
1964-02-29,1963,Charlton Athletic,Portsmouth,0-1,0,1,2,2,1,-1,A
1964-02-29,1963,Derby County,Norwich City,2-1,2,1,2,2,3,1,H
1964-02-29,1963,Grimsby Town,Rotherham United,1-3,1,3,2,2,4,-2,A
1964-02-29,1963,Huddersfield Town,Cardiff City,2-1,2,1,2,2,3,1,H
1964-02-29,1963,Middlesbrough,Manchester City,2-2,2,2,2,2,4,0,D
1964-02-29,1963,Newcastle United,Swindon Town,4-1,4,1,2,2,5,3,H
1964-02-29,1963,Plymouth Argyle,Scunthorpe United,3-1,3,1,2,2,4,2,H
1964-02-29,1963,Southampton,Bury,0-1,0,1,2,2,1,-1,A
1964-03-03,1963,Preston North End,Leeds United,2-0,2,0,2,2,2,2,H
1964-03-03,1963,Swansea City,Southampton,6-0,6,0,2,2,6,6,H
1964-03-07,1963,Bury,Huddersfield Town,0-2,0,2,2,2,2,-2,A
1964-03-07,1963,Cardiff City,Charlton Athletic,1-1,1,1,2,2,2,0,D
1964-03-07,1963,Leeds United,Southampton,3-1,3,1,2,2,4,2,H
1964-03-07,1963,Manchester City,Derby County,3-2,3,2,2,2,5,1,H
1964-03-07,1963,Northampton Town,Newcastle United,2-2,2,2,2,2,4,0,D
1964-03-07,1963,Norwich City,Grimsby Town,2-0,2,0,2,2,2,2,H
1964-03-07,1963,Portsmouth,Leyton Orient,4-3,4,3,2,2,7,1,H
1964-03-07,1963,Rotherham United,Swansea City,3-0,3,0,2,2,3,3,H
1964-03-07,1963,Scunthorpe United,Preston North End,1-0,1,0,2,2,1,1,H
1964-03-07,1963,Sunderland,Middlesbrough,0-0,0,0,2,2,0,0,D
1964-03-07,1963,Swindon Town,Plymouth Argyle,2-1,2,1,2,2,3,1,H
1964-03-14,1963,Charlton Athletic,Swindon Town,2-2,2,2,2,2,4,0,D
1964-03-14,1963,Derby County,Bury,2-1,2,1,2,2,3,1,H
1964-03-14,1963,Leyton Orient,Scunthorpe United,2-2,2,2,2,2,4,0,D
1964-03-14,1963,Middlesbrough,Leeds United,1-3,1,3,2,2,4,-2,A
1964-03-14,1963,Newcastle United,Sunderland,1-0,1,0,2,2,1,1,H
1964-03-14,1963,Plymouth Argyle,Manchester City,2-1,2,1,2,2,3,1,H
1964-03-17,1963,Manchester City,Middlesbrough,1-0,1,0,2,2,1,1,H
1964-03-17,1963,Preston North End,Norwich City,3-0,3,0,2,2,3,3,H
1964-03-17,1963,Swansea City,Newcastle United,0-1,0,1,2,2,1,-1,A
1964-03-20,1963,Cardiff City,Newcastle United,2-2,2,2,2,2,4,0,D
1964-03-20,1963,Rotherham United,Charlton Athletic,5-0,5,0,2,2,5,5,H
1964-03-20,1963,Scunthorpe United,Derby County,3-2,3,2,2,2,5,1,H
1964-03-21,1963,Bury,Swansea City,3-2,3,2,2,2,5,1,H
1964-03-21,1963,Leeds United,Grimsby Town,3-1,3,1,2,2,4,2,H
1964-03-21,1963,Manchester City,Southampton,1-1,1,1,2,2,2,0,D
1964-03-21,1963,Northampton Town,Leyton Orient,1-2,1,2,2,2,3,-1,A
1964-03-21,1963,Norwich City,Huddersfield Town,2-2,2,2,2,2,4,0,D
1964-03-21,1963,Portsmouth,Plymouth Argyle,1-2,1,2,2,2,3,-1,A
1964-03-21,1963,Sunderland,Preston North End,4-0,4,0,2,2,4,4,H
1964-03-21,1963,Swindon Town,Middlesbrough,2-0,2,0,2,2,2,2,H
1964-03-26,1963,Leyton Orient,Charlton Athletic,0-3,0,3,2,2,3,-3,A
1964-03-26,1963,Scunthorpe United,Bury,0-0,0,0,2,2,0,0,D
1964-03-27,1963,Grimsby Town,Preston North End,0-3,0,3,2,2,3,-3,A
1964-03-27,1963,Manchester City,Norwich City,5-0,5,0,2,2,5,5,H
1964-03-27,1963,Newcastle United,Leeds United,0-1,0,1,2,2,1,-1,A
1964-03-27,1963,Sunderland,Rotherham United,2-0,2,0,2,2,2,2,H
1964-03-27,1963,Swindon Town,Cardiff City,1-2,1,2,2,2,3,-1,A
1964-03-28,1963,Charlton Athletic,Northampton Town,1-1,1,1,2,2,2,0,D
1964-03-28,1963,Derby County,Leeds United,1-1,1,1,2,2,2,0,D
1964-03-28,1963,Grimsby Town,Bury,1-0,1,0,2,2,1,1,H
1964-03-28,1963,Huddersfield Town,Rotherham United,0-3,0,3,2,2,3,-3,A
1964-03-28,1963,Leyton Orient,Swindon Town,2-1,2,1,2,2,3,1,H
1964-03-28,1963,Middlesbrough,Scunthorpe United,2-0,2,0,2,2,2,2,H
1964-03-28,1963,Preston North End,Manchester City,2-0,2,0,2,2,2,2,H
1964-03-28,1963,Southampton,Norwich City,3-0,3,0,2,2,3,3,H
1964-03-28,1963,Swansea City,Cardiff City,3-0,3,0,2,2,3,3,H
1964-03-30,1963,Cardiff City,Swindon Town,1-0,1,0,2,2,1,1,H
1964-03-30,1963,Charlton Athletic,Leyton Orient,1-2,1,2,2,2,3,-1,A
1964-03-30,1963,Derby County,Southampton,3-2,3,2,2,2,5,1,H
1964-03-30,1963,Leeds United,Newcastle United,2-1,2,1,2,2,3,1,H
1964-03-30,1963,Middlesbrough,Huddersfield Town,1-1,1,1,2,2,2,0,D
1964-03-30,1963,Norwich City,Manchester City,1-2,1,2,2,2,3,-1,A
1964-03-30,1963,Plymouth Argyle,Swansea City,3-2,3,2,2,2,5,1,H
1964-03-30,1963,Portsmouth,Northampton Town,3-0,3,0,2,2,3,3,H
1964-03-30,1963,Preston North End,Grimsby Town,1-0,1,0,2,2,1,1,H
1964-03-30,1963,Rotherham United,Sunderland,2-2,2,2,2,2,4,0,D
1964-03-31,1963,Bury,Scunthorpe United,3-2,3,2,2,2,5,1,H
1964-03-31,1963,Huddersfield Town,Middlesbrough,1-0,1,0,2,2,1,1,H
1964-03-31,1963,Northampton Town,Portsmouth,2-1,2,1,2,2,3,1,H
1964-03-31,1963,Swansea City,Plymouth Argyle,2-1,2,1,2,2,3,1,H
1964-04-01,1963,Southampton,Derby County,6-4,6,4,2,2,10,2,H
1964-04-04,1963,Bury,Middlesbrough,1-1,1,1,2,2,2,0,D
1964-04-04,1963,Cardiff City,Derby County,2-1,2,1,2,2,3,1,H
1964-04-04,1963,Leeds United,Leyton Orient,2-1,2,1,2,2,3,1,H
1964-04-04,1963,Manchester City,Newcastle United,3-1,3,1,2,2,4,2,H
1964-04-04,1963,Northampton Town,Southampton,2-0,2,0,2,2,2,2,H
1964-04-04,1963,Norwich City,Plymouth Argyle,1-1,1,1,2,2,2,0,D
1964-04-04,1963,Portsmouth,Grimsby Town,2-2,2,2,2,2,4,0,D
1964-04-04,1963,Rotherham United,Preston North End,4-2,4,2,2,2,6,2,H
1964-04-04,1963,Scunthorpe United,Charlton Athletic,1-1,1,1,2,2,2,0,D
1964-04-04,1963,Sunderland,Swansea City,1-0,1,0,2,2,1,1,H
1964-04-04,1963,Swindon Town,Huddersfield Town,1-2,1,2,2,2,3,-1,A
1964-04-06,1963,Leyton Orient,Sunderland,2-5,2,5,2,2,7,-3,A
1964-04-07,1963,Huddersfield Town,Charlton Athletic,2-1,2,1,2,2,3,1,H
1964-04-07,1963,Swansea City,Northampton Town,1-1,1,1,2,2,2,0,D
1964-04-08,1963,Cardiff City,Scunthorpe United,3-1,3,1,2,2,4,2,H
1964-04-08,1963,Newcastle United,Rotherham United,5-2,5,2,2,2,7,3,H
1964-04-10,1963,Middlesbrough,Northampton Town,1-0,1,0,2,2,1,1,H
1964-04-11,1963,Charlton Athletic,Norwich City,3-1,3,1,2,2,4,2,H
1964-04-11,1963,Derby County,Swindon Town,3-0,3,0,2,2,3,3,H
1964-04-11,1963,Grimsby Town,Scunthorpe United,2-0,2,0,2,2,2,2,H
1964-04-11,1963,Huddersfield Town,Manchester City,0-2,0,2,2,2,2,-2,A
1964-04-11,1963,Leyton Orient,Rotherham United,0-2,0,2,2,2,2,-2,A
1964-04-11,1963,Newcastle United,Bury,0-4,0,4,2,2,4,-4,A
1964-04-11,1963,Plymouth Argyle,Cardiff City,1-1,1,1,2,2,2,0,D
1964-04-11,1963,Preston North End,Portsmouth,0-0,0,0,2,2,0,0,D
1964-04-11,1963,Southampton,Sunderland,0-0,0,0,2,2,0,0,D
1964-04-11,1963,Swansea City,Leeds United,0-3,0,3,2,2,3,-3,A
1964-04-13,1963,Bury,Portsmouth,3-2,3,2,2,2,5,1,H
1964-04-13,1963,Huddersfield Town,Northampton Town,0-1,0,1,2,2,1,-1,A
1964-04-13,1963,Leyton Orient,Cardiff City,4-0,4,0,2,2,4,4,H
1964-04-15,1963,Grimsby Town,Cardiff City,0-2,0,2,2,2,2,-2,A
1964-04-18,1963,Bury,Preston North End,2-1,2,1,2,2,3,1,H
1964-04-18,1963,Cardiff City,Southampton,2-4,2,4,2,2,6,-2,A
1964-04-18,1963,Leeds United,Plymouth Argyle,1-1,1,1,2,2,2,0,D
1964-04-18,1963,Manchester City,Leyton Orient,2-0,2,0,2,2,2,2,H
1964-04-18,1963,Northampton Town,Grimsby Town,1-2,1,2,2,2,3,-1,A
1964-04-18,1963,Norwich City,Middlesbrough,1-1,1,1,2,2,2,0,D
1964-04-18,1963,Portsmouth,Huddersfield Town,2-1,2,1,2,2,3,1,H
1964-04-18,1963,Rotherham United,Derby County,2-0,2,0,2,2,2,2,H
1964-04-18,1963,Scunthorpe United,Newcastle United,2-0,2,0,2,2,2,2,H
1964-04-18,1963,Sunderland,Charlton Athletic,2-1,2,1,2,2,3,1,H
1964-04-18,1963,Swindon Town,Swansea City,2-1,2,1,2,2,3,1,H
1964-04-21,1963,Bury,Southampton,1-5,1,5,2,2,6,-4,A
1964-04-21,1963,Swansea City,Portsmouth,1-1,1,1,2,2,2,0,D
1964-04-24,1963,Middlesbrough,Cardiff City,3-1,3,1,2,2,4,2,H
1964-04-25,1963,Charlton Athletic,Leeds United,0-2,0,2,2,2,2,-2,A
1964-04-25,1963,Derby County,Portsmouth,3-1,3,1,2,2,4,2,H
1964-04-25,1963,Grimsby Town,Sunderland,2-2,2,2,2,2,4,0,D
1964-04-25,1963,Huddersfield Town,Scunthorpe United,3-2,3,2,2,2,5,1,H
1964-04-25,1963,Leyton Orient,Bury,1-1,1,1,2,2,2,0,D
1964-04-25,1963,Newcastle United,Norwich City,2-0,2,0,2,2,2,2,H
1964-04-25,1963,Plymouth Argyle,Rotherham United,0-0,0,0,2,2,0,0,D
1964-04-25,1963,Preston North End,Northampton Town,2-1,2,1,2,2,3,1,H
1964-04-25,1963,Southampton,Swindon Town,5-1,5,1,2,2,6,4,H
1964-04-25,1963,Swansea City,Manchester City,3-3,3,3,2,2,6,0,D
1964-04-27,1963,Southampton,Rotherham United,6-1,6,1,2,2,7,5,H
1964-08-22,1964,Bury,Swindon Town,6-1,6,1,2,2,7,5,H
1964-08-22,1964,Cardiff City,Ipswich Town,0-0,0,0,2,2,0,0,D
1964-08-22,1964,Charlton Athletic,Manchester City,2-1,2,1,2,2,3,1,H
1964-08-22,1964,Coventry City,Plymouth Argyle,2-0,2,0,2,2,2,2,H
1964-08-22,1964,Crystal Palace,Derby County,2-3,2,3,2,2,5,-1,A
1964-08-22,1964,Huddersfield Town,Bolton Wanderers,1-1,1,1,2,2,2,0,D
1964-08-22,1964,Leyton Orient,Portsmouth,5-2,5,2,2,2,7,3,H
1964-08-22,1964,Norwich City,Swansea City,2-1,2,1,2,2,3,1,H
1964-08-22,1964,Preston North End,Rotherham United,0-0,0,0,2,2,0,0,D
1964-08-22,1964,Southampton,Middlesbrough,0-3,0,3,2,2,3,-3,A
1964-08-24,1964,Middlesbrough,Northampton Town,1-0,1,0,2,2,1,1,H
1964-08-24,1964,Newcastle United,Charlton Athletic,1-1,1,1,2,2,2,0,D
1964-08-25,1964,Ipswich Town,Coventry City,1-3,1,3,2,2,4,-2,A
1964-08-25,1964,Rotherham United,Swansea City,4-2,4,2,2,2,6,2,H
1964-08-25,1964,Swindon Town,Crystal Palace,2-0,2,0,2,2,2,2,H
1964-08-26,1964,Cardiff City,Preston North End,3-3,3,3,2,2,6,0,D
1964-08-26,1964,Derby County,Norwich City,0-1,0,1,2,2,1,-1,A
1964-08-26,1964,Manchester City,Leyton Orient,6-0,6,0,2,2,6,6,H
1964-08-26,1964,Plymouth Argyle,Huddersfield Town,0-0,0,0,2,2,0,0,D
1964-08-26,1964,Portsmouth,Bury,2-1,2,1,2,2,3,1,H
1964-08-26,1964,Southampton,Bolton Wanderers,3-2,3,2,2,2,5,1,H
1964-08-29,1964,Bolton Wanderers,Coventry City,1-3,1,3,2,2,4,-2,A
1964-08-29,1964,Derby County,Bury,3-1,3,1,2,2,4,2,H
1964-08-29,1964,Ipswich Town,Preston North End,1-5,1,5,2,2,6,-4,A
1964-08-29,1964,Manchester City,Northampton Town,0-2,0,2,2,2,2,-2,A
1964-08-29,1964,Middlesbrough,Huddersfield Town,0-0,0,0,2,2,0,0,D
1964-08-29,1964,Newcastle United,Southampton,2-1,2,1,2,2,3,1,H
1964-08-29,1964,Plymouth Argyle,Cardiff City,3-1,3,1,2,2,4,2,H
1964-08-29,1964,Portsmouth,Charlton Athletic,2-3,2,3,2,2,5,-1,A
1964-08-29,1964,Rotherham United,Norwich City,4-0,4,0,2,2,4,4,H
1964-08-29,1964,Swansea City,Crystal Palace,2-1,2,1,2,2,3,1,H
1964-08-29,1964,Swindon Town,Leyton Orient,1-0,1,0,2,2,1,1,H
1964-08-31,1964,Leyton Orient,Manchester City,4-3,4,3,2,2,7,1,H
1964-08-31,1964,Preston North End,Cardiff City,1-1,1,1,2,2,2,0,D
1964-09-01,1964,Bury,Portsmouth,1-1,1,1,2,2,2,0,D
1964-09-01,1964,Charlton Athletic,Newcastle United,0-1,0,1,2,2,1,-1,A
1964-09-01,1964,Coventry City,Ipswich Town,5-3,5,3,2,2,8,2,H
1964-09-01,1964,Northampton Town,Middlesbrough,1-1,1,1,2,2,2,0,D
1964-09-01,1964,Swansea City,Rotherham United,0-3,0,3,2,2,3,-3,A
1964-09-02,1964,Bolton Wanderers,Southampton,3-0,3,0,2,2,3,3,H
1964-09-02,1964,Crystal Palace,Swindon Town,3-1,3,1,2,2,4,2,H
1964-09-02,1964,Huddersfield Town,Plymouth Argyle,1-2,1,2,2,2,3,-1,A
1964-09-02,1964,Norwich City,Derby County,5-2,5,2,2,2,7,3,H
1964-09-04,1964,Bury,Swansea City,2-2,2,2,2,2,4,0,D
1964-09-05,1964,Cardiff City,Bolton Wanderers,1-3,1,3,2,2,4,-2,A
1964-09-05,1964,Charlton Athletic,Swindon Town,3-2,3,2,2,2,5,1,H
1964-09-05,1964,Coventry City,Middlesbrough,3-0,3,0,2,2,3,3,H
1964-09-05,1964,Crystal Palace,Rotherham United,2-1,2,1,2,2,3,1,H
1964-09-05,1964,Huddersfield Town,Newcastle United,0-1,0,1,2,2,1,-1,A
1964-09-05,1964,Leyton Orient,Derby County,1-4,1,4,2,2,5,-3,A
1964-09-05,1964,Manchester City,Portsmouth,2-0,2,0,2,2,2,2,H
1964-09-05,1964,Norwich City,Ipswich Town,2-1,2,1,2,2,3,1,H
1964-09-05,1964,Preston North End,Plymouth Argyle,1-3,1,3,2,2,4,-2,A
1964-09-05,1964,Southampton,Northampton Town,2-0,2,0,2,2,2,2,H
1964-09-07,1964,Middlesbrough,Bolton Wanderers,5-2,5,2,2,2,7,3,H
1964-09-08,1964,Bury,Leyton Orient,2-1,2,1,2,2,3,1,H
1964-09-08,1964,Northampton Town,Newcastle United,1-0,1,0,2,2,1,1,H
1964-09-08,1964,Swindon Town,Swansea City,3-0,3,0,2,2,3,3,H
1964-09-09,1964,Derby County,Coventry City,2-1,2,1,2,2,3,1,H
1964-09-09,1964,Manchester City,Norwich City,0-2,0,2,2,2,2,-2,A
1964-09-11,1964,Northampton Town,Huddersfield Town,3-2,3,2,2,2,5,1,H
1964-09-12,1964,Bolton Wanderers,Preston North End,5-1,5,1,2,2,6,4,H
1964-09-12,1964,Derby County,Charlton Athletic,4-4,4,4,2,2,8,0,D
1964-09-12,1964,Middlesbrough,Cardiff City,0-0,0,0,2,2,0,0,D
1964-09-12,1964,Newcastle United,Coventry City,2-0,2,0,2,2,2,2,H
1964-09-12,1964,Norwich City,Crystal Palace,1-2,1,2,2,2,3,-1,A
1964-09-12,1964,Plymouth Argyle,Ipswich Town,1-1,1,1,2,2,2,0,D
1964-09-12,1964,Portsmouth,Southampton,0-3,0,3,2,2,3,-3,A
1964-09-12,1964,Rotherham United,Bury,3-0,3,0,2,2,3,3,H
1964-09-12,1964,Swansea City,Leyton Orient,2-5,2,5,2,2,7,-3,A
1964-09-12,1964,Swindon Town,Manchester City,0-1,0,1,2,2,1,-1,A
1964-09-14,1964,Leyton Orient,Bury,1-0,1,0,2,2,1,1,H
1964-09-15,1964,Charlton Athletic,Crystal Palace,1-2,1,2,2,2,3,-1,A
1964-09-15,1964,Coventry City,Derby County,0-2,0,2,2,2,2,-2,A
1964-09-15,1964,Ipswich Town,Northampton Town,0-0,0,0,2,2,0,0,D
1964-09-15,1964,Rotherham United,Portsmouth,1-0,1,0,2,2,1,1,H
1964-09-15,1964,Swansea City,Swindon Town,4-0,4,0,2,2,4,4,H
1964-09-16,1964,Bolton Wanderers,Middlesbrough,4-2,4,2,2,2,6,2,H
1964-09-16,1964,Cardiff City,Huddersfield Town,1-1,1,1,2,2,2,0,D
1964-09-16,1964,Newcastle United,Plymouth Argyle,2-1,2,1,2,2,3,1,H
1964-09-16,1964,Norwich City,Manchester City,4-1,4,1,2,2,5,3,H
1964-09-16,1964,Southampton,Preston North End,3-1,3,1,2,2,4,2,H
1964-09-19,1964,Bury,Norwich City,1-0,1,0,2,2,1,1,H
1964-09-19,1964,Cardiff City,Newcastle United,1-1,1,1,2,2,2,0,D
1964-09-19,1964,Charlton Athletic,Swansea City,1-0,1,0,2,2,1,1,H
1964-09-19,1964,Coventry City,Northampton Town,0-1,0,1,2,2,1,-1,A
1964-09-19,1964,Crystal Palace,Plymouth Argyle,2-1,2,1,2,2,3,1,H
1964-09-19,1964,Huddersfield Town,Southampton,0-3,0,3,2,2,3,-3,A
1964-09-19,1964,Ipswich Town,Bolton Wanderers,1-4,1,4,2,2,5,-3,A
1964-09-19,1964,Leyton Orient,Rotherham United,2-1,2,1,2,2,3,1,H
1964-09-19,1964,Manchester City,Derby County,2-0,2,0,2,2,2,2,H
1964-09-19,1964,Portsmouth,Swindon Town,5-0,5,0,2,2,5,5,H
1964-09-19,1964,Preston North End,Middlesbrough,4-3,4,3,2,2,7,1,H
1964-09-26,1964,Bolton Wanderers,Plymouth Argyle,6-1,6,1,2,2,7,5,H
1964-09-26,1964,Crystal Palace,Bury,0-2,0,2,2,2,2,-2,A
1964-09-26,1964,Derby County,Portsmouth,4-0,4,0,2,2,4,4,H
1964-09-26,1964,Middlesbrough,Ipswich Town,2-4,2,4,2,2,6,-2,A
1964-09-26,1964,Newcastle United,Preston North End,5-2,5,2,2,2,7,3,H
1964-09-26,1964,Northampton Town,Cardiff City,1-0,1,0,2,2,1,1,H
1964-09-26,1964,Norwich City,Leyton Orient,2-0,2,0,2,2,2,2,H
1964-09-26,1964,Rotherham United,Charlton Athletic,3-2,3,2,2,2,5,1,H
1964-09-26,1964,Southampton,Coventry City,4-1,4,1,2,2,5,3,H
1964-09-26,1964,Swansea City,Manchester City,3-0,3,0,2,2,3,3,H
1964-09-26,1964,Swindon Town,Huddersfield Town,4-1,4,1,2,2,5,3,H
1964-09-28,1964,Leyton Orient,Bolton Wanderers,3-1,3,1,2,2,4,2,H
1964-09-29,1964,Huddersfield Town,Cardiff City,3-1,3,1,2,2,4,2,H
1964-09-29,1964,Northampton Town,Ipswich Town,3-2,3,2,2,2,5,1,H
1964-09-29,1964,Swansea City,Coventry City,1-1,1,1,2,2,2,0,D
1964-09-30,1964,Crystal Palace,Charlton Athletic,3-1,3,1,2,2,4,2,H
1964-09-30,1964,Plymouth Argyle,Newcastle United,2-1,2,1,2,2,3,1,H
1964-09-30,1964,Portsmouth,Rotherham United,2-0,2,0,2,2,2,2,H
1964-10-02,1964,Bury,Bolton Wanderers,2-1,2,1,2,2,3,1,H
1964-10-03,1964,Charlton Athletic,Norwich City,2-1,2,1,2,2,3,1,H
1964-10-03,1964,Coventry City,Huddersfield Town,2-3,2,3,2,2,5,-1,A
1964-10-03,1964,Ipswich Town,Newcastle United,3-1,3,1,2,2,4,2,H
1964-10-03,1964,Leyton Orient,Crystal Palace,0-1,0,1,2,2,1,-1,A
1964-10-03,1964,Manchester City,Rotherham United,2-1,2,1,2,2,3,1,H
1964-10-03,1964,Plymouth Argyle,Middlesbrough,1-0,1,0,2,2,1,1,H
1964-10-03,1964,Portsmouth,Swansea City,1-0,1,0,2,2,1,1,H
1964-10-03,1964,Preston North End,Northampton Town,2-2,2,2,2,2,4,0,D
1964-10-03,1964,Swindon Town,Derby County,4-2,4,2,2,2,6,2,H
1964-10-06,1964,Bury,Plymouth Argyle,0-2,0,2,2,2,2,-2,A
1964-10-06,1964,Charlton Athletic,Middlesbrough,0-2,0,2,2,2,2,-2,A
1964-10-06,1964,Rotherham United,Cardiff City,3-1,3,1,2,2,4,2,H
1964-10-07,1964,Crystal Palace,Ipswich Town,1-1,1,1,2,2,2,0,D
1964-10-07,1964,Derby County,Huddersfield Town,2-0,2,0,2,2,2,2,H
1964-10-07,1964,Norwich City,Preston North End,4-2,4,2,2,2,6,2,H
1964-10-07,1964,Portsmouth,Northampton Town,3-3,3,3,2,2,6,0,D
1964-10-10,1964,Bolton Wanderers,Crystal Palace,3-0,3,0,2,2,3,3,H
1964-10-10,1964,Cardiff City,Derby County,2-1,2,1,2,2,3,1,H
1964-10-10,1964,Coventry City,Swindon Town,3-2,3,2,2,2,5,1,H
1964-10-10,1964,Huddersfield Town,Portsmouth,2-1,2,1,2,2,3,1,H
1964-10-10,1964,Ipswich Town,Rotherham United,4-4,4,4,2,2,8,0,D
1964-10-10,1964,Middlesbrough,Bury,3-3,3,3,2,2,6,0,D
1964-10-10,1964,Newcastle United,Leyton Orient,5-0,5,0,2,2,5,5,H
1964-10-10,1964,Northampton Town,Charlton Athletic,1-0,1,0,2,2,1,1,H
1964-10-10,1964,Plymouth Argyle,Norwich City,1-0,1,0,2,2,1,1,H
1964-10-10,1964,Preston North End,Swansea City,2-2,2,2,2,2,4,0,D
1964-10-10,1964,Southampton,Manchester City,1-0,1,0,2,2,1,1,H
1964-10-13,1964,Swindon Town,Southampton,2-1,2,1,2,2,3,1,H
1964-10-14,1964,Manchester City,Newcastle United,3-0,3,0,2,2,3,3,H
1964-10-17,1964,Bury,Newcastle United,1-2,1,2,2,2,3,-1,A
1964-10-17,1964,Charlton Athletic,Southampton,2-5,2,5,2,2,7,-3,A
1964-10-17,1964,Crystal Palace,Middlesbrough,3-1,3,1,2,2,4,2,H
1964-10-17,1964,Derby County,Preston North End,3-1,3,1,2,2,4,2,H
1964-10-17,1964,Leyton Orient,Northampton Town,2-2,2,2,2,2,4,0,D
1964-10-17,1964,Manchester City,Huddersfield Town,2-3,2,3,2,2,5,-1,A
1964-10-17,1964,Norwich City,Bolton Wanderers,3-2,3,2,2,2,5,1,H
1964-10-17,1964,Portsmouth,Coventry City,0-2,0,2,2,2,2,-2,A
1964-10-17,1964,Rotherham United,Plymouth Argyle,4-2,4,2,2,2,6,2,H
1964-10-17,1964,Swansea City,Ipswich Town,1-1,1,1,2,2,2,0,D
1964-10-17,1964,Swindon Town,Cardiff City,3-3,3,3,2,2,6,0,D
1964-10-24,1964,Bolton Wanderers,Rotherham United,2-0,2,0,2,2,2,2,H
1964-10-24,1964,Cardiff City,Portsmouth,1-0,1,0,2,2,1,1,H
1964-10-24,1964,Coventry City,Manchester City,2-2,2,2,2,2,4,0,D
1964-10-24,1964,Huddersfield Town,Charlton Athletic,0-1,0,1,2,2,1,-1,A
1964-10-24,1964,Ipswich Town,Derby County,2-1,2,1,2,2,3,1,H
1964-10-24,1964,Middlesbrough,Norwich City,2-0,2,0,2,2,2,2,H
1964-10-24,1964,Newcastle United,Crystal Palace,2-0,2,0,2,2,2,2,H
1964-10-24,1964,Northampton Town,Bury,2-0,2,0,2,2,2,2,H
1964-10-24,1964,Plymouth Argyle,Swansea City,2-1,2,1,2,2,3,1,H
1964-10-24,1964,Preston North End,Swindon Town,2-1,2,1,2,2,3,1,H
1964-10-24,1964,Southampton,Leyton Orient,2-2,2,2,2,2,4,0,D
1964-10-30,1964,Bury,Southampton,3-3,3,3,2,2,6,0,D
1964-10-31,1964,Charlton Athletic,Coventry City,3-0,3,0,2,2,3,3,H
1964-10-31,1964,Crystal Palace,Northampton Town,1-2,1,2,2,2,3,-1,A
1964-10-31,1964,Derby County,Plymouth Argyle,3-2,3,2,2,2,5,1,H
1964-10-31,1964,Leyton Orient,Huddersfield Town,1-0,1,0,2,2,1,1,H
1964-10-31,1964,Manchester City,Cardiff City,2-0,2,0,2,2,2,2,H
1964-10-31,1964,Norwich City,Newcastle United,1-1,1,1,2,2,2,0,D
1964-10-31,1964,Portsmouth,Preston North End,1-0,1,0,2,2,1,1,H
1964-10-31,1964,Rotherham United,Middlesbrough,2-3,2,3,2,2,5,-1,A
1964-10-31,1964,Swansea City,Bolton Wanderers,2-0,2,0,2,2,2,2,H
1964-10-31,1964,Swindon Town,Ipswich Town,3-1,3,1,2,2,4,2,H
1964-11-02,1964,Preston North End,Southampton,0-0,0,0,2,2,0,0,D
1964-11-07,1964,Bolton Wanderers,Derby County,3-1,3,1,2,2,4,2,H
1964-11-07,1964,Cardiff City,Charlton Athletic,2-1,2,1,2,2,3,1,H
1964-11-07,1964,Coventry City,Leyton Orient,1-1,1,1,2,2,2,0,D
1964-11-07,1964,Huddersfield Town,Bury,0-2,0,2,2,2,2,-2,A
1964-11-07,1964,Ipswich Town,Portsmouth,7-0,7,0,2,2,7,7,H
1964-11-07,1964,Middlesbrough,Swansea City,4-0,4,0,2,2,4,4,H
1964-11-07,1964,Newcastle United,Rotherham United,3-1,3,1,2,2,4,2,H
1964-11-07,1964,Northampton Town,Norwich City,0-0,0,0,2,2,0,0,D
1964-11-07,1964,Plymouth Argyle,Swindon Town,2-1,2,1,2,2,3,1,H
1964-11-07,1964,Preston North End,Manchester City,2-5,2,5,2,2,7,-3,A
1964-11-07,1964,Southampton,Crystal Palace,0-1,0,1,2,2,1,-1,A
1964-11-13,1964,Bury,Coventry City,5-0,5,0,2,2,5,5,H
1964-11-14,1964,Charlton Athletic,Preston North End,2-3,2,3,2,2,5,-1,A
1964-11-14,1964,Crystal Palace,Huddersfield Town,3-0,3,0,2,2,3,3,H
1964-11-14,1964,Derby County,Middlesbrough,3-3,3,3,2,2,6,0,D
1964-11-14,1964,Leyton Orient,Cardiff City,1-3,1,3,2,2,4,-2,A
1964-11-14,1964,Manchester City,Ipswich Town,4-0,4,0,2,2,4,4,H
1964-11-14,1964,Norwich City,Southampton,2-2,2,2,2,2,4,0,D
1964-11-14,1964,Portsmouth,Plymouth Argyle,0-1,0,1,2,2,1,-1,A
1964-11-14,1964,Rotherham United,Northampton Town,1-1,1,1,2,2,2,0,D
1964-11-14,1964,Swansea City,Newcastle United,3-1,3,1,2,2,4,2,H
1964-11-14,1964,Swindon Town,Bolton Wanderers,1-3,1,3,2,2,4,-2,A
1964-11-21,1964,Bolton Wanderers,Portsmouth,3-2,3,2,2,2,5,1,H
1964-11-21,1964,Cardiff City,Bury,4-0,4,0,2,2,4,4,H
1964-11-21,1964,Coventry City,Crystal Palace,0-0,0,0,2,2,0,0,D
1964-11-21,1964,Huddersfield Town,Norwich City,0-0,0,0,2,2,0,0,D
1964-11-21,1964,Ipswich Town,Charlton Athletic,1-1,1,1,2,2,2,0,D
1964-11-21,1964,Middlesbrough,Swindon Town,4-1,4,1,2,2,5,3,H
1964-11-21,1964,Newcastle United,Derby County,2-2,2,2,2,2,4,0,D
1964-11-21,1964,Northampton Town,Swansea City,2-1,2,1,2,2,3,1,H
1964-11-21,1964,Plymouth Argyle,Manchester City,3-2,3,2,2,2,5,1,H
1964-11-21,1964,Preston North End,Leyton Orient,3-0,3,0,2,2,3,3,H
1964-11-21,1964,Southampton,Rotherham United,6-1,6,1,2,2,7,5,H
1964-11-27,1964,Bury,Preston North End,1-1,1,1,2,2,2,0,D
1964-11-28,1964,Charlton Athletic,Plymouth Argyle,3-2,3,2,2,2,5,1,H
1964-11-28,1964,Crystal Palace,Cardiff City,0-0,0,0,2,2,0,0,D
1964-11-28,1964,Derby County,Northampton Town,2-2,2,2,2,2,4,0,D
1964-11-28,1964,Leyton Orient,Ipswich Town,0-0,0,0,2,2,0,0,D
1964-11-28,1964,Manchester City,Bolton Wanderers,2-4,2,4,2,2,6,-2,A
1964-11-28,1964,Norwich City,Coventry City,1-0,1,0,2,2,1,1,H
1964-11-28,1964,Portsmouth,Middlesbrough,2-1,2,1,2,2,3,1,H
1964-11-28,1964,Rotherham United,Huddersfield Town,2-3,2,3,2,2,5,-1,A
1964-11-28,1964,Swansea City,Southampton,3-3,3,3,2,2,6,0,D
1964-11-28,1964,Swindon Town,Newcastle United,1-6,1,6,2,2,7,-5,A
1964-12-05,1964,Cardiff City,Norwich City,1-3,1,3,2,2,4,-2,A
1964-12-05,1964,Coventry City,Rotherham United,3-5,3,5,2,2,8,-2,A
1964-12-05,1964,Huddersfield Town,Swansea City,4-0,4,0,2,2,4,4,H
1964-12-05,1964,Ipswich Town,Bury,1-0,1,0,2,2,1,1,H
1964-12-05,1964,Middlesbrough,Manchester City,0-1,0,1,2,2,1,-1,A
1964-12-05,1964,Newcastle United,Portsmouth,3-0,3,0,2,2,3,3,H
1964-12-05,1964,Northampton Town,Swindon Town,2-1,2,1,2,2,3,1,H
1964-12-05,1964,Plymouth Argyle,Leyton Orient,1-1,1,1,2,2,2,0,D
1964-12-05,1964,Preston North End,Crystal Palace,1-0,1,0,2,2,1,1,H
1964-12-05,1964,Southampton,Derby County,3-3,3,3,2,2,6,0,D
1964-12-12,1964,Derby County,Crystal Palace,3-3,3,3,2,2,6,0,D
1964-12-12,1964,Ipswich Town,Cardiff City,1-1,1,1,2,2,2,0,D
1964-12-12,1964,Middlesbrough,Southampton,4-1,4,1,2,2,5,3,H
1964-12-12,1964,Newcastle United,Northampton Town,5-0,5,0,2,2,5,5,H
1964-12-12,1964,Plymouth Argyle,Coventry City,2-3,2,3,2,2,5,-1,A
1964-12-12,1964,Portsmouth,Leyton Orient,1-1,1,1,2,2,2,0,D
1964-12-12,1964,Rotherham United,Preston North End,2-2,2,2,2,2,4,0,D
1964-12-12,1964,Swansea City,Norwich City,0-0,0,0,2,2,0,0,D
1964-12-12,1964,Swindon Town,Bury,2-0,2,0,2,2,2,2,H
1964-12-15,1964,Bolton Wanderers,Huddersfield Town,1-0,1,0,2,2,1,1,H
1964-12-19,1964,Bury,Derby County,2-1,2,1,2,2,3,1,H
1964-12-19,1964,Cardiff City,Plymouth Argyle,4-0,4,0,2,2,4,4,H
1964-12-19,1964,Charlton Athletic,Portsmouth,3-3,3,3,2,2,6,0,D
1964-12-19,1964,Coventry City,Bolton Wanderers,0-0,0,0,2,2,0,0,D
1964-12-19,1964,Crystal Palace,Swansea City,3-3,3,3,2,2,6,0,D
1964-12-19,1964,Leyton Orient,Swindon Town,0-3,0,3,2,2,3,-3,A
1964-12-19,1964,Northampton Town,Manchester City,2-0,2,0,2,2,2,2,H
1964-12-19,1964,Norwich City,Rotherham United,3-0,3,0,2,2,3,3,H
1964-12-19,1964,Preston North End,Ipswich Town,4-1,4,1,2,2,5,3,H
1964-12-19,1964,Southampton,Newcastle United,0-1,0,1,2,2,1,-1,A
1964-12-26,1964,Bolton Wanderers,Northampton Town,0-0,0,0,2,2,0,0,D
1964-12-26,1964,Crystal Palace,Portsmouth,4-2,4,2,2,2,6,2,H
1964-12-26,1964,Ipswich Town,Huddersfield Town,3-2,3,2,2,2,5,1,H
1964-12-26,1964,Leyton Orient,Charlton Athletic,4-2,4,2,2,2,6,2,H
1964-12-26,1964,Manchester City,Bury,0-0,0,0,2,2,0,0,D
1964-12-26,1964,Middlesbrough,Newcastle United,0-2,0,2,2,2,2,-2,A
1964-12-26,1964,Preston North End,Coventry City,3-2,3,2,2,2,5,1,H
1964-12-26,1964,Southampton,Plymouth Argyle,5-0,5,0,2,2,5,5,H
1964-12-26,1964,Swansea City,Cardiff City,3-2,3,2,2,2,5,1,H
1964-12-26,1964,Swindon Town,Norwich City,0-1,0,1,2,2,1,-1,A
1964-12-28,1964,Bury,Manchester City,0-2,0,2,2,2,2,-2,A
1964-12-28,1964,Charlton Athletic,Leyton Orient,2-0,2,0,2,2,2,2,H
1964-12-28,1964,Coventry City,Preston North End,3-0,3,0,2,2,3,3,H
1964-12-28,1964,Huddersfield Town,Ipswich Town,0-0,0,0,2,2,0,0,D
1964-12-28,1964,Newcastle United,Middlesbrough,2-1,2,1,2,2,3,1,H
1964-12-28,1964,Portsmouth,Crystal Palace,1-1,1,1,2,2,2,0,D
1964-12-28,1964,Rotherham United,Derby County,1-1,1,1,2,2,2,0,D
1965-01-02,1964,Derby County,Leyton Orient,1-0,1,0,2,2,1,1,H
1965-01-02,1964,Ipswich Town,Norwich City,3-0,3,0,2,2,3,3,H
1965-01-02,1964,Middlesbrough,Coventry City,2-3,2,3,2,2,5,-1,A
1965-01-02,1964,Newcastle United,Huddersfield Town,2-1,2,1,2,2,3,1,H
1965-01-02,1964,Northampton Town,Southampton,2-2,2,2,2,2,4,0,D
1965-01-02,1964,Plymouth Argyle,Preston North End,0-1,0,1,2,2,1,-1,A
1965-01-02,1964,Portsmouth,Manchester City,1-1,1,1,2,2,2,0,D
1965-01-02,1964,Rotherham United,Crystal Palace,1-0,1,0,2,2,1,1,H
1965-01-02,1964,Swansea City,Bury,2-2,2,2,2,2,4,0,D
1965-01-02,1964,Swindon Town,Charlton Athletic,2-0,2,0,2,2,2,2,H
1965-01-15,1964,Cardiff City,Middlesbrough,6-1,6,1,2,2,7,5,H
1965-01-16,1964,Charlton Athletic,Derby County,1-3,1,3,2,2,4,-2,A
1965-01-16,1964,Coventry City,Newcastle United,5-4,5,4,2,2,9,1,H
1965-01-16,1964,Crystal Palace,Norwich City,2-0,2,0,2,2,2,2,H
1965-01-16,1964,Huddersfield Town,Northampton Town,2-0,2,0,2,2,2,2,H
1965-01-16,1964,Ipswich Town,Plymouth Argyle,2-2,2,2,2,2,4,0,D
1965-01-16,1964,Leyton Orient,Swansea City,2-3,2,3,2,2,5,-1,A
1965-01-16,1964,Manchester City,Swindon Town,1-2,1,2,2,2,3,-1,A
1965-01-16,1964,Preston North End,Bolton Wanderers,2-2,2,2,2,2,4,0,D
1965-01-16,1964,Southampton,Portsmouth,2-2,2,2,2,2,4,0,D
1965-01-23,1964,Bolton Wanderers,Ipswich Town,0-0,0,0,2,2,0,0,D
1965-01-23,1964,Middlesbrough,Preston North End,1-1,1,1,2,2,2,0,D
1965-01-23,1964,Newcastle United,Cardiff City,2-0,2,0,2,2,2,2,H
1965-01-23,1964,Northampton Town,Coventry City,1-1,1,1,2,2,2,0,D
1965-01-23,1964,Norwich City,Bury,1-1,1,1,2,2,2,0,D
1965-01-23,1964,Plymouth Argyle,Crystal Palace,1-1,1,1,2,2,2,0,D
1965-01-23,1964,Southampton,Huddersfield Town,3-3,3,3,2,2,6,0,D
1965-01-23,1964,Swansea City,Charlton Athletic,1-3,1,3,2,2,4,-2,A
1965-01-23,1964,Swindon Town,Portsmouth,0-0,0,0,2,2,0,0,D
1965-01-30,1964,Derby County,Manchester City,2-0,2,0,2,2,2,2,H
1965-01-30,1964,Norwich City,Swindon Town,3-1,3,1,2,2,4,2,H
1965-02-06,1964,Bury,Crystal Palace,3-1,3,1,2,2,4,2,H
1965-02-06,1964,Cardiff City,Northampton Town,0-2,0,2,2,2,2,-2,A
1965-02-06,1964,Charlton Athletic,Rotherham United,1-1,1,1,2,2,2,0,D
1965-02-06,1964,Coventry City,Southampton,1-1,1,1,2,2,2,0,D
1965-02-06,1964,Huddersfield Town,Swindon Town,2-1,2,1,2,2,3,1,H
1965-02-06,1964,Ipswich Town,Middlesbrough,5-2,5,2,2,2,7,3,H
1965-02-06,1964,Leyton Orient,Norwich City,2-3,2,3,2,2,5,-1,A
1965-02-06,1964,Manchester City,Swansea City,1-0,1,0,2,2,1,1,H
1965-02-06,1964,Plymouth Argyle,Bolton Wanderers,1-3,1,3,2,2,4,-2,A
1965-02-06,1964,Portsmouth,Derby County,3-1,3,1,2,2,4,2,H
1965-02-06,1964,Preston North End,Newcastle United,2-0,2,0,2,2,2,2,H
1965-02-13,1964,Bolton Wanderers,Bury,0-1,0,1,2,2,1,-1,A
1965-02-13,1964,Crystal Palace,Leyton Orient,1-0,1,0,2,2,1,1,H
1965-02-13,1964,Derby County,Swindon Town,4-1,4,1,2,2,5,3,H
1965-02-13,1964,Huddersfield Town,Coventry City,2-1,2,1,2,2,3,1,H
1965-02-13,1964,Middlesbrough,Plymouth Argyle,1-3,1,3,2,2,4,-2,A
1965-02-13,1964,Newcastle United,Ipswich Town,2-2,2,2,2,2,4,0,D
1965-02-13,1964,Northampton Town,Preston North End,2-1,2,1,2,2,3,1,H
1965-02-13,1964,Norwich City,Charlton Athletic,2-0,2,0,2,2,2,2,H
1965-02-13,1964,Rotherham United,Manchester City,0-0,0,0,2,2,0,0,D
1965-02-13,1964,Southampton,Cardiff City,1-1,1,1,2,2,2,0,D
1965-02-13,1964,Swansea City,Portsmouth,0-0,0,0,2,2,0,0,D
1965-02-17,1964,Plymouth Argyle,Southampton,4-0,4,0,2,2,4,4,H
1965-02-20,1964,Charlton Athletic,Northampton Town,1-1,1,1,2,2,2,0,D
1965-02-20,1964,Derby County,Cardiff City,1-0,1,0,2,2,1,1,H
1965-02-20,1964,Leyton Orient,Newcastle United,2-1,2,1,2,2,3,1,H
1965-02-20,1964,Manchester City,Southampton,3-1,3,1,2,2,4,2,H
1965-02-20,1964,Norwich City,Plymouth Argyle,3-0,3,0,2,2,3,3,H
1965-02-20,1964,Portsmouth,Huddersfield Town,3-0,3,0,2,2,3,3,H
1965-02-20,1964,Rotherham United,Ipswich Town,2-2,2,2,2,2,4,0,D
1965-02-20,1964,Swindon Town,Coventry City,4-1,4,1,2,2,5,3,H
1965-02-23,1964,Bury,Middlesbrough,3-2,3,2,2,2,5,1,H
1965-02-27,1964,Bolton Wanderers,Norwich City,5-2,5,2,2,2,7,3,H
1965-02-27,1964,Cardiff City,Swindon Town,2-0,2,0,2,2,2,2,H
1965-02-27,1964,Coventry City,Portsmouth,1-2,1,2,2,2,3,-1,A
1965-02-27,1964,Huddersfield Town,Manchester City,1-0,1,0,2,2,1,1,H
1965-02-27,1964,Ipswich Town,Swansea City,3-0,3,0,2,2,3,3,H
1965-02-27,1964,Middlesbrough,Crystal Palace,0-0,0,0,2,2,0,0,D
1965-02-27,1964,Newcastle United,Bury,2-3,2,3,2,2,5,-1,A
1965-02-27,1964,Northampton Town,Leyton Orient,2-0,2,0,2,2,2,2,H
1965-02-27,1964,Plymouth Argyle,Rotherham United,1-1,1,1,2,2,2,0,D
1965-02-27,1964,Preston North End,Derby County,2-2,2,2,2,2,4,0,D
1965-02-27,1964,Southampton,Charlton Athletic,4-0,4,0,2,2,4,4,H
1965-03-02,1964,Northampton Town,Bolton Wanderers,4-0,4,0,2,2,4,4,H
1965-03-05,1964,Bury,Ipswich Town,0-1,0,1,2,2,1,-1,A
1965-03-06,1964,Charlton Athletic,Bolton Wanderers,1-3,1,3,2,2,4,-2,A
1965-03-06,1964,Derby County,Southampton,2-1,2,1,2,2,3,1,H
1965-03-06,1964,Manchester City,Middlesbrough,1-1,1,1,2,2,2,0,D
1965-03-06,1964,Norwich City,Cardiff City,2-1,2,1,2,2,3,1,H
1965-03-06,1964,Portsmouth,Newcastle United,1-2,1,2,2,2,3,-1,A
1965-03-06,1964,Rotherham United,Coventry City,0-2,0,2,2,2,2,-2,A
1965-03-06,1964,Swansea City,Huddersfield Town,2-2,2,2,2,2,4,0,D
1965-03-12,1964,Cardiff City,Manchester City,2-2,2,2,2,2,4,0,D
1965-03-13,1964,Bolton Wanderers,Swansea City,2-1,2,1,2,2,3,1,H
1965-03-13,1964,Coventry City,Charlton Athletic,2-0,2,0,2,2,2,2,H
1965-03-13,1964,Huddersfield Town,Leyton Orient,0-0,0,0,2,2,0,0,D
1965-03-13,1964,Ipswich Town,Swindon Town,0-0,0,0,2,2,0,0,D
1965-03-13,1964,Middlesbrough,Rotherham United,3-5,3,5,2,2,8,-2,A
1965-03-13,1964,Newcastle United,Norwich City,2-0,2,0,2,2,2,2,H
1965-03-13,1964,Northampton Town,Crystal Palace,1-1,1,1,2,2,2,0,D
1965-03-13,1964,Plymouth Argyle,Derby County,1-1,1,1,2,2,2,0,D
1965-03-13,1964,Preston North End,Portsmouth,6-1,6,1,2,2,7,5,H
1965-03-13,1964,Southampton,Bury,3-1,3,1,2,2,4,2,H
1965-03-17,1964,Crystal Palace,Preston North End,1-0,1,0,2,2,1,1,H
1965-03-19,1964,Bury,Huddersfield Town,0-2,0,2,2,2,2,-2,A
1965-03-20,1964,Crystal Palace,Southampton,0-2,0,2,2,2,2,-2,A
1965-03-20,1964,Derby County,Bolton Wanderers,2-3,2,3,2,2,5,-1,A
1965-03-20,1964,Manchester City,Preston North End,4-3,4,3,2,2,7,1,H
1965-03-20,1964,Norwich City,Northampton Town,1-1,1,1,2,2,2,0,D
1965-03-20,1964,Portsmouth,Ipswich Town,0-2,0,2,2,2,2,-2,A
1965-03-20,1964,Rotherham United,Newcastle United,1-1,1,1,2,2,2,0,D
1965-03-20,1964,Swansea City,Middlesbrough,1-2,1,2,2,2,3,-1,A
1965-03-20,1964,Swindon Town,Plymouth Argyle,2-3,2,3,2,2,5,-1,A
1965-03-22,1964,Charlton Athletic,Cardiff City,2-2,2,2,2,2,4,0,D
1965-03-23,1964,Swansea City,Preston North End,4-0,4,0,2,2,4,4,H
1965-03-23,1964,Swindon Town,Northampton Town,4-2,4,2,2,2,6,2,H
1965-03-24,1964,Cardiff City,Southampton,2-2,2,2,2,2,4,0,D
1965-03-24,1964,Derby County,Rotherham United,2-2,2,2,2,2,4,0,D
1965-03-26,1964,Bolton Wanderers,Swindon Town,1-1,1,1,2,2,2,0,D
1965-03-26,1964,Preston North End,Charlton Athletic,2-1,2,1,2,2,3,1,H
1965-03-27,1964,Cardiff City,Leyton Orient,0-2,0,2,2,2,2,-2,A
1965-03-27,1964,Coventry City,Bury,2-1,2,1,2,2,3,1,H
1965-03-27,1964,Huddersfield Town,Crystal Palace,2-0,2,0,2,2,2,2,H
1965-03-27,1964,Ipswich Town,Manchester City,4-1,4,1,2,2,5,3,H
1965-03-27,1964,Middlesbrough,Derby County,1-2,1,2,2,2,3,-1,A
1965-03-27,1964,Newcastle United,Swansea City,3-1,3,1,2,2,4,2,H
1965-03-27,1964,Northampton Town,Rotherham United,1-0,1,0,2,2,1,1,H
1965-03-27,1964,Plymouth Argyle,Portsmouth,2-1,2,1,2,2,3,1,H
1965-03-27,1964,Southampton,Norwich City,1-0,1,0,2,2,1,1,H
1965-03-29,1964,Bolton Wanderers,Charlton Athletic,1-1,1,1,2,2,2,0,D
1965-03-30,1964,Huddersfield Town,Middlesbrough,1-0,1,0,2,2,1,1,H
1965-03-31,1964,Leyton Orient,Plymouth Argyle,2-0,2,0,2,2,2,2,H
1965-04-03,1964,Bury,Cardiff City,1-2,1,2,2,2,3,-1,A
1965-04-03,1964,Charlton Athletic,Ipswich Town,4-0,4,0,2,2,4,4,H
1965-04-03,1964,Crystal Palace,Coventry City,2-2,2,2,2,2,4,0,D
1965-04-03,1964,Derby County,Newcastle United,0-3,0,3,2,2,3,-3,A
1965-04-03,1964,Leyton Orient,Preston North End,2-1,2,1,2,2,3,1,H
1965-04-03,1964,Manchester City,Plymouth Argyle,2-1,2,1,2,2,3,1,H
1965-04-03,1964,Norwich City,Huddersfield Town,0-2,0,2,2,2,2,-2,A
1965-04-03,1964,Portsmouth,Bolton Wanderers,3-0,3,0,2,2,3,3,H
1965-04-03,1964,Rotherham United,Southampton,1-3,1,3,2,2,4,-2,A
1965-04-03,1964,Swansea City,Northampton Town,1-2,1,2,2,2,3,-1,A
1965-04-03,1964,Swindon Town,Middlesbrough,0-1,0,1,2,2,1,-1,A
1965-04-06,1964,Cardiff City,Swansea City,5-0,5,0,2,2,5,5,H
1965-04-06,1964,Rotherham United,Leyton Orient,3-0,3,0,2,2,3,3,H
1965-04-07,1964,Crystal Palace,Bolton Wanderers,2-0,2,0,2,2,2,2,H
1965-04-09,1964,Middlesbrough,Portsmouth,4-1,4,1,2,2,5,3,H
1965-04-10,1964,Bolton Wanderers,Manchester City,4-0,4,0,2,2,4,4,H
1965-04-10,1964,Cardiff City,Crystal Palace,0-0,0,0,2,2,0,0,D
1965-04-10,1964,Coventry City,Norwich City,3-0,3,0,2,2,3,3,H
1965-04-10,1964,Huddersfield Town,Rotherham United,1-0,1,0,2,2,1,1,H
1965-04-10,1964,Ipswich Town,Leyton Orient,1-1,1,1,2,2,2,0,D
1965-04-10,1964,Newcastle United,Swindon Town,1-0,1,0,2,2,1,1,H
1965-04-10,1964,Northampton Town,Derby County,2-2,2,2,2,2,4,0,D
1965-04-10,1964,Plymouth Argyle,Charlton Athletic,1-5,1,5,2,2,6,-4,A
1965-04-10,1964,Preston North End,Bury,2-2,2,2,2,2,4,0,D
1965-04-10,1964,Southampton,Swansea City,3-1,3,1,2,2,4,2,H
1965-04-16,1964,Leyton Orient,Middlesbrough,1-1,1,1,2,2,2,0,D
1965-04-16,1964,Manchester City,Crystal Palace,0-2,0,2,2,2,2,-2,A
1965-04-16,1964,Newcastle United,Bolton Wanderers,2-0,2,0,2,2,2,2,H
1965-04-16,1964,Swindon Town,Rotherham United,3-2,3,2,2,2,5,1,H
1965-04-17,1964,Bury,Northampton Town,1-4,1,4,2,2,5,-3,A
1965-04-17,1964,Charlton Athletic,Huddersfield Town,0-0,0,0,2,2,0,0,D
1965-04-17,1964,Crystal Palace,Newcastle United,1-1,1,1,2,2,2,0,D
1965-04-17,1964,Derby County,Ipswich Town,2-3,2,3,2,2,5,-1,A
1965-04-17,1964,Leyton Orient,Southampton,0-0,0,0,2,2,0,0,D
1965-04-17,1964,Manchester City,Coventry City,1-1,1,1,2,2,2,0,D
1965-04-17,1964,Norwich City,Middlesbrough,2-0,2,0,2,2,2,2,H
1965-04-17,1964,Portsmouth,Cardiff City,1-0,1,0,2,2,1,1,H
1965-04-17,1964,Rotherham United,Bolton Wanderers,0-0,0,0,2,2,0,0,D
1965-04-17,1964,Swansea City,Plymouth Argyle,3-0,3,0,2,2,3,3,H
1965-04-17,1964,Swindon Town,Preston North End,2-2,2,2,2,2,4,0,D
1965-04-19,1964,Bolton Wanderers,Newcastle United,1-1,1,1,2,2,2,0,D
1965-04-19,1964,Cardiff City,Coventry City,3-1,3,1,2,2,4,2,H
1965-04-19,1964,Charlton Athletic,Bury,1-2,1,2,2,2,3,-1,A
1965-04-19,1964,Crystal Palace,Manchester City,1-1,1,1,2,2,2,0,D
1965-04-19,1964,Derby County,Swansea City,3-4,3,4,2,2,7,-1,A
1965-04-19,1964,Huddersfield Town,Preston North End,3-0,3,0,2,2,3,3,H
1965-04-19,1964,Ipswich Town,Southampton,2-0,2,0,2,2,2,2,H
1965-04-19,1964,Middlesbrough,Leyton Orient,2-0,2,0,2,2,2,2,H
1965-04-19,1964,Plymouth Argyle,Northampton Town,5-2,5,2,2,2,7,3,H
1965-04-19,1964,Portsmouth,Norwich City,4-0,4,0,2,2,4,4,H
1965-04-19,1964,Rotherham United,Swindon Town,1-0,1,0,2,2,1,1,H
1965-04-20,1964,Bury,Charlton Athletic,2-0,2,0,2,2,2,2,H
1965-04-20,1964,Coventry City,Cardiff City,0-2,0,2,2,2,2,-2,A
1965-04-20,1964,Northampton Town,Plymouth Argyle,3-1,3,1,2,2,4,2,H
1965-04-20,1964,Norwich City,Portsmouth,3-1,3,1,2,2,4,2,H
1965-04-20,1964,Preston North End,Huddersfield Town,2-0,2,0,2,2,2,2,H
1965-04-20,1964,Swansea City,Derby County,2-1,2,1,2,2,3,1,H
1965-04-21,1964,Southampton,Ipswich Town,1-1,1,1,2,2,2,0,D
1965-04-24,1964,Bolton Wanderers,Leyton Orient,0-0,0,0,2,2,0,0,D
1965-04-24,1964,Cardiff City,Rotherham United,3-2,3,2,2,2,5,1,H
1965-04-24,1964,Coventry City,Swansea City,3-0,3,0,2,2,3,3,H
1965-04-24,1964,Huddersfield Town,Derby County,3-1,3,1,2,2,4,2,H
1965-04-24,1964,Ipswich Town,Crystal Palace,3-2,3,2,2,2,5,1,H
1965-04-24,1964,Middlesbrough,Charlton Athletic,1-2,1,2,2,2,3,-1,A
1965-04-24,1964,Newcastle United,Manchester City,0-0,0,0,2,2,0,0,D
1965-04-24,1964,Northampton Town,Portsmouth,1-1,1,1,2,2,2,0,D
1965-04-24,1964,Plymouth Argyle,Bury,2-2,2,2,2,2,4,0,D
1965-04-24,1964,Preston North End,Norwich City,3-1,3,1,2,2,4,2,H
1965-04-24,1964,Southampton,Swindon Town,2-1,2,1,2,2,3,1,H
1965-04-27,1964,Bury,Rotherham United,0-1,0,1,2,2,1,-1,A
1965-04-28,1964,Bolton Wanderers,Cardiff City,1-0,1,0,2,2,1,1,H
1965-04-28,1964,Leyton Orient,Coventry City,1-3,1,3,2,2,4,-2,A
1965-04-28,1964,Manchester City,Charlton Athletic,2-1,2,1,2,2,3,1,H
1965-08-21,1965,Birmingham City,Crystal Palace,2-1,2,1,2,2,3,1,H
1965-08-21,1965,Bolton Wanderers,Charlton Athletic,4-2,4,2,2,2,6,2,H
1965-08-21,1965,Bristol City,Rotherham United,2-1,2,1,2,2,3,1,H
1965-08-21,1965,Cardiff City,Bury,1-0,1,0,2,2,1,1,H
1965-08-21,1965,Carlisle United,Norwich City,4-1,4,1,2,2,5,3,H
1965-08-21,1965,Coventry City,Wolverhampton Wanderers,2-1,2,1,2,2,3,1,H
1965-08-21,1965,Derby County,Southampton,0-3,0,3,2,2,3,-3,A
1965-08-21,1965,Ipswich Town,Preston North End,1-0,1,0,2,2,1,1,H
1965-08-21,1965,Leyton Orient,Huddersfield Town,0-2,0,2,2,2,2,-2,A
1965-08-21,1965,Middlesbrough,Manchester City,1-1,1,1,2,2,2,0,D
1965-08-21,1965,Portsmouth,Plymouth Argyle,4-1,4,1,2,2,5,3,H
1965-08-23,1965,Preston North End,Portsmouth,4-1,4,1,2,2,5,3,H
1965-08-24,1965,Bury,Coventry City,1-1,1,1,2,2,2,0,D
1965-08-24,1965,Huddersfield Town,Ipswich Town,1-0,1,0,2,2,1,1,H
1965-08-24,1965,Rotherham United,Leyton Orient,2-1,2,1,2,2,3,1,H
1965-08-25,1965,Birmingham City,Middlesbrough,1-1,1,1,2,2,2,0,D
1965-08-25,1965,Cardiff City,Derby County,2-1,2,1,2,2,3,1,H
1965-08-25,1965,Crystal Palace,Bolton Wanderers,1-1,1,1,2,2,2,0,D
1965-08-25,1965,Manchester City,Wolverhampton Wanderers,2-1,2,1,2,2,3,1,H
1965-08-25,1965,Norwich City,Bristol City,0-0,0,0,2,2,0,0,D
1965-08-25,1965,Plymouth Argyle,Charlton Athletic,3-0,3,0,2,2,3,3,H
1965-08-25,1965,Southampton,Carlisle United,1-0,1,0,2,2,1,1,H
1965-08-28,1965,Bury,Derby County,4-1,4,1,2,2,5,3,H
1965-08-28,1965,Charlton Athletic,Ipswich Town,2-0,2,0,2,2,2,2,H
1965-08-28,1965,Crystal Palace,Leyton Orient,2-1,2,1,2,2,3,1,H
1965-08-28,1965,Huddersfield Town,Middlesbrough,6-0,6,0,2,2,6,6,H
1965-08-28,1965,Manchester City,Bristol City,2-2,2,2,2,2,4,0,D
1965-08-28,1965,Norwich City,Cardiff City,3-2,3,2,2,2,5,1,H
1965-08-28,1965,Plymouth Argyle,Bolton Wanderers,1-3,1,3,2,2,4,-2,A
1965-08-28,1965,Preston North End,Birmingham City,3-3,3,3,2,2,6,0,D
1965-08-28,1965,Rotherham United,Coventry City,1-1,1,1,2,2,2,0,D
1965-08-28,1965,Southampton,Portsmouth,2-2,2,2,2,2,4,0,D
1965-08-28,1965,Wolverhampton Wanderers,Carlisle United,3-0,3,0,2,2,3,3,H
1965-08-30,1965,Leyton Orient,Rotherham United,1-4,1,4,2,2,5,-3,A
1965-08-30,1965,Wolverhampton Wanderers,Manchester City,2-4,2,4,2,2,6,-2,A
1965-08-31,1965,Bristol City,Norwich City,0-0,0,0,2,2,0,0,D
1965-08-31,1965,Carlisle United,Southampton,1-0,1,0,2,2,1,1,H
1965-08-31,1965,Charlton Athletic,Plymouth Argyle,1-1,1,1,2,2,2,0,D
1965-08-31,1965,Coventry City,Bury,1-0,1,0,2,2,1,1,H
1965-08-31,1965,Ipswich Town,Huddersfield Town,2-2,2,2,2,2,4,0,D
1965-08-31,1965,Middlesbrough,Birmingham City,1-1,1,1,2,2,2,0,D
1965-09-01,1965,Bolton Wanderers,Crystal Palace,3-0,3,0,2,2,3,3,H
1965-09-01,1965,Derby County,Cardiff City,1-5,1,5,2,2,6,-4,A
1965-09-01,1965,Portsmouth,Preston North End,4-1,4,1,2,2,5,3,H
1965-09-03,1965,Carlisle United,Rotherham United,1-0,1,0,2,2,1,1,H
1965-09-04,1965,Birmingham City,Charlton Athletic,2-2,2,2,2,2,4,0,D
1965-09-04,1965,Bolton Wanderers,Portsmouth,2-0,2,0,2,2,2,2,H
1965-09-04,1965,Bristol City,Huddersfield Town,2-1,2,1,2,2,3,1,H
1965-09-04,1965,Cardiff City,Wolverhampton Wanderers,1-4,1,4,2,2,5,-3,A
1965-09-04,1965,Coventry City,Manchester City,3-3,3,3,2,2,6,0,D
1965-09-04,1965,Derby County,Norwich City,3-1,3,1,2,2,4,2,H
1965-09-04,1965,Ipswich Town,Plymouth Argyle,4-1,4,1,2,2,5,3,H
1965-09-04,1965,Leyton Orient,Preston North End,2-2,2,2,2,2,4,0,D
1965-09-04,1965,Middlesbrough,Crystal Palace,2-2,2,2,2,2,4,0,D
1965-09-04,1965,Southampton,Bury,6-2,6,2,2,2,8,4,H
1965-09-07,1965,Bury,Bristol City,1-2,1,2,2,2,3,-1,A
1965-09-07,1965,Carlisle United,Derby County,2-1,2,1,2,2,3,1,H
1965-09-07,1965,Huddersfield Town,Bolton Wanderers,1-0,1,0,2,2,1,1,H
1965-09-07,1965,Ipswich Town,Middlesbrough,2-1,2,1,2,2,3,1,H
1965-09-07,1965,Rotherham United,Wolverhampton Wanderers,4-3,4,3,2,2,7,1,H
1965-09-08,1965,Birmingham City,Leyton Orient,2-2,2,2,2,2,4,0,D
1965-09-08,1965,Crystal Palace,Portsmouth,4-1,4,1,2,2,5,3,H
1965-09-08,1965,Plymouth Argyle,Preston North End,0-1,0,1,2,2,1,-1,A
1965-09-08,1965,Southampton,Coventry City,1-0,1,0,2,2,1,1,H
1965-09-11,1965,Bristol City,Coventry City,1-1,1,1,2,2,2,0,D
1965-09-11,1965,Charlton Athletic,Leyton Orient,3-0,3,0,2,2,3,3,H
1965-09-11,1965,Crystal Palace,Huddersfield Town,2-1,2,1,2,2,3,1,H
1965-09-11,1965,Manchester City,Carlisle United,2-1,2,1,2,2,3,1,H
1965-09-11,1965,Norwich City,Southampton,3-4,3,4,2,2,7,-1,A
1965-09-11,1965,Plymouth Argyle,Birmingham City,6-1,6,1,2,2,7,5,H
1965-09-11,1965,Portsmouth,Ipswich Town,1-0,1,0,2,2,1,1,H
1965-09-11,1965,Preston North End,Middlesbrough,1-1,1,1,2,2,2,0,D
1965-09-11,1965,Rotherham United,Cardiff City,6-4,6,4,2,2,10,2,H
1965-09-11,1965,Wolverhampton Wanderers,Derby County,4-0,4,0,2,2,4,4,H
1965-09-13,1965,Leyton Orient,Birmingham City,2-1,2,1,2,2,3,1,H
1965-09-13,1965,Preston North End,Plymouth Argyle,2-0,2,0,2,2,2,2,H
1965-09-13,1965,Wolverhampton Wanderers,Rotherham United,4-1,4,1,2,2,5,3,H
1965-09-14,1965,Charlton Athletic,Cardiff City,5-2,5,2,2,2,7,3,H
1965-09-14,1965,Coventry City,Southampton,5-1,5,1,2,2,6,4,H
1965-09-14,1965,Middlesbrough,Ipswich Town,3-2,3,2,2,2,5,1,H
1965-09-15,1965,Bolton Wanderers,Huddersfield Town,1-1,1,1,2,2,2,0,D
1965-09-15,1965,Derby County,Carlisle United,3-1,3,1,2,2,4,2,H
1965-09-15,1965,Norwich City,Manchester City,3-3,3,3,2,2,6,0,D
1965-09-15,1965,Portsmouth,Crystal Palace,1-1,1,1,2,2,2,0,D
1965-09-17,1965,Carlisle United,Bristol City,5-0,5,0,2,2,5,5,H
1965-09-18,1965,Birmingham City,Portsmouth,1-3,1,3,2,2,4,-2,A
1965-09-18,1965,Bury,Norwich City,2-5,2,5,2,2,7,-3,A
1965-09-18,1965,Cardiff City,Manchester City,4-3,4,3,2,2,7,1,H
1965-09-18,1965,Coventry City,Crystal Palace,0-1,0,1,2,2,1,-1,A
1965-09-18,1965,Derby County,Rotherham United,1-3,1,3,2,2,4,-2,A
1965-09-18,1965,Huddersfield Town,Preston North End,2-1,2,1,2,2,3,1,H
1965-09-18,1965,Ipswich Town,Bolton Wanderers,2-0,2,0,2,2,2,2,H
1965-09-18,1965,Leyton Orient,Plymouth Argyle,0-1,0,1,2,2,1,-1,A
1965-09-18,1965,Middlesbrough,Charlton Athletic,2-2,2,2,2,2,4,0,D
1965-09-18,1965,Southampton,Wolverhampton Wanderers,9-3,9,3,2,2,12,6,H
1965-09-25,1965,Bolton Wanderers,Birmingham City,1-2,1,2,2,2,3,-1,A
1965-09-25,1965,Bristol City,Cardiff City,1-1,1,1,2,2,2,0,D
1965-09-25,1965,Charlton Athletic,Huddersfield Town,0-2,0,2,2,2,2,-2,A
1965-09-25,1965,Coventry City,Carlisle United,3-2,3,2,2,2,5,1,H
1965-09-25,1965,Manchester City,Derby County,1-0,1,0,2,2,1,1,H
1965-09-25,1965,Norwich City,Ipswich Town,1-0,1,0,2,2,1,1,H
1965-09-25,1965,Plymouth Argyle,Middlesbrough,2-2,2,2,2,2,4,0,D
1965-09-25,1965,Portsmouth,Leyton Orient,4-1,4,1,2,2,5,3,H
1965-09-25,1965,Preston North End,Crystal Palace,2-0,2,0,2,2,2,2,H
1965-09-25,1965,Rotherham United,Southampton,1-0,1,0,2,2,1,1,H
1965-09-25,1965,Wolverhampton Wanderers,Bury,3-0,3,0,2,2,3,3,H
1965-10-02,1965,Bury,Rotherham United,6-1,6,1,2,2,7,5,H
1965-10-02,1965,Carlisle United,Preston North End,0-2,0,2,2,2,2,-2,A
1965-10-02,1965,Crystal Palace,Charlton Athletic,2-0,2,0,2,2,2,2,H
1965-10-02,1965,Derby County,Bristol City,2-1,2,1,2,2,3,1,H
1965-10-02,1965,Huddersfield Town,Plymouth Argyle,2-1,2,1,2,2,3,1,H
1965-10-02,1965,Leyton Orient,Bolton Wanderers,1-0,1,0,2,2,1,1,H
1965-10-02,1965,Norwich City,Wolverhampton Wanderers,0-3,0,3,2,2,3,-3,A
1965-10-02,1965,Southampton,Manchester City,0-1,0,1,2,2,1,-1,A
1965-10-06,1965,Cardiff City,Coventry City,1-2,1,2,2,2,3,-1,A
1965-10-09,1965,Birmingham City,Norwich City,1-0,1,0,2,2,1,1,H
1965-10-09,1965,Bolton Wanderers,Southampton,2-3,2,3,2,2,5,-1,A
1965-10-09,1965,Charlton Athletic,Carlisle United,3-2,3,2,2,2,5,1,H
1965-10-09,1965,Crystal Palace,Bristol City,2-1,2,1,2,2,3,1,H
1965-10-09,1965,Huddersfield Town,Manchester City,0-0,0,0,2,2,0,0,D
1965-10-09,1965,Ipswich Town,Bury,3-4,3,4,2,2,7,-1,A
1965-10-09,1965,Leyton Orient,Wolverhampton Wanderers,0-3,0,3,2,2,3,-3,A
1965-10-09,1965,Middlesbrough,Rotherham United,4-0,4,0,2,2,4,4,H
1965-10-09,1965,Plymouth Argyle,Cardiff City,2-2,2,2,2,2,4,0,D
1965-10-09,1965,Portsmouth,Derby County,1-1,1,1,2,2,2,0,D
1965-10-09,1965,Preston North End,Coventry City,0-0,0,0,2,2,0,0,D
1965-10-16,1965,Bristol City,Preston North End,1-0,1,0,2,2,1,1,H
1965-10-16,1965,Bury,Birmingham City,5-1,5,1,2,2,6,4,H
1965-10-16,1965,Cardiff City,Portsmouth,1-2,1,2,2,2,3,-1,A
1965-10-16,1965,Carlisle United,Plymouth Argyle,1-3,1,3,2,2,4,-2,A
1965-10-16,1965,Coventry City,Charlton Athletic,3-1,3,1,2,2,4,2,H
1965-10-16,1965,Derby County,Bolton Wanderers,2-0,2,0,2,2,2,2,H
1965-10-16,1965,Manchester City,Crystal Palace,3-1,3,1,2,2,4,2,H
1965-10-16,1965,Norwich City,Leyton Orient,2-1,2,1,2,2,3,1,H
1965-10-16,1965,Rotherham United,Huddersfield Town,0-0,0,0,2,2,0,0,D
1965-10-16,1965,Southampton,Ipswich Town,1-2,1,2,2,2,3,-1,A
1965-10-16,1965,Wolverhampton Wanderers,Middlesbrough,3-0,3,0,2,2,3,3,H
1965-10-22,1965,Middlesbrough,Norwich City,0-1,0,1,2,2,1,-1,A
1965-10-23,1965,Birmingham City,Southampton,0-1,0,1,2,2,1,-1,A
1965-10-23,1965,Bolton Wanderers,Cardiff City,2-1,2,1,2,2,3,1,H
1965-10-23,1965,Charlton Athletic,Bristol City,1-4,1,4,2,2,5,-3,A
1965-10-23,1965,Crystal Palace,Rotherham United,2-2,2,2,2,2,4,0,D
1965-10-23,1965,Huddersfield Town,Wolverhampton Wanderers,1-1,1,1,2,2,2,0,D
1965-10-23,1965,Ipswich Town,Derby County,2-2,2,2,2,2,4,0,D
1965-10-23,1965,Leyton Orient,Bury,2-2,2,2,2,2,4,0,D
1965-10-23,1965,Plymouth Argyle,Coventry City,1-2,1,2,2,2,3,-1,A
1965-10-23,1965,Portsmouth,Carlisle United,4-1,4,1,2,2,5,3,H
1965-10-23,1965,Preston North End,Manchester City,0-3,0,3,2,2,3,-3,A
1965-10-26,1965,Middlesbrough,Portsmouth,5-2,5,2,2,2,7,3,H
1965-10-27,1965,Manchester City,Norwich City,0-0,0,0,2,2,0,0,D
1965-10-30,1965,Bristol City,Plymouth Argyle,0-0,0,0,2,2,0,0,D
1965-10-30,1965,Bury,Middlesbrough,2-0,2,0,2,2,2,2,H
1965-10-30,1965,Cardiff City,Ipswich Town,1-0,1,0,2,2,1,1,H
1965-10-30,1965,Carlisle United,Bolton Wanderers,1-1,1,1,2,2,2,0,D
1965-10-30,1965,Coventry City,Portsmouth,3-2,3,2,2,2,5,1,H
1965-10-30,1965,Derby County,Birmingham City,5-3,5,3,2,2,8,2,H
1965-10-30,1965,Manchester City,Charlton Athletic,0-0,0,0,2,2,0,0,D
1965-10-30,1965,Norwich City,Huddersfield Town,1-1,1,1,2,2,2,0,D
1965-10-30,1965,Rotherham United,Preston North End,6-3,6,3,2,2,9,3,H
1965-10-30,1965,Southampton,Leyton Orient,1-0,1,0,2,2,1,1,H
1965-10-30,1965,Wolverhampton Wanderers,Crystal Palace,1-0,1,0,2,2,1,1,H
1965-11-06,1965,Birmingham City,Cardiff City,4-2,4,2,2,2,6,2,H
1965-11-06,1965,Bolton Wanderers,Coventry City,4-2,4,2,2,2,6,2,H
1965-11-06,1965,Charlton Athletic,Rotherham United,2-2,2,2,2,2,4,0,D
1965-11-06,1965,Crystal Palace,Norwich City,0-0,0,0,2,2,0,0,D
1965-11-06,1965,Huddersfield Town,Bury,2-0,2,0,2,2,2,2,H
1965-11-06,1965,Ipswich Town,Carlisle United,1-0,1,0,2,2,1,1,H
1965-11-06,1965,Leyton Orient,Derby County,0-0,0,0,2,2,0,0,D
1965-11-06,1965,Middlesbrough,Southampton,0-0,0,0,2,2,0,0,D
1965-11-06,1965,Plymouth Argyle,Manchester City,1-0,1,0,2,2,1,1,H
1965-11-06,1965,Portsmouth,Bristol City,2-4,2,4,2,2,6,-2,A
1965-11-06,1965,Preston North End,Wolverhampton Wanderers,2-2,2,2,2,2,4,0,D
1965-11-10,1965,Cardiff City,Charlton Athletic,3-1,3,1,2,2,4,2,H
1965-11-13,1965,Bristol City,Bolton Wanderers,2-2,2,2,2,2,4,0,D
1965-11-13,1965,Bury,Crystal Palace,2-2,2,2,2,2,4,0,D
1965-11-13,1965,Cardiff City,Leyton Orient,3-1,3,1,2,2,4,2,H
1965-11-13,1965,Carlisle United,Birmingham City,1-0,1,0,2,2,1,1,H
1965-11-13,1965,Coventry City,Ipswich Town,3-1,3,1,2,2,4,2,H
1965-11-13,1965,Derby County,Middlesbrough,5-0,5,0,2,2,5,5,H
1965-11-13,1965,Manchester City,Portsmouth,3-1,3,1,2,2,4,2,H
1965-11-13,1965,Norwich City,Preston North End,1-1,1,1,2,2,2,0,D
1965-11-13,1965,Rotherham United,Plymouth Argyle,2-0,2,0,2,2,2,2,H
1965-11-13,1965,Southampton,Huddersfield Town,0-1,0,1,2,2,1,-1,A
1965-11-13,1965,Wolverhampton Wanderers,Charlton Athletic,2-2,2,2,2,2,4,0,D
1965-11-16,1965,Bury,Bolton Wanderers,1-1,1,1,2,2,2,0,D
1965-11-20,1965,Birmingham City,Coventry City,0-1,0,1,2,2,1,-1,A
1965-11-20,1965,Bolton Wanderers,Manchester City,1-0,1,0,2,2,1,1,H
1965-11-20,1965,Crystal Palace,Southampton,1-0,1,0,2,2,1,1,H
1965-11-20,1965,Huddersfield Town,Derby County,1-3,1,3,2,2,4,-2,A
1965-11-20,1965,Ipswich Town,Bristol City,0-0,0,0,2,2,0,0,D
1965-11-20,1965,Leyton Orient,Carlisle United,2-1,2,1,2,2,3,1,H
1965-11-20,1965,Middlesbrough,Cardiff City,3-4,3,4,2,2,7,-1,A
1965-11-20,1965,Plymouth Argyle,Wolverhampton Wanderers,2-2,2,2,2,2,4,0,D
1965-11-20,1965,Portsmouth,Rotherham United,1-1,1,1,2,2,2,0,D
1965-11-20,1965,Preston North End,Bury,2-1,2,1,2,2,3,1,H
1965-11-27,1965,Bristol City,Birmingham City,2-0,2,0,2,2,2,2,H
1965-11-27,1965,Cardiff City,Huddersfield Town,0-1,0,1,2,2,1,-1,A
1965-11-27,1965,Coventry City,Leyton Orient,1-1,1,1,2,2,2,0,D
1965-11-27,1965,Derby County,Crystal Palace,4-0,4,0,2,2,4,4,H
1965-11-27,1965,Manchester City,Ipswich Town,2-1,2,1,2,2,3,1,H
1965-11-27,1965,Norwich City,Plymouth Argyle,0-0,0,0,2,2,0,0,D
1965-11-27,1965,Rotherham United,Bolton Wanderers,2-1,2,1,2,2,3,1,H
1965-11-27,1965,Southampton,Preston North End,5-2,5,2,2,2,7,3,H
1965-11-27,1965,Wolverhampton Wanderers,Portsmouth,8-2,8,2,2,2,10,6,H
1965-12-04,1965,Birmingham City,Manchester City,3-1,3,1,2,2,4,2,H
1965-12-04,1965,Bolton Wanderers,Wolverhampton Wanderers,2-1,2,1,2,2,3,1,H
1965-12-04,1965,Charlton Athletic,Southampton,2-2,2,2,2,2,4,0,D
1965-12-04,1965,Crystal Palace,Cardiff City,0-0,0,0,2,2,0,0,D
1965-12-04,1965,Huddersfield Town,Carlisle United,2-0,2,0,2,2,2,2,H
1965-12-04,1965,Ipswich Town,Rotherham United,0-0,0,0,2,2,0,0,D
1965-12-04,1965,Leyton Orient,Bristol City,0-4,0,4,2,2,4,-4,A
1965-12-04,1965,Middlesbrough,Coventry City,1-1,1,1,2,2,2,0,D
1965-12-04,1965,Plymouth Argyle,Bury,2-2,2,2,2,2,4,0,D
1965-12-04,1965,Portsmouth,Norwich City,0-3,0,3,2,2,3,-3,A
1965-12-04,1965,Preston North End,Derby County,2-0,2,0,2,2,2,2,H
1965-12-11,1965,Bristol City,Middlesbrough,2-2,2,2,2,2,4,0,D
1965-12-11,1965,Bury,Portsmouth,1-0,1,0,2,2,1,1,H
1965-12-11,1965,Cardiff City,Preston North End,1-3,1,3,2,2,4,-2,A
1965-12-11,1965,Carlisle United,Crystal Palace,3-1,3,1,2,2,4,2,H
1965-12-11,1965,Coventry City,Huddersfield Town,0-3,0,3,2,2,3,-3,A
1965-12-11,1965,Derby County,Charlton Athletic,2-0,2,0,2,2,2,2,H
1965-12-11,1965,Manchester City,Leyton Orient,5-0,5,0,2,2,5,5,H
1965-12-11,1965,Norwich City,Bolton Wanderers,3-0,3,0,2,2,3,3,H
1965-12-11,1965,Rotherham United,Birmingham City,3-4,3,4,2,2,7,-1,A
1965-12-11,1965,Southampton,Plymouth Argyle,4-1,4,1,2,2,5,3,H
1965-12-11,1965,Wolverhampton Wanderers,Ipswich Town,4-1,4,1,2,2,5,3,H
1965-12-18,1965,Birmingham City,Bury,4-0,4,0,2,2,4,4,H
1965-12-18,1965,Bolton Wanderers,Derby County,0-1,0,1,2,2,1,-1,A
1965-12-18,1965,Crystal Palace,Manchester City,0-2,0,2,2,2,2,-2,A
1965-12-18,1965,Huddersfield Town,Rotherham United,4-0,4,0,2,2,4,4,H
1965-12-18,1965,Ipswich Town,Southampton,3-0,3,0,2,2,3,3,H
1965-12-18,1965,Middlesbrough,Wolverhampton Wanderers,3-1,3,1,2,2,4,2,H
1965-12-18,1965,Portsmouth,Cardiff City,3-1,3,1,2,2,4,2,H
1965-12-18,1965,Preston North End,Bristol City,1-1,1,1,2,2,2,0,D
1965-12-27,1965,Cardiff City,Southampton,3-5,3,5,2,2,8,-2,A
1965-12-27,1965,Carlisle United,Bury,4-1,4,1,2,2,5,3,H
1965-12-27,1965,Charlton Athletic,Portsmouth,2-2,2,2,2,2,4,0,D
1965-12-27,1965,Crystal Palace,Ipswich Town,3-1,3,1,2,2,4,2,H
1965-12-27,1965,Middlesbrough,Leyton Orient,2-1,2,1,2,2,3,1,H
1965-12-27,1965,Norwich City,Coventry City,1-1,1,1,2,2,2,0,D
1965-12-27,1965,Plymouth Argyle,Derby County,0-0,0,0,2,2,0,0,D
1965-12-27,1965,Wolverhampton Wanderers,Bristol City,1-1,1,1,2,2,2,0,D
1965-12-28,1965,Birmingham City,Huddersfield Town,2-1,2,1,2,2,3,1,H
1965-12-28,1965,Bristol City,Wolverhampton Wanderers,0-1,0,1,2,2,1,-1,A
1965-12-28,1965,Coventry City,Norwich City,2-0,2,0,2,2,2,2,H
1965-12-28,1965,Portsmouth,Charlton Athletic,3-1,3,1,2,2,4,2,H
1966-01-01,1965,Bristol City,Crystal Palace,1-1,1,1,2,2,2,0,D
1966-01-01,1965,Bury,Ipswich Town,1-1,1,1,2,2,2,0,D
1966-01-01,1965,Cardiff City,Plymouth Argyle,5-1,5,1,2,2,6,4,H
1966-01-01,1965,Carlisle United,Charlton Athletic,3-1,3,1,2,2,4,2,H
1966-01-01,1965,Coventry City,Preston North End,5-1,5,1,2,2,6,4,H
1966-01-01,1965,Derby County,Portsmouth,3-1,3,1,2,2,4,2,H
1966-01-01,1965,Manchester City,Huddersfield Town,2-0,2,0,2,2,2,2,H
1966-01-01,1965,Norwich City,Birmingham City,2-2,2,2,2,2,4,0,D
1966-01-01,1965,Rotherham United,Middlesbrough,4-1,4,1,2,2,5,3,H
1966-01-01,1965,Southampton,Bolton Wanderers,5-1,5,1,2,2,6,4,H
1966-01-01,1965,Wolverhampton Wanderers,Leyton Orient,2-1,2,1,2,2,3,1,H
1966-01-08,1965,Birmingham City,Carlisle United,2-1,2,1,2,2,3,1,H
1966-01-08,1965,Bolton Wanderers,Bristol City,1-2,1,2,2,2,3,-1,A
1966-01-08,1965,Charlton Athletic,Wolverhampton Wanderers,1-1,1,1,2,2,2,0,D
1966-01-08,1965,Crystal Palace,Bury,1-0,1,0,2,2,1,1,H
1966-01-08,1965,Huddersfield Town,Southampton,2-0,2,0,2,2,2,2,H
1966-01-08,1965,Ipswich Town,Coventry City,1-0,1,0,2,2,1,1,H
1966-01-08,1965,Leyton Orient,Cardiff City,1-1,1,1,2,2,2,0,D
1966-01-08,1965,Middlesbrough,Derby County,0-0,0,0,2,2,0,0,D
1966-01-08,1965,Plymouth Argyle,Rotherham United,5-2,5,2,2,2,7,3,H
1966-01-08,1965,Portsmouth,Manchester City,2-2,2,2,2,2,4,0,D
1966-01-08,1965,Preston North End,Norwich City,0-0,0,0,2,2,0,0,D
1966-01-12,1965,Manchester City,Rotherham United,3-1,3,1,2,2,4,2,H
1966-01-15,1965,Bury,Leyton Orient,3-0,3,0,2,2,3,3,H
1966-01-15,1965,Carlisle United,Portsmouth,2-1,2,1,2,2,3,1,H
1966-01-15,1965,Coventry City,Plymouth Argyle,5-1,5,1,2,2,6,4,H
1966-01-15,1965,Derby County,Ipswich Town,2-2,2,2,2,2,4,0,D
1966-01-15,1965,Manchester City,Preston North End,0-0,0,0,2,2,0,0,D
1966-01-15,1965,Rotherham United,Crystal Palace,3-0,3,0,2,2,3,3,H
1966-01-15,1965,Wolverhampton Wanderers,Huddersfield Town,2-1,2,1,2,2,3,1,H
1966-01-29,1965,Bury,Cardiff City,1-1,1,1,2,2,2,0,D
1966-01-29,1965,Charlton Athletic,Bolton Wanderers,0-1,0,1,2,2,1,-1,A
1966-01-29,1965,Crystal Palace,Birmingham City,1-0,1,0,2,2,1,1,H
1966-01-29,1965,Huddersfield Town,Leyton Orient,1-1,1,1,2,2,2,0,D
1966-01-29,1965,Manchester City,Middlesbrough,3-1,3,1,2,2,4,2,H
1966-01-29,1965,Norwich City,Carlisle United,2-0,2,0,2,2,2,2,H
1966-01-29,1965,Plymouth Argyle,Portsmouth,3-1,3,1,2,2,4,2,H
1966-01-29,1965,Preston North End,Ipswich Town,0-1,0,1,2,2,1,-1,A
1966-01-29,1965,Rotherham United,Bristol City,1-2,1,2,2,2,3,-1,A
1966-01-29,1965,Southampton,Derby County,3-1,3,1,2,2,4,2,H
1966-01-29,1965,Wolverhampton Wanderers,Coventry City,0-1,0,1,2,2,1,-1,A
1966-02-05,1965,Birmingham City,Preston North End,1-1,1,1,2,2,2,0,D
1966-02-05,1965,Bolton Wanderers,Plymouth Argyle,0-1,0,1,2,2,1,-1,A
1966-02-05,1965,Bristol City,Manchester City,1-1,1,1,2,2,2,0,D
1966-02-05,1965,Carlisle United,Wolverhampton Wanderers,2-1,2,1,2,2,3,1,H
1966-02-05,1965,Coventry City,Rotherham United,2-2,2,2,2,2,4,0,D
1966-02-05,1965,Derby County,Bury,4-1,4,1,2,2,5,3,H
1966-02-05,1965,Ipswich Town,Charlton Athletic,1-4,1,4,2,2,5,-3,A
1966-02-05,1965,Leyton Orient,Crystal Palace,0-2,0,2,2,2,2,-2,A
1966-02-05,1965,Middlesbrough,Huddersfield Town,1-3,1,3,2,2,4,-2,A
1966-02-05,1965,Portsmouth,Southampton,2-5,2,5,2,2,7,-3,A
1966-02-11,1965,Bristol City,Bury,2-1,2,1,2,2,3,1,H
1966-02-11,1965,Ipswich Town,Crystal Palace,2-2,2,2,2,2,4,0,D
1966-02-19,1965,Bury,Southampton,1-3,1,3,2,2,4,-2,A
1966-02-19,1965,Charlton Athletic,Birmingham City,2-1,2,1,2,2,3,1,H
1966-02-19,1965,Crystal Palace,Middlesbrough,1-1,1,1,2,2,2,0,D
1966-02-19,1965,Huddersfield Town,Bristol City,3-0,3,0,2,2,3,3,H
1966-02-19,1965,Manchester City,Coventry City,1-0,1,0,2,2,1,1,H
1966-02-19,1965,Norwich City,Derby County,0-1,0,1,2,2,1,-1,A
1966-02-19,1965,Plymouth Argyle,Ipswich Town,3-0,3,0,2,2,3,3,H
1966-02-19,1965,Portsmouth,Bolton Wanderers,1-0,1,0,2,2,1,1,H
1966-02-19,1965,Preston North End,Leyton Orient,1-2,1,2,2,2,3,-1,A
1966-02-19,1965,Wolverhampton Wanderers,Cardiff City,2-1,2,1,2,2,3,1,H
1966-02-26,1965,Birmingham City,Plymouth Argyle,1-0,1,0,2,2,1,1,H
1966-02-26,1965,Bolton Wanderers,Bury,2-1,2,1,2,2,3,1,H
1966-02-26,1965,Cardiff City,Rotherham United,0-0,0,0,2,2,0,0,D
1966-02-26,1965,Carlisle United,Manchester City,1-2,1,2,2,2,3,-1,A
1966-02-26,1965,Coventry City,Bristol City,2-2,2,2,2,2,4,0,D
1966-02-26,1965,Derby County,Wolverhampton Wanderers,2-2,2,2,2,2,4,0,D
1966-02-26,1965,Huddersfield Town,Crystal Palace,1-1,1,1,2,2,2,0,D
1966-02-26,1965,Ipswich Town,Portsmouth,1-0,1,0,2,2,1,1,H
1966-02-26,1965,Leyton Orient,Charlton Athletic,1-2,1,2,2,2,3,-1,A
1966-02-26,1965,Middlesbrough,Preston North End,2-1,2,1,2,2,3,1,H
1966-02-26,1965,Southampton,Norwich City,2-2,2,2,2,2,4,0,D
1966-03-05,1965,Bury,Charlton Athletic,3-0,3,0,2,2,3,3,H
1966-03-05,1965,Cardiff City,Bolton Wanderers,1-1,1,1,2,2,2,0,D
1966-03-05,1965,Derby County,Plymouth Argyle,1-2,1,2,2,2,3,-1,A
1966-03-05,1965,Middlesbrough,Bristol City,4-2,4,2,2,2,6,2,H
1966-03-05,1965,Southampton,Birmingham City,0-1,0,1,2,2,1,-1,A
1966-03-08,1965,Carlisle United,Middlesbrough,2-1,2,1,2,2,3,1,H
1966-03-12,1965,Bolton Wanderers,Ipswich Town,3-1,3,1,2,2,4,2,H
1966-03-12,1965,Bristol City,Carlisle United,2-0,2,0,2,2,2,2,H
1966-03-12,1965,Charlton Athletic,Middlesbrough,1-0,1,0,2,2,1,1,H
1966-03-12,1965,Crystal Palace,Coventry City,0-1,0,1,2,2,1,-1,A
1966-03-12,1965,Manchester City,Cardiff City,2-2,2,2,2,2,4,0,D
1966-03-12,1965,Norwich City,Bury,4-0,4,0,2,2,4,4,H
1966-03-12,1965,Plymouth Argyle,Leyton Orient,1-1,1,1,2,2,2,0,D
1966-03-12,1965,Portsmouth,Birmingham City,0-1,0,1,2,2,1,-1,A
1966-03-12,1965,Preston North End,Huddersfield Town,1-1,1,1,2,2,2,0,D
1966-03-12,1965,Rotherham United,Derby County,3-0,3,0,2,2,3,3,H
1966-03-12,1965,Wolverhampton Wanderers,Southampton,1-1,1,1,2,2,2,0,D
1966-03-14,1965,Plymouth Argyle,Carlisle United,0-0,0,0,2,2,0,0,D
1966-03-15,1965,Huddersfield Town,Birmingham City,2-0,2,0,2,2,2,2,H
1966-03-16,1965,Bolton Wanderers,Preston North End,1-3,1,3,2,2,4,-2,A
1966-03-18,1965,Cardiff City,Bristol City,2-1,2,1,2,2,3,1,H
1966-03-18,1965,Carlisle United,Coventry City,2-2,2,2,2,2,4,0,D
1966-03-19,1965,Birmingham City,Bolton Wanderers,0-1,0,1,2,2,1,-1,A
1966-03-19,1965,Bury,Wolverhampton Wanderers,1-0,1,0,2,2,1,1,H
1966-03-19,1965,Crystal Palace,Preston North End,1-1,1,1,2,2,2,0,D
1966-03-19,1965,Derby County,Manchester City,1-2,1,2,2,2,3,-1,A
1966-03-19,1965,Huddersfield Town,Charlton Athletic,1-1,1,1,2,2,2,0,D
1966-03-19,1965,Ipswich Town,Norwich City,2-0,2,0,2,2,2,2,H
1966-03-19,1965,Leyton Orient,Portsmouth,0-0,0,0,2,2,0,0,D
1966-03-19,1965,Middlesbrough,Plymouth Argyle,0-1,0,1,2,2,1,-1,A
1966-03-19,1965,Southampton,Rotherham United,1-1,1,1,2,2,2,0,D
1966-03-25,1965,Bristol City,Derby County,1-1,1,1,2,2,2,0,D
1966-03-25,1965,Plymouth Argyle,Huddersfield Town,0-0,0,0,2,2,0,0,D
1966-03-25,1965,Portsmouth,Middlesbrough,4-1,4,1,2,2,5,3,H
1966-03-25,1965,Rotherham United,Bury,2-1,2,1,2,2,3,1,H
1966-03-26,1965,Bolton Wanderers,Leyton Orient,2-0,2,0,2,2,2,2,H
1966-03-26,1965,Charlton Athletic,Crystal Palace,1-0,1,0,2,2,1,1,H
1966-03-26,1965,Coventry City,Cardiff City,3-1,3,1,2,2,4,2,H
1966-03-26,1965,Ipswich Town,Birmingham City,0-1,0,1,2,2,1,-1,A
1966-03-26,1965,Wolverhampton Wanderers,Norwich City,2-1,2,1,2,2,3,1,H
1966-03-28,1965,Leyton Orient,Norwich City,0-0,0,0,2,2,0,0,D
1966-04-02,1965,Bristol City,Portsmouth,1-0,1,0,2,2,1,1,H
1966-04-02,1965,Cardiff City,Birmingham City,1-3,1,3,2,2,4,-2,A
1966-04-02,1965,Carlisle United,Ipswich Town,3-1,3,1,2,2,4,2,H
1966-04-02,1965,Coventry City,Bolton Wanderers,2-2,2,2,2,2,4,0,D
1966-04-02,1965,Derby County,Leyton Orient,1-3,1,3,2,2,4,-2,A
1966-04-02,1965,Manchester City,Plymouth Argyle,1-1,1,1,2,2,2,0,D
1966-04-02,1965,Norwich City,Crystal Palace,2-1,2,1,2,2,3,1,H
1966-04-02,1965,Southampton,Middlesbrough,3-1,3,1,2,2,4,2,H
1966-04-02,1965,Wolverhampton Wanderers,Preston North End,3-0,3,0,2,2,3,3,H
1966-04-06,1965,Portsmouth,Huddersfield Town,2-1,2,1,2,2,3,1,H
1966-04-08,1965,Bristol City,Southampton,0-1,0,1,2,2,1,-1,A
1966-04-08,1965,Cardiff City,Carlisle United,1-1,1,1,2,2,2,0,D
1966-04-08,1965,Charlton Athletic,Preston North End,5-2,5,2,2,2,7,3,H
1966-04-08,1965,Crystal Palace,Plymouth Argyle,3-1,3,1,2,2,4,2,H
1966-04-08,1965,Leyton Orient,Ipswich Town,1-4,1,4,2,2,5,-3,A
1966-04-08,1965,Manchester City,Bury,1-0,1,0,2,2,1,1,H
1966-04-09,1965,Birmingham City,Derby County,5-5,5,5,2,2,10,0,D
1966-04-09,1965,Crystal Palace,Wolverhampton Wanderers,0-1,0,1,2,2,1,-1,A
1966-04-09,1965,Huddersfield Town,Norwich City,0-0,0,0,2,2,0,0,D
1966-04-09,1965,Ipswich Town,Cardiff City,2-1,2,1,2,2,3,1,H
1966-04-09,1965,Middlesbrough,Bury,1-0,1,0,2,2,1,1,H
1966-04-09,1965,Plymouth Argyle,Bristol City,0-2,0,2,2,2,2,-2,A
1966-04-09,1965,Portsmouth,Coventry City,2-0,2,0,2,2,2,2,H
1966-04-09,1965,Preston North End,Rotherham United,1-1,1,1,2,2,2,0,D
1966-04-11,1965,Birmingham City,Wolverhampton Wanderers,2-2,2,2,2,2,4,0,D
1966-04-11,1965,Bolton Wanderers,Middlesbrough,6-0,6,0,2,2,6,6,H
1966-04-11,1965,Derby County,Coventry City,1-0,1,0,2,2,1,1,H
1966-04-11,1965,Huddersfield Town,Portsmouth,2-0,2,0,2,2,2,2,H
1966-04-11,1965,Ipswich Town,Leyton Orient,3-2,3,2,2,2,5,1,H
1966-04-11,1965,Norwich City,Rotherham United,1-2,1,2,2,2,3,-1,A
1966-04-11,1965,Plymouth Argyle,Crystal Palace,1-2,1,2,2,2,3,-1,A
1966-04-11,1965,Preston North End,Charlton Athletic,3-3,3,3,2,2,6,0,D
1966-04-11,1965,Southampton,Bristol City,2-2,2,2,2,2,4,0,D
1966-04-12,1965,Bury,Manchester City,2-1,2,1,2,2,3,1,H
1966-04-12,1965,Carlisle United,Cardiff City,2-0,2,0,2,2,2,2,H
1966-04-12,1965,Coventry City,Derby County,3-2,3,2,2,2,5,1,H
1966-04-12,1965,Middlesbrough,Bolton Wanderers,1-1,1,1,2,2,2,0,D
1966-04-12,1965,Rotherham United,Norwich City,2-1,2,1,2,2,3,1,H
1966-04-12,1965,Wolverhampton Wanderers,Birmingham City,2-0,2,0,2,2,2,2,H
1966-04-15,1965,Carlisle United,Leyton Orient,1-0,1,0,2,2,1,1,H
1966-04-16,1965,Bury,Preston North End,5-0,5,0,2,2,5,5,H
1966-04-16,1965,Coventry City,Birmingham City,4-3,4,3,2,2,7,1,H
1966-04-16,1965,Derby County,Huddersfield Town,4-1,4,1,2,2,5,3,H
1966-04-16,1965,Manchester City,Bolton Wanderers,4-1,4,1,2,2,5,3,H
1966-04-16,1965,Norwich City,Charlton Athletic,2-0,2,0,2,2,2,2,H
1966-04-16,1965,Rotherham United,Portsmouth,3-3,3,3,2,2,6,0,D
1966-04-16,1965,Southampton,Crystal Palace,1-0,1,0,2,2,1,1,H
1966-04-16,1965,Wolverhampton Wanderers,Plymouth Argyle,0-0,0,0,2,2,0,0,D
1966-04-18,1965,Leyton Orient,Middlesbrough,2-3,2,3,2,2,5,-1,A
1966-04-19,1965,Bury,Huddersfield Town,0-4,0,4,2,2,4,-4,A
1966-04-19,1965,Preston North End,Bolton Wanderers,0-1,0,1,2,2,1,-1,A
1966-04-20,1965,Southampton,Cardiff City,3-2,3,2,2,2,5,1,H
1966-04-22,1965,Birmingham City,Bristol City,1-3,1,3,2,2,4,-2,A
1966-04-23,1965,Charlton Athletic,Bury,0-1,0,1,2,2,1,-1,A
1966-04-23,1965,Crystal Palace,Derby County,1-1,1,1,2,2,2,0,D
1966-04-23,1965,Huddersfield Town,Cardiff City,1-1,1,1,2,2,2,0,D
1966-04-23,1965,Ipswich Town,Manchester City,1-1,1,1,2,2,2,0,D
1966-04-23,1965,Leyton Orient,Coventry City,1-1,1,1,2,2,2,0,D
1966-04-23,1965,Middlesbrough,Carlisle United,0-2,0,2,2,2,2,-2,A
1966-04-23,1965,Plymouth Argyle,Norwich City,2-0,2,0,2,2,2,2,H
1966-04-23,1965,Portsmouth,Wolverhampton Wanderers,2-0,2,0,2,2,2,2,H
1966-04-23,1965,Preston North End,Southampton,1-1,1,1,2,2,2,0,D
1966-04-25,1965,Bolton Wanderers,Rotherham United,1-3,1,3,2,2,4,-2,A
1966-04-25,1965,Preston North End,Carlisle United,2-1,2,1,2,2,3,1,H
1966-04-26,1965,Charlton Athletic,Coventry City,2-0,2,0,2,2,2,2,H
1966-04-27,1965,Norwich City,Middlesbrough,1-2,1,2,2,2,3,-1,A
1966-04-30,1965,Bristol City,Leyton Orient,2-0,2,0,2,2,2,2,H
1966-04-30,1965,Bury,Plymouth Argyle,1-0,1,0,2,2,1,1,H
1966-04-30,1965,Cardiff City,Crystal Palace,1-0,1,0,2,2,1,1,H
1966-04-30,1965,Carlisle United,Huddersfield Town,2-0,2,0,2,2,2,2,H
1966-04-30,1965,Coventry City,Middlesbrough,2-1,2,1,2,2,3,1,H
1966-04-30,1965,Derby County,Preston North End,1-0,1,0,2,2,1,1,H
1966-04-30,1965,Manchester City,Birmingham City,3-1,3,1,2,2,4,2,H
1966-04-30,1965,Norwich City,Portsmouth,1-3,1,3,2,2,4,-2,A
1966-04-30,1965,Rotherham United,Ipswich Town,0-0,0,0,2,2,0,0,D
1966-04-30,1965,Southampton,Charlton Athletic,1-0,1,0,2,2,1,1,H
1966-04-30,1965,Wolverhampton Wanderers,Bolton Wanderers,3-1,3,1,2,2,4,2,H
1966-05-03,1965,Birmingham City,Ipswich Town,4-1,4,1,2,2,5,3,H
1966-05-03,1965,Bristol City,Charlton Athletic,0-0,0,0,2,2,0,0,D
1966-05-03,1965,Cardiff City,Middlesbrough,5-3,5,3,2,2,8,2,H
1966-05-04,1965,Bolton Wanderers,Carlisle United,4-0,4,0,2,2,4,4,H
1966-05-04,1965,Rotherham United,Manchester City,0-1,0,1,2,2,1,-1,A
1966-05-07,1965,Birmingham City,Rotherham United,3-0,3,0,2,2,3,3,H
1966-05-07,1965,Bolton Wanderers,Norwich City,1-1,1,1,2,2,2,0,D
1966-05-07,1965,Charlton Athletic,Derby County,2-2,2,2,2,2,4,0,D
1966-05-07,1965,Crystal Palace,Carlisle United,2-0,2,0,2,2,2,2,H
1966-05-07,1965,Huddersfield Town,Coventry City,0-2,0,2,2,2,2,-2,A
1966-05-07,1965,Ipswich Town,Wolverhampton Wanderers,5-2,5,2,2,2,7,3,H
1966-05-07,1965,Leyton Orient,Manchester City,2-2,2,2,2,2,4,0,D
1966-05-07,1965,Plymouth Argyle,Southampton,2-3,2,3,2,2,5,-1,A
1966-05-07,1965,Portsmouth,Bury,4-0,4,0,2,2,4,4,H
1966-05-07,1965,Preston North End,Cardiff City,9-0,9,0,2,2,9,9,H
1966-05-09,1965,Leyton Orient,Southampton,1-1,1,1,2,2,2,0,D
1966-05-09,1965,Rotherham United,Charlton Athletic,0-0,0,0,2,2,0,0,D
1966-05-10,1965,Bristol City,Ipswich Town,4-1,4,1,2,2,5,3,H
1966-05-10,1965,Bury,Carlisle United,2-1,2,1,2,2,3,1,H
1966-05-10,1965,Cardiff City,Norwich City,0-2,0,2,2,2,2,-2,A
1966-05-12,1965,Rotherham United,Carlisle United,3-3,3,3,2,2,6,0,D
1966-05-13,1965,Charlton Athletic,Manchester City,2-3,2,3,2,2,5,-1,A
1966-05-18,1965,Charlton Athletic,Norwich City,2-1,2,1,2,2,3,1,H
1966-05-18,1965,Manchester City,Southampton,0-0,0,0,2,2,0,0,D
1966-08-20,1966,Bury,Plymouth Argyle,1-0,1,0,2,2,1,1,H
1966-08-20,1966,Cardiff City,Ipswich Town,0-2,0,2,2,2,2,-2,A
1966-08-20,1966,Charlton Athletic,Bolton Wanderers,0-1,0,1,2,2,1,-1,A
1966-08-20,1966,Coventry City,Hull City,1-0,1,0,2,2,1,1,H
1966-08-20,1966,Crystal Palace,Carlisle United,4-2,4,2,2,2,6,2,H
1966-08-20,1966,Derby County,Blackburn Rovers,2-3,2,3,2,2,5,-1,A
1966-08-20,1966,Huddersfield Town,Bristol City,2-0,2,0,2,2,2,2,H
1966-08-20,1966,Norwich City,Portsmouth,0-0,0,0,2,2,0,0,D
1966-08-20,1966,Preston North End,Northampton Town,2-1,2,1,2,2,3,1,H
1966-08-20,1966,Rotherham United,Millwall,3-1,3,1,2,2,4,2,H
1966-08-20,1966,Wolverhampton Wanderers,Birmingham City,1-2,1,2,2,2,3,-1,A
1966-08-23,1966,Bristol City,Crystal Palace,0-1,0,1,2,2,1,-1,A
1966-08-23,1966,Carlisle United,Derby County,0-0,0,0,2,2,0,0,D
1966-08-23,1966,Ipswich Town,Huddersfield Town,3-0,3,0,2,2,3,3,H
1966-08-24,1966,Blackburn Rovers,Charlton Athletic,2-1,2,1,2,2,3,1,H
1966-08-24,1966,Bolton Wanderers,Rotherham United,2-2,2,2,2,2,4,0,D
1966-08-24,1966,Plymouth Argyle,Coventry City,4-2,4,2,2,2,6,2,H
1966-08-24,1966,Portsmouth,Birmingham City,4-5,4,5,2,2,9,-1,A
1966-08-27,1966,Birmingham City,Norwich City,2-1,2,1,2,2,3,1,H
1966-08-27,1966,Blackburn Rovers,Crystal Palace,2-1,2,1,2,2,3,1,H
1966-08-27,1966,Bolton Wanderers,Derby County,3-1,3,1,2,2,4,2,H
1966-08-27,1966,Bristol City,Cardiff City,1-2,1,2,2,2,3,-1,A
1966-08-27,1966,Carlisle United,Huddersfield Town,2-1,2,1,2,2,3,1,H
1966-08-27,1966,Hull City,Bury,2-0,2,0,2,2,2,2,H
1966-08-27,1966,Ipswich Town,Wolverhampton Wanderers,3-1,3,1,2,2,4,2,H
1966-08-27,1966,Millwall,Charlton Athletic,0-0,0,0,2,2,0,0,D
1966-08-27,1966,Northampton Town,Rotherham United,3-1,3,1,2,2,4,2,H
1966-08-27,1966,Plymouth Argyle,Preston North End,1-0,1,0,2,2,1,1,H
1966-08-27,1966,Portsmouth,Coventry City,0-2,0,2,2,2,2,-2,A
1966-08-30,1966,Birmingham City,Portsmouth,3-0,3,0,2,2,3,3,H
1966-08-30,1966,Charlton Athletic,Blackburn Rovers,0-0,0,0,2,2,0,0,D
1966-08-30,1966,Coventry City,Plymouth Argyle,1-0,1,0,2,2,1,1,H
1966-08-30,1966,Huddersfield Town,Ipswich Town,1-0,1,0,2,2,1,1,H
1966-08-30,1966,Northampton Town,Bury,0-0,0,0,2,2,0,0,D
1966-08-30,1966,Rotherham United,Bolton Wanderers,0-1,0,1,2,2,1,-1,A
1966-08-31,1966,Cardiff City,Wolverhampton Wanderers,0-3,0,3,2,2,3,-3,A
1966-08-31,1966,Crystal Palace,Bristol City,2-1,2,1,2,2,3,1,H
1966-08-31,1966,Derby County,Carlisle United,0-1,0,1,2,2,1,-1,A
1966-08-31,1966,Norwich City,Hull City,0-2,0,2,2,2,2,-2,A
1966-09-03,1966,Bury,Portsmouth,1-3,1,3,2,2,4,-2,A
1966-09-03,1966,Cardiff City,Carlisle United,4-2,4,2,2,2,6,2,H
1966-09-03,1966,Coventry City,Birmingham City,1-1,1,1,2,2,2,0,D
1966-09-03,1966,Crystal Palace,Bolton Wanderers,3-2,3,2,2,2,5,1,H
1966-09-03,1966,Derby County,Charlton Athletic,0-2,0,2,2,2,2,-2,A
1966-09-03,1966,Huddersfield Town,Blackburn Rovers,3-1,3,1,2,2,4,2,H
1966-09-03,1966,Millwall,Northampton Town,1-0,1,0,2,2,1,1,H
1966-09-03,1966,Norwich City,Ipswich Town,1-2,1,2,2,2,3,-1,A
1966-09-03,1966,Preston North End,Hull City,4-2,4,2,2,2,6,2,H
1966-09-03,1966,Rotherham United,Plymouth Argyle,4-2,4,2,2,2,6,2,H
1966-09-03,1966,Wolverhampton Wanderers,Bristol City,1-1,1,1,2,2,2,0,D
1966-09-05,1966,Millwall,Coventry City,1-0,1,0,2,2,1,1,H
1966-09-06,1966,Bristol City,Charlton Athletic,4-0,4,0,2,2,4,4,H
1966-09-06,1966,Bury,Rotherham United,5-2,5,2,2,2,7,3,H
1966-09-06,1966,Ipswich Town,Derby County,4-3,4,3,2,2,7,1,H
1966-09-06,1966,Northampton Town,Norwich City,1-2,1,2,2,2,3,-1,A
1966-09-07,1966,Blackburn Rovers,Preston North End,2-0,2,0,2,2,2,2,H
1966-09-07,1966,Bolton Wanderers,Carlisle United,3-0,3,0,2,2,3,3,H
1966-09-07,1966,Cardiff City,Huddersfield Town,1-1,1,1,2,2,2,0,D
1966-09-07,1966,Plymouth Argyle,Birmingham City,1-1,1,1,2,2,2,0,D
1966-09-07,1966,Portsmouth,Hull City,0-1,0,1,2,2,1,-1,A
1966-09-07,1966,Wolverhampton Wanderers,Crystal Palace,1-1,1,1,2,2,2,0,D
1966-09-10,1966,Birmingham City,Bury,1-3,1,3,2,2,4,-2,A
1966-09-10,1966,Blackburn Rovers,Cardiff City,4-1,4,1,2,2,5,3,H
1966-09-10,1966,Bolton Wanderers,Huddersfield Town,1-0,1,0,2,2,1,1,H
1966-09-10,1966,Bristol City,Ipswich Town,1-1,1,1,2,2,2,0,D
1966-09-10,1966,Carlisle United,Wolverhampton Wanderers,1-3,1,3,2,2,4,-2,A
1966-09-10,1966,Charlton Athletic,Crystal Palace,1-1,1,1,2,2,2,0,D
1966-09-10,1966,Hull City,Rotherham United,1-0,1,0,2,2,1,1,H
1966-09-10,1966,Northampton Town,Derby County,0-2,0,2,2,2,2,-2,A
1966-09-10,1966,Norwich City,Coventry City,1-1,1,1,2,2,2,0,D
1966-09-10,1966,Plymouth Argyle,Millwall,3-1,3,1,2,2,4,2,H
1966-09-10,1966,Portsmouth,Preston North End,2-0,2,0,2,2,2,2,H
1966-09-17,1966,Bury,Norwich City,2-0,2,0,2,2,2,2,H
1966-09-17,1966,Cardiff City,Bolton Wanderers,2-5,2,5,2,2,7,-3,A
1966-09-17,1966,Coventry City,Bristol City,1-0,1,0,2,2,1,1,H
1966-09-17,1966,Crystal Palace,Derby County,2-1,2,1,2,2,3,1,H
1966-09-17,1966,Huddersfield Town,Charlton Athletic,4-1,4,1,2,2,5,3,H
1966-09-17,1966,Ipswich Town,Carlisle United,1-2,1,2,2,2,3,-1,A
1966-09-17,1966,Millwall,Hull City,2-1,2,1,2,2,3,1,H
1966-09-17,1966,Northampton Town,Plymouth Argyle,2-1,2,1,2,2,3,1,H
1966-09-17,1966,Preston North End,Birmingham City,3-0,3,0,2,2,3,3,H
1966-09-17,1966,Rotherham United,Portsmouth,0-1,0,1,2,2,1,-1,A
1966-09-17,1966,Wolverhampton Wanderers,Blackburn Rovers,4-0,4,0,2,2,4,4,H
1966-09-19,1966,Millwall,Preston North End,2-0,2,0,2,2,2,2,H
1966-09-20,1966,Bury,Northampton Town,1-2,1,2,2,2,3,-1,A
1966-09-20,1966,Hull City,Norwich City,5-0,5,0,2,2,5,5,H
1966-09-21,1966,Wolverhampton Wanderers,Cardiff City,7-1,7,1,2,2,8,6,H
1966-09-23,1966,Hull City,Northampton Town,6-1,6,1,2,2,7,5,H
1966-09-24,1966,Birmingham City,Rotherham United,2-3,2,3,2,2,5,-1,A
1966-09-24,1966,Blackburn Rovers,Ipswich Town,1-2,1,2,2,2,3,-1,A
1966-09-24,1966,Bolton Wanderers,Wolverhampton Wanderers,0-0,0,0,2,2,0,0,D
1966-09-24,1966,Carlisle United,Bristol City,2-1,2,1,2,2,3,1,H
1966-09-24,1966,Charlton Athletic,Cardiff City,5-0,5,0,2,2,5,5,H
1966-09-24,1966,Coventry City,Bury,3-0,3,0,2,2,3,3,H
1966-09-24,1966,Derby County,Huddersfield Town,4-3,4,3,2,2,7,1,H
1966-09-24,1966,Norwich City,Preston North End,1-1,1,1,2,2,2,0,D
1966-09-24,1966,Plymouth Argyle,Crystal Palace,1-0,1,0,2,2,1,1,H
1966-09-24,1966,Portsmouth,Millwall,0-1,0,1,2,2,1,-1,A
1966-09-26,1966,Preston North End,Blackburn Rovers,3-0,3,0,2,2,3,3,H
1966-09-27,1966,Birmingham City,Plymouth Argyle,0-0,0,0,2,2,0,0,D
1966-09-27,1966,Carlisle United,Norwich City,1-0,1,0,2,2,1,1,H
1966-09-27,1966,Charlton Athletic,Bristol City,5-0,5,0,2,2,5,5,H
1966-09-28,1966,Derby County,Ipswich Town,2-2,2,2,2,2,4,0,D
1966-09-28,1966,Hull City,Portsmouth,2-0,2,0,2,2,2,2,H
1966-10-01,1966,Bristol City,Blackburn Rovers,2-2,2,2,2,2,4,0,D
1966-10-01,1966,Bury,Carlisle United,0-2,0,2,2,2,2,-2,A
1966-10-01,1966,Cardiff City,Derby County,1-1,1,1,2,2,2,0,D
1966-10-01,1966,Huddersfield Town,Crystal Palace,0-2,0,2,2,2,2,-2,A
1966-10-01,1966,Ipswich Town,Bolton Wanderers,2-2,2,2,2,2,4,0,D
1966-10-01,1966,Millwall,Birmingham City,3-1,3,1,2,2,4,2,H
1966-10-01,1966,Northampton Town,Portsmouth,2-4,2,4,2,2,6,-2,A
1966-10-01,1966,Plymouth Argyle,Hull City,3-1,3,1,2,2,4,2,H
1966-10-01,1966,Preston North End,Coventry City,3-2,3,2,2,2,5,1,H
1966-10-01,1966,Rotherham United,Norwich City,2-1,2,1,2,2,3,1,H
1966-10-01,1966,Wolverhampton Wanderers,Charlton Athletic,1-0,1,0,2,2,1,1,H
1966-10-08,1966,Blackburn Rovers,Bury,2-1,2,1,2,2,3,1,H
1966-10-08,1966,Bolton Wanderers,Preston North End,4-2,4,2,2,2,6,2,H
1966-10-08,1966,Bristol City,Norwich City,1-0,1,0,2,2,1,1,H
1966-10-08,1966,Cardiff City,Hull City,2-4,2,4,2,2,6,-2,A
1966-10-08,1966,Carlisle United,Coventry City,2-1,2,1,2,2,3,1,H
1966-10-08,1966,Charlton Athletic,Rotherham United,2-0,2,0,2,2,2,2,H
1966-10-08,1966,Crystal Palace,Northampton Town,5-1,5,1,2,2,6,4,H
1966-10-08,1966,Derby County,Millwall,5-1,5,1,2,2,6,4,H
1966-10-08,1966,Huddersfield Town,Plymouth Argyle,1-1,1,1,2,2,2,0,D
1966-10-08,1966,Ipswich Town,Birmingham City,3-2,3,2,2,2,5,1,H
1966-10-08,1966,Wolverhampton Wanderers,Portsmouth,3-1,3,1,2,2,4,2,H
1966-10-14,1966,Bury,Bolton Wanderers,2-1,2,1,2,2,3,1,H
1966-10-15,1966,Birmingham City,Bristol City,4-0,4,0,2,2,4,4,H
1966-10-15,1966,Coventry City,Blackburn Rovers,2-0,2,0,2,2,2,2,H
1966-10-15,1966,Hull City,Wolverhampton Wanderers,3-1,3,1,2,2,4,2,H
1966-10-15,1966,Millwall,Crystal Palace,1-1,1,1,2,2,2,0,D
1966-10-15,1966,Northampton Town,Huddersfield Town,0-1,0,1,2,2,1,-1,A
1966-10-15,1966,Norwich City,Carlisle United,2-0,2,0,2,2,2,2,H
1966-10-15,1966,Plymouth Argyle,Cardiff City,7-1,7,1,2,2,8,6,H
1966-10-15,1966,Portsmouth,Ipswich Town,4-2,4,2,2,2,6,2,H
1966-10-15,1966,Preston North End,Charlton Athletic,2-1,2,1,2,2,3,1,H
1966-10-15,1966,Rotherham United,Derby County,0-0,0,0,2,2,0,0,D
1966-10-21,1966,Bristol City,Portsmouth,3-3,3,3,2,2,6,0,D
1966-10-22,1966,Blackburn Rovers,Norwich City,0-0,0,0,2,2,0,0,D
1966-10-22,1966,Bolton Wanderers,Coventry City,1-1,1,1,2,2,2,0,D
1966-10-22,1966,Carlisle United,Birmingham City,2-0,2,0,2,2,2,2,H
1966-10-22,1966,Charlton Athletic,Bury,4-0,4,0,2,2,4,4,H
1966-10-22,1966,Crystal Palace,Rotherham United,1-1,1,1,2,2,2,0,D
1966-10-22,1966,Derby County,Preston North End,5-1,5,1,2,2,6,4,H
1966-10-22,1966,Huddersfield Town,Millwall,2-0,2,0,2,2,2,2,H
1966-10-22,1966,Ipswich Town,Hull City,5-4,5,4,2,2,9,1,H
1966-10-22,1966,Wolverhampton Wanderers,Plymouth Argyle,2-1,2,1,2,2,3,1,H
1966-10-24,1966,Preston North End,Millwall,2-1,2,1,2,2,3,1,H
1966-10-29,1966,Birmingham City,Blackburn Rovers,1-1,1,1,2,2,2,0,D
1966-10-29,1966,Bury,Derby County,2-2,2,2,2,2,4,0,D
1966-10-29,1966,Coventry City,Charlton Athletic,1-0,1,0,2,2,1,1,H
1966-10-29,1966,Hull City,Bristol City,0-2,0,2,2,2,2,-2,A
1966-10-29,1966,Millwall,Cardiff City,1-0,1,0,2,2,1,1,H
1966-10-29,1966,Northampton Town,Wolverhampton Wanderers,0-4,0,4,2,2,4,-4,A
1966-10-29,1966,Norwich City,Bolton Wanderers,1-0,1,0,2,2,1,1,H
1966-10-29,1966,Plymouth Argyle,Ipswich Town,1-1,1,1,2,2,2,0,D
1966-10-29,1966,Portsmouth,Carlisle United,2-1,2,1,2,2,3,1,H
1966-10-29,1966,Preston North End,Crystal Palace,1-0,1,0,2,2,1,1,H
1966-10-29,1966,Rotherham United,Huddersfield Town,4-2,4,2,2,2,6,2,H
1966-11-04,1966,Cardiff City,Rotherham United,0-0,0,0,2,2,0,0,D
1966-11-05,1966,Blackburn Rovers,Portsmouth,2-2,2,2,2,2,4,0,D
1966-11-05,1966,Bolton Wanderers,Birmingham City,3-1,3,1,2,2,4,2,H
1966-11-05,1966,Bristol City,Plymouth Argyle,1-0,1,0,2,2,1,1,H
1966-11-05,1966,Carlisle United,Hull City,2-0,2,0,2,2,2,2,H
1966-11-05,1966,Charlton Athletic,Norwich City,0-0,0,0,2,2,0,0,D
1966-11-05,1966,Crystal Palace,Bury,3-1,3,1,2,2,4,2,H
1966-11-05,1966,Derby County,Coventry City,1-2,1,2,2,2,3,-1,A
1966-11-05,1966,Huddersfield Town,Preston North End,1-0,1,0,2,2,1,1,H
1966-11-05,1966,Ipswich Town,Northampton Town,6-1,6,1,2,2,7,5,H
1966-11-05,1966,Wolverhampton Wanderers,Millwall,2-0,2,0,2,2,2,2,H
1966-11-12,1966,Birmingham City,Charlton Athletic,4-0,4,0,2,2,4,4,H
1966-11-12,1966,Bury,Huddersfield Town,0-0,0,0,2,2,0,0,D
1966-11-12,1966,Coventry City,Crystal Palace,1-2,1,2,2,2,3,-1,A
1966-11-12,1966,Hull City,Blackburn Rovers,2-3,2,3,2,2,5,-1,A
1966-11-12,1966,Millwall,Ipswich Town,1-0,1,0,2,2,1,1,H
1966-11-12,1966,Northampton Town,Bristol City,2-1,2,1,2,2,3,1,H
1966-11-12,1966,Norwich City,Derby County,4-1,4,1,2,2,5,3,H
1966-11-12,1966,Plymouth Argyle,Carlisle United,1-2,1,2,2,2,3,-1,A
1966-11-12,1966,Portsmouth,Bolton Wanderers,2-1,2,1,2,2,3,1,H
1966-11-12,1966,Preston North End,Cardiff City,4-0,4,0,2,2,4,4,H
1966-11-12,1966,Rotherham United,Wolverhampton Wanderers,2-2,2,2,2,2,4,0,D
1966-11-19,1966,Blackburn Rovers,Plymouth Argyle,3-0,3,0,2,2,3,3,H
1966-11-19,1966,Bolton Wanderers,Hull City,2-1,2,1,2,2,3,1,H
1966-11-19,1966,Bristol City,Millwall,1-1,1,1,2,2,2,0,D
1966-11-19,1966,Cardiff City,Bury,3-0,3,0,2,2,3,3,H
1966-11-19,1966,Carlisle United,Northampton Town,2-0,2,0,2,2,2,2,H
1966-11-19,1966,Charlton Athletic,Portsmouth,0-2,0,2,2,2,2,-2,A
1966-11-19,1966,Crystal Palace,Norwich City,0-0,0,0,2,2,0,0,D
1966-11-19,1966,Derby County,Birmingham City,1-2,1,2,2,2,3,-1,A
1966-11-19,1966,Huddersfield Town,Coventry City,3-1,3,1,2,2,4,2,H
1966-11-19,1966,Ipswich Town,Rotherham United,3-2,3,2,2,2,5,1,H
1966-11-19,1966,Wolverhampton Wanderers,Preston North End,3-2,3,2,2,2,5,1,H
1966-11-26,1966,Birmingham City,Crystal Palace,3-1,3,1,2,2,4,2,H
1966-11-26,1966,Bury,Wolverhampton Wanderers,2-1,2,1,2,2,3,1,H
1966-11-26,1966,Coventry City,Cardiff City,3-2,3,2,2,2,5,1,H
1966-11-26,1966,Hull City,Charlton Athletic,2-2,2,2,2,2,4,0,D
1966-11-26,1966,Millwall,Carlisle United,2-1,2,1,2,2,3,1,H
1966-11-26,1966,Northampton Town,Blackburn Rovers,2-1,2,1,2,2,3,1,H
1966-11-26,1966,Norwich City,Huddersfield Town,0-0,0,0,2,2,0,0,D
1966-11-26,1966,Plymouth Argyle,Bolton Wanderers,2-0,2,0,2,2,2,2,H
1966-11-26,1966,Portsmouth,Derby County,0-3,0,3,2,2,3,-3,A
1966-11-26,1966,Preston North End,Ipswich Town,2-0,2,0,2,2,2,2,H
1966-11-26,1966,Rotherham United,Bristol City,3-3,3,3,2,2,6,0,D
1966-12-03,1966,Blackburn Rovers,Millwall,1-0,1,0,2,2,1,1,H
1966-12-03,1966,Bolton Wanderers,Northampton Town,1-2,1,2,2,2,3,-1,A
1966-12-03,1966,Bristol City,Preston North End,2-0,2,0,2,2,2,2,H
1966-12-03,1966,Cardiff City,Norwich City,2-0,2,0,2,2,2,2,H
1966-12-03,1966,Carlisle United,Rotherham United,2-3,2,3,2,2,5,-1,A
1966-12-03,1966,Charlton Athletic,Plymouth Argyle,1-0,1,0,2,2,1,1,H
1966-12-03,1966,Crystal Palace,Portsmouth,0-2,0,2,2,2,2,-2,A
1966-12-03,1966,Derby County,Hull City,2-3,2,3,2,2,5,-1,A
1966-12-03,1966,Huddersfield Town,Birmingham City,3-1,3,1,2,2,4,2,H
1966-12-03,1966,Ipswich Town,Bury,2-0,2,0,2,2,2,2,H
1966-12-03,1966,Wolverhampton Wanderers,Coventry City,1-3,1,3,2,2,4,-2,A
1966-12-09,1966,Coventry City,Ipswich Town,5-0,5,0,2,2,5,5,H
1966-12-10,1966,Birmingham City,Cardiff City,1-2,1,2,2,2,3,-1,A
1966-12-10,1966,Bury,Bristol City,2-1,2,1,2,2,3,1,H
1966-12-10,1966,Hull City,Crystal Palace,6-1,6,1,2,2,7,5,H
1966-12-10,1966,Millwall,Bolton Wanderers,2-0,2,0,2,2,2,2,H
1966-12-10,1966,Norwich City,Wolverhampton Wanderers,1-2,1,2,2,2,3,-1,A
1966-12-10,1966,Plymouth Argyle,Derby County,1-2,1,2,2,2,3,-1,A
1966-12-10,1966,Portsmouth,Huddersfield Town,1-1,1,1,2,2,2,0,D
1966-12-10,1966,Preston North End,Carlisle United,2-3,2,3,2,2,5,-1,A
1966-12-10,1966,Rotherham United,Blackburn Rovers,2-1,2,1,2,2,3,1,H
1966-12-14,1966,Cardiff City,Northampton Town,4-2,4,2,2,2,6,2,H
1966-12-17,1966,Birmingham City,Wolverhampton Wanderers,3-2,3,2,2,2,5,1,H
1966-12-17,1966,Blackburn Rovers,Derby County,0-0,0,0,2,2,0,0,D
1966-12-17,1966,Bolton Wanderers,Charlton Athletic,2-1,2,1,2,2,3,1,H
1966-12-17,1966,Bristol City,Huddersfield Town,1-1,1,1,2,2,2,0,D
1966-12-17,1966,Carlisle United,Crystal Palace,3-0,3,0,2,2,3,3,H
1966-12-17,1966,Hull City,Coventry City,2-2,2,2,2,2,4,0,D
1966-12-17,1966,Ipswich Town,Cardiff City,0-0,0,0,2,2,0,0,D
1966-12-17,1966,Millwall,Rotherham United,2-0,2,0,2,2,2,2,H
1966-12-17,1966,Northampton Town,Preston North End,1-5,1,5,2,2,6,-4,A
1966-12-17,1966,Plymouth Argyle,Bury,4-1,4,1,2,2,5,3,H
1966-12-17,1966,Portsmouth,Norwich City,3-3,3,3,2,2,6,0,D
1966-12-20,1966,Charlton Athletic,Ipswich Town,2-1,2,1,2,2,3,1,H
1966-12-24,1966,Preston North End,Bury,2-2,2,2,2,2,4,0,D
1966-12-24,1966,Wolverhampton Wanderers,Derby County,5-3,5,3,2,2,8,2,H
1966-12-26,1966,Birmingham City,Northampton Town,3-0,3,0,2,2,3,3,H
1966-12-26,1966,Bristol City,Bolton Wanderers,1-1,1,1,2,2,2,0,D
1966-12-26,1966,Cardiff City,Crystal Palace,1-2,1,2,2,2,3,-1,A
1966-12-26,1966,Carlisle United,Blackburn Rovers,1-2,1,2,2,2,3,-1,A
1966-12-26,1966,Coventry City,Rotherham United,4-2,4,2,2,2,6,2,H
1966-12-26,1966,Derby County,Wolverhampton Wanderers,0-3,0,3,2,2,3,-3,A
1966-12-26,1966,Hull City,Huddersfield Town,2-0,2,0,2,2,2,2,H
1966-12-26,1966,Ipswich Town,Charlton Athletic,0-0,0,0,2,2,0,0,D
1966-12-26,1966,Millwall,Norwich City,2-1,2,1,2,2,3,1,H
1966-12-26,1966,Portsmouth,Plymouth Argyle,2-1,2,1,2,2,3,1,H
1966-12-27,1966,Blackburn Rovers,Carlisle United,2-0,2,0,2,2,2,2,H
1966-12-27,1966,Bury,Preston North End,3-4,3,4,2,2,7,-1,A
1966-12-27,1966,Crystal Palace,Cardiff City,3-1,3,1,2,2,4,2,H
1966-12-27,1966,Huddersfield Town,Hull City,1-0,1,0,2,2,1,1,H
1966-12-27,1966,Northampton Town,Birmingham City,2-1,2,1,2,2,3,1,H
1966-12-27,1966,Norwich City,Millwall,1-1,1,1,2,2,2,0,D
1966-12-27,1966,Plymouth Argyle,Portsmouth,0-0,0,0,2,2,0,0,D
1966-12-27,1966,Rotherham United,Coventry City,1-1,1,1,2,2,2,0,D
1966-12-31,1966,Bury,Hull City,3-2,3,2,2,2,5,1,H
1966-12-31,1966,Cardiff City,Bristol City,5-1,5,1,2,2,6,4,H
1966-12-31,1966,Charlton Athletic,Millwall,0-0,0,0,2,2,0,0,D
1966-12-31,1966,Coventry City,Portsmouth,5-1,5,1,2,2,6,4,H
1966-12-31,1966,Crystal Palace,Blackburn Rovers,2-1,2,1,2,2,3,1,H
1966-12-31,1966,Derby County,Bolton Wanderers,2-2,2,2,2,2,4,0,D
1966-12-31,1966,Huddersfield Town,Carlisle United,1-1,1,1,2,2,2,0,D
1966-12-31,1966,Norwich City,Birmingham City,3-3,3,3,2,2,6,0,D
1966-12-31,1966,Preston North End,Plymouth Argyle,2-0,2,0,2,2,2,2,H
1966-12-31,1966,Rotherham United,Northampton Town,1-2,1,2,2,2,3,-1,A
1966-12-31,1966,Wolverhampton Wanderers,Ipswich Town,0-0,0,0,2,2,0,0,D
1967-01-07,1966,Birmingham City,Coventry City,1-1,1,1,2,2,2,0,D
1967-01-07,1966,Bristol City,Wolverhampton Wanderers,1-0,1,0,2,2,1,1,H
1967-01-07,1966,Carlisle United,Cardiff City,3-0,3,0,2,2,3,3,H
1967-01-07,1966,Charlton Athletic,Derby County,3-1,3,1,2,2,4,2,H
1967-01-07,1966,Hull City,Preston North End,2-2,2,2,2,2,4,0,D
1967-01-07,1966,Northampton Town,Millwall,1-2,1,2,2,2,3,-1,A
1967-01-07,1966,Plymouth Argyle,Rotherham United,1-0,1,0,2,2,1,1,H
1967-01-07,1966,Portsmouth,Bury,1-2,1,2,2,2,3,-1,A
1967-01-14,1966,Bury,Birmingham City,0-2,0,2,2,2,2,-2,A
1967-01-14,1966,Cardiff City,Blackburn Rovers,1-1,1,1,2,2,2,0,D
1967-01-14,1966,Coventry City,Norwich City,2-1,2,1,2,2,3,1,H
1967-01-14,1966,Crystal Palace,Charlton Athletic,1-0,1,0,2,2,1,1,H
1967-01-14,1966,Derby County,Northampton Town,4-3,4,3,2,2,7,1,H
1967-01-14,1966,Huddersfield Town,Bolton Wanderers,2-1,2,1,2,2,3,1,H
1967-01-14,1966,Ipswich Town,Bristol City,0-0,0,0,2,2,0,0,D
1967-01-14,1966,Millwall,Plymouth Argyle,1-2,1,2,2,2,3,-1,A
1967-01-14,1966,Preston North End,Portsmouth,1-0,1,0,2,2,1,1,H
1967-01-14,1966,Rotherham United,Hull City,1-1,1,1,2,2,2,0,D
1967-01-14,1966,Wolverhampton Wanderers,Carlisle United,1-1,1,1,2,2,2,0,D
1967-01-17,1966,Northampton Town,Charlton Athletic,1-1,1,1,2,2,2,0,D
1967-01-21,1966,Birmingham City,Preston North End,3-1,3,1,2,2,4,2,H
1967-01-21,1966,Blackburn Rovers,Wolverhampton Wanderers,0-0,0,0,2,2,0,0,D
1967-01-21,1966,Bolton Wanderers,Cardiff City,3-1,3,1,2,2,4,2,H
1967-01-21,1966,Bristol City,Coventry City,2-2,2,2,2,2,4,0,D
1967-01-21,1966,Carlisle United,Ipswich Town,2-1,2,1,2,2,3,1,H
1967-01-21,1966,Charlton Athletic,Huddersfield Town,1-2,1,2,2,2,3,-1,A
1967-01-21,1966,Derby County,Crystal Palace,2-0,2,0,2,2,2,2,H
1967-01-21,1966,Hull City,Millwall,2-0,2,0,2,2,2,2,H
1967-01-21,1966,Norwich City,Bury,2-0,2,0,2,2,2,2,H
1967-01-21,1966,Plymouth Argyle,Northampton Town,1-0,1,0,2,2,1,1,H
1967-01-21,1966,Portsmouth,Rotherham United,3-2,3,2,2,2,5,1,H
1967-02-03,1966,Cardiff City,Charlton Athletic,4-1,4,1,2,2,5,3,H
1967-02-04,1966,Bristol City,Carlisle United,3-0,3,0,2,2,3,3,H
1967-02-04,1966,Bury,Coventry City,0-1,0,1,2,2,1,-1,A
1967-02-04,1966,Crystal Palace,Plymouth Argyle,2-1,2,1,2,2,3,1,H
1967-02-04,1966,Huddersfield Town,Derby County,1-0,1,0,2,2,1,1,H
1967-02-04,1966,Ipswich Town,Blackburn Rovers,1-1,1,1,2,2,2,0,D
1967-02-04,1966,Millwall,Portsmouth,1-1,1,1,2,2,2,0,D
1967-02-04,1966,Northampton Town,Hull City,2-2,2,2,2,2,4,0,D
1967-02-04,1966,Preston North End,Norwich City,3-1,3,1,2,2,4,2,H
1967-02-04,1966,Rotherham United,Birmingham City,3-2,3,2,2,2,5,1,H
1967-02-04,1966,Wolverhampton Wanderers,Bolton Wanderers,5-2,5,2,2,2,7,3,H
1967-02-11,1966,Birmingham City,Millwall,2-0,2,0,2,2,2,2,H
1967-02-11,1966,Blackburn Rovers,Bristol City,1-0,1,0,2,2,1,1,H
1967-02-11,1966,Bolton Wanderers,Ipswich Town,1-1,1,1,2,2,2,0,D
1967-02-11,1966,Carlisle United,Bury,2-0,2,0,2,2,2,2,H
1967-02-11,1966,Charlton Athletic,Wolverhampton Wanderers,1-3,1,3,2,2,4,-2,A
1967-02-11,1966,Coventry City,Preston North End,2-1,2,1,2,2,3,1,H
1967-02-11,1966,Crystal Palace,Huddersfield Town,1-1,1,1,2,2,2,0,D
1967-02-11,1966,Derby County,Cardiff City,1-1,1,1,2,2,2,0,D
1967-02-11,1966,Hull City,Plymouth Argyle,4-2,4,2,2,2,6,2,H
1967-02-11,1966,Norwich City,Rotherham United,1-0,1,0,2,2,1,1,H
1967-02-11,1966,Portsmouth,Northampton Town,3-2,3,2,2,2,5,1,H
1967-02-18,1966,Blackburn Rovers,Huddersfield Town,2-0,2,0,2,2,2,2,H
1967-02-18,1966,Charlton Athletic,Coventry City,1-2,1,2,2,2,3,-1,A
1967-02-25,1966,Birmingham City,Ipswich Town,2-2,2,2,2,2,4,0,D
1967-02-25,1966,Bury,Blackburn Rovers,1-2,1,2,2,2,3,-1,A
1967-02-25,1966,Coventry City,Carlisle United,2-1,2,1,2,2,3,1,H
1967-02-25,1966,Hull City,Cardiff City,1-0,1,0,2,2,1,1,H
1967-02-25,1966,Millwall,Derby County,3-2,3,2,2,2,5,1,H
1967-02-25,1966,Northampton Town,Crystal Palace,1-0,1,0,2,2,1,1,H
1967-02-25,1966,Norwich City,Bristol City,1-0,1,0,2,2,1,1,H
1967-02-25,1966,Plymouth Argyle,Huddersfield Town,2-3,2,3,2,2,5,-1,A
1967-02-25,1966,Portsmouth,Wolverhampton Wanderers,2-3,2,3,2,2,5,-1,A
1967-02-25,1966,Preston North End,Bolton Wanderers,1-3,1,3,2,2,4,-2,A
1967-02-25,1966,Rotherham United,Charlton Athletic,2-0,2,0,2,2,2,2,H
1967-03-04,1966,Blackburn Rovers,Birmingham City,1-0,1,0,2,2,1,1,H
1967-03-04,1966,Bolton Wanderers,Norwich City,1-1,1,1,2,2,2,0,D
1967-03-04,1966,Bristol City,Hull City,2-1,2,1,2,2,3,1,H
1967-03-04,1966,Cardiff City,Millwall,1-1,1,1,2,2,2,0,D
1967-03-04,1966,Carlisle United,Portsmouth,5-1,5,1,2,2,6,4,H
1967-03-04,1966,Derby County,Bury,3-1,3,1,2,2,4,2,H
1967-03-04,1966,Huddersfield Town,Rotherham United,3-0,3,0,2,2,3,3,H
1967-03-04,1966,Ipswich Town,Plymouth Argyle,1-1,1,1,2,2,2,0,D
1967-03-04,1966,Wolverhampton Wanderers,Northampton Town,1-0,1,0,2,2,1,1,H
1967-03-07,1966,Crystal Palace,Preston North End,1-0,1,0,2,2,1,1,H
1967-03-11,1966,Bolton Wanderers,Crystal Palace,0-0,0,0,2,2,0,0,D
1967-03-11,1966,Charlton Athletic,Preston North End,2-0,2,0,2,2,2,2,H
1967-03-11,1966,Northampton Town,Coventry City,0-0,0,0,2,2,0,0,D
1967-03-18,1966,Birmingham City,Carlisle United,1-2,1,2,2,2,3,-1,A
1967-03-18,1966,Bury,Charlton Athletic,2-1,2,1,2,2,3,1,H
1967-03-18,1966,Coventry City,Bolton Wanderers,1-1,1,1,2,2,2,0,D
1967-03-18,1966,Hull City,Ipswich Town,1-1,1,1,2,2,2,0,D
1967-03-18,1966,Millwall,Huddersfield Town,1-3,1,3,2,2,4,-2,A
1967-03-18,1966,Northampton Town,Cardiff City,2-0,2,0,2,2,2,2,H
1967-03-18,1966,Norwich City,Blackburn Rovers,0-1,0,1,2,2,1,-1,A
1967-03-18,1966,Plymouth Argyle,Wolverhampton Wanderers,0-1,0,1,2,2,1,-1,A
1967-03-18,1966,Portsmouth,Bristol City,1-1,1,1,2,2,2,0,D
1967-03-18,1966,Preston North End,Derby County,2-0,2,0,2,2,2,2,H
1967-03-18,1966,Rotherham United,Crystal Palace,0-1,0,1,2,2,1,-1,A
1967-03-22,1966,Cardiff City,Portsmouth,0-0,0,0,2,2,0,0,D
1967-03-24,1966,Charlton Athletic,Carlisle United,1-0,1,0,2,2,1,1,H
1967-03-24,1966,Millwall,Bury,2-0,2,0,2,2,2,2,H
1967-03-24,1966,Plymouth Argyle,Norwich City,2-2,2,2,2,2,4,0,D
1967-03-25,1966,Blackburn Rovers,Coventry City,0-1,0,1,2,2,1,-1,A
1967-03-25,1966,Bolton Wanderers,Bury,3-1,3,1,2,2,4,2,H
1967-03-25,1966,Bristol City,Birmingham City,3-1,3,1,2,2,4,2,H
1967-03-25,1966,Cardiff City,Plymouth Argyle,4-1,4,1,2,2,5,3,H
1967-03-25,1966,Crystal Palace,Millwall,1-2,1,2,2,2,3,-1,A
1967-03-25,1966,Derby County,Rotherham United,2-0,2,0,2,2,2,2,H
1967-03-25,1966,Huddersfield Town,Northampton Town,0-2,0,2,2,2,2,-2,A
1967-03-25,1966,Ipswich Town,Portsmouth,4-2,4,2,2,2,6,2,H
1967-03-25,1966,Wolverhampton Wanderers,Hull City,4-0,4,0,2,2,4,4,H
1967-03-27,1966,Birmingham City,Hull City,2-1,2,1,2,2,3,1,H
1967-03-27,1966,Bolton Wanderers,Blackburn Rovers,0-1,0,1,2,2,1,-1,A
1967-03-27,1966,Crystal Palace,Ipswich Town,0-2,0,2,2,2,2,-2,A
1967-03-27,1966,Derby County,Bristol City,2-0,2,0,2,2,2,2,H
1967-03-27,1966,Huddersfield Town,Wolverhampton Wanderers,0-1,0,1,2,2,1,-1,A
1967-03-27,1966,Norwich City,Plymouth Argyle,3-1,3,1,2,2,4,2,H
1967-03-27,1966,Portsmouth,Cardiff City,1-2,1,2,2,2,3,-1,A
1967-03-27,1966,Rotherham United,Preston North End,2-1,2,1,2,2,3,1,H
1967-03-28,1966,Bristol City,Derby County,4-1,4,1,2,2,5,3,H
1967-03-28,1966,Bury,Millwall,0-1,0,1,2,2,1,-1,A
1967-03-28,1966,Carlisle United,Charlton Athletic,1-0,1,0,2,2,1,1,H
1967-03-28,1966,Coventry City,Northampton Town,2-0,2,0,2,2,2,2,H
1967-03-28,1966,Hull City,Birmingham City,0-2,0,2,2,2,2,-2,A
1967-03-28,1966,Ipswich Town,Crystal Palace,2-0,2,0,2,2,2,2,H
1967-03-28,1966,Preston North End,Rotherham United,1-1,1,1,2,2,2,0,D
1967-03-28,1966,Wolverhampton Wanderers,Huddersfield Town,1-0,1,0,2,2,1,1,H
1967-04-01,1966,Birmingham City,Bolton Wanderers,2-2,2,2,2,2,4,0,D
1967-04-01,1966,Bury,Crystal Palace,1-1,1,1,2,2,2,0,D
1967-04-01,1966,Coventry City,Derby County,2-2,2,2,2,2,4,0,D
1967-04-01,1966,Hull City,Carlisle United,1-2,1,2,2,2,3,-1,A
1967-04-01,1966,Millwall,Wolverhampton Wanderers,1-1,1,1,2,2,2,0,D
1967-04-01,1966,Northampton Town,Ipswich Town,1-1,1,1,2,2,2,0,D
1967-04-01,1966,Norwich City,Charlton Athletic,1-1,1,1,2,2,2,0,D
1967-04-01,1966,Plymouth Argyle,Bristol City,1-2,1,2,2,2,3,-1,A
1967-04-01,1966,Portsmouth,Blackburn Rovers,1-1,1,1,2,2,2,0,D
1967-04-01,1966,Preston North End,Huddersfield Town,1-2,1,2,2,2,3,-1,A
1967-04-01,1966,Rotherham United,Cardiff City,4-1,4,1,2,2,5,3,H
1967-04-07,1966,Bristol City,Northampton Town,1-0,1,0,2,2,1,1,H
1967-04-08,1966,Blackburn Rovers,Hull City,4-1,4,1,2,2,5,3,H
1967-04-08,1966,Bolton Wanderers,Portsmouth,0-1,0,1,2,2,1,-1,A
1967-04-08,1966,Cardiff City,Preston North End,4-0,4,0,2,2,4,4,H
1967-04-08,1966,Carlisle United,Plymouth Argyle,0-0,0,0,2,2,0,0,D
1967-04-08,1966,Crystal Palace,Coventry City,1-1,1,1,2,2,2,0,D
1967-04-08,1966,Derby County,Norwich City,1-1,1,1,2,2,2,0,D
1967-04-08,1966,Huddersfield Town,Bury,4-2,4,2,2,2,6,2,H
1967-04-08,1966,Ipswich Town,Millwall,4-1,4,1,2,2,5,3,H
1967-04-08,1966,Wolverhampton Wanderers,Rotherham United,2-0,2,0,2,2,2,2,H
1967-04-15,1966,Birmingham City,Derby County,2-0,2,0,2,2,2,2,H
1967-04-15,1966,Bury,Cardiff City,2-0,2,0,2,2,2,2,H
1967-04-15,1966,Coventry City,Huddersfield Town,1-0,1,0,2,2,1,1,H
1967-04-15,1966,Hull City,Bolton Wanderers,1-1,1,1,2,2,2,0,D
1967-04-15,1966,Millwall,Bristol City,3-2,3,2,2,2,5,1,H
1967-04-15,1966,Northampton Town,Carlisle United,3-3,3,3,2,2,6,0,D
1967-04-15,1966,Norwich City,Crystal Palace,4-3,4,3,2,2,7,1,H
1967-04-15,1966,Plymouth Argyle,Blackburn Rovers,4-0,4,0,2,2,4,4,H
1967-04-15,1966,Portsmouth,Charlton Athletic,1-2,1,2,2,2,3,-1,A
1967-04-15,1966,Preston North End,Wolverhampton Wanderers,1-2,1,2,2,2,3,-1,A
1967-04-15,1966,Rotherham United,Ipswich Town,0-2,0,2,2,2,2,-2,A
1967-04-18,1966,Ipswich Town,Norwich City,0-2,0,2,2,2,2,-2,A
1967-04-19,1966,Bolton Wanderers,Bristol City,0-0,0,0,2,2,0,0,D
1967-04-22,1966,Blackburn Rovers,Northampton Town,3-0,3,0,2,2,3,3,H
1967-04-22,1966,Bolton Wanderers,Plymouth Argyle,1-2,1,2,2,2,3,-1,A
1967-04-22,1966,Bristol City,Rotherham United,1-2,1,2,2,2,3,-1,A
1967-04-22,1966,Cardiff City,Coventry City,1-1,1,1,2,2,2,0,D
1967-04-22,1966,Carlisle United,Millwall,2-1,2,1,2,2,3,1,H
1967-04-22,1966,Charlton Athletic,Hull City,1-3,1,3,2,2,4,-2,A
1967-04-22,1966,Crystal Palace,Birmingham City,2-1,2,1,2,2,3,1,H
1967-04-22,1966,Derby County,Portsmouth,0-0,0,0,2,2,0,0,D
1967-04-22,1966,Huddersfield Town,Norwich City,0-1,0,1,2,2,1,-1,A
1967-04-22,1966,Ipswich Town,Preston North End,0-0,0,0,2,2,0,0,D
1967-04-22,1966,Wolverhampton Wanderers,Bury,4-1,4,1,2,2,5,3,H
1967-04-25,1966,Blackburn Rovers,Bolton Wanderers,0-0,0,0,2,2,0,0,D
1967-04-27,1966,Hull City,Derby County,1-3,1,3,2,2,4,-2,A
1967-04-28,1966,Birmingham City,Huddersfield Town,0-1,0,1,2,2,1,-1,A
1967-04-28,1966,Bury,Ipswich Town,1-2,1,2,2,2,3,-1,A
1967-04-29,1966,Coventry City,Wolverhampton Wanderers,3-1,3,1,2,2,4,2,H
1967-04-29,1966,Millwall,Blackburn Rovers,1-1,1,1,2,2,2,0,D
1967-04-29,1966,Northampton Town,Bolton Wanderers,2-1,2,1,2,2,3,1,H
1967-04-29,1966,Norwich City,Cardiff City,3-2,3,2,2,2,5,1,H
1967-04-29,1966,Plymouth Argyle,Charlton Athletic,2-1,2,1,2,2,3,1,H
1967-04-29,1966,Portsmouth,Crystal Palace,1-1,1,1,2,2,2,0,D
1967-04-29,1966,Preston North End,Bristol City,2-2,2,2,2,2,4,0,D
1967-04-29,1966,Rotherham United,Carlisle United,2-3,2,3,2,2,5,-1,A
1967-05-06,1966,Blackburn Rovers,Rotherham United,1-1,1,1,2,2,2,0,D
1967-05-06,1966,Bolton Wanderers,Millwall,5-0,5,0,2,2,5,5,H
1967-05-06,1966,Bristol City,Bury,3-3,3,3,2,2,6,0,D
1967-05-06,1966,Cardiff City,Birmingham City,3-0,3,0,2,2,3,3,H
1967-05-06,1966,Carlisle United,Preston North End,1-1,1,1,2,2,2,0,D
1967-05-06,1966,Charlton Athletic,Northampton Town,3-0,3,0,2,2,3,3,H
1967-05-06,1966,Crystal Palace,Hull City,4-1,4,1,2,2,5,3,H
1967-05-06,1966,Derby County,Plymouth Argyle,1-1,1,1,2,2,2,0,D
1967-05-06,1966,Huddersfield Town,Portsmouth,1-1,1,1,2,2,2,0,D
1967-05-06,1966,Ipswich Town,Coventry City,1-1,1,1,2,2,2,0,D
1967-05-06,1966,Wolverhampton Wanderers,Norwich City,4-1,4,1,2,2,5,3,H
1967-05-12,1966,Charlton Athletic,Birmingham City,1-0,1,0,2,2,1,1,H
1967-05-13,1966,Carlisle United,Bolton Wanderers,6-1,6,1,2,2,7,5,H
1967-05-13,1966,Coventry City,Millwall,3-1,3,1,2,2,4,2,H
1967-05-13,1966,Crystal Palace,Wolverhampton Wanderers,4-1,4,1,2,2,5,3,H
1967-05-13,1966,Huddersfield Town,Cardiff City,3-1,3,1,2,2,4,2,H
1967-05-13,1966,Norwich City,Northampton Town,1-0,1,0,2,2,1,1,H
1967-05-13,1966,Rotherham United,Bury,3-0,3,0,2,2,3,3,H
1967-08-19,1967,Birmingham City,Bolton Wanderers,4-0,4,0,2,2,4,4,H
1967-08-19,1967,Bristol City,Huddersfield Town,2-3,2,3,2,2,5,-1,A
1967-08-19,1967,Cardiff City,Plymouth Argyle,1-1,1,1,2,2,2,0,D
1967-08-19,1967,Derby County,Charlton Athletic,3-2,3,2,2,2,5,1,H
1967-08-19,1967,Hull City,Carlisle United,1-0,1,0,2,2,1,1,H
1967-08-19,1967,Middlesbrough,Ipswich Town,0-2,0,2,2,2,2,-2,A
1967-08-19,1967,Millwall,Blackburn Rovers,1-2,1,2,2,2,3,-1,A
1967-08-19,1967,Norwich City,Aston Villa,1-0,1,0,2,2,1,1,H
1967-08-19,1967,Portsmouth,Queens Park Rangers,1-1,1,1,2,2,2,0,D
1967-08-19,1967,Preston North End,Blackpool,0-2,0,2,2,2,2,-2,A
1967-08-19,1967,Rotherham United,Crystal Palace,0-3,0,3,2,2,3,-3,A
1967-08-21,1967,Blackpool,Ipswich Town,0-0,0,0,2,2,0,0,D
1967-08-22,1967,Bristol City,Queens Park Rangers,0-2,0,2,2,2,2,-2,A
1967-08-22,1967,Huddersfield Town,Millwall,1-0,1,0,2,2,1,1,H
1967-08-23,1967,Blackburn Rovers,Carlisle United,1-0,1,0,2,2,1,1,H
1967-08-23,1967,Bolton Wanderers,Hull City,6-1,6,1,2,2,7,5,H
1967-08-23,1967,Norwich City,Preston North End,1-3,1,3,2,2,4,-2,A
1967-08-23,1967,Plymouth Argyle,Aston Villa,2-1,2,1,2,2,3,1,H
1967-08-26,1967,Aston Villa,Rotherham United,3-1,3,1,2,2,4,2,H
1967-08-26,1967,Blackburn Rovers,Hull City,2-0,2,0,2,2,2,2,H
1967-08-26,1967,Blackpool,Millwall,1-4,1,4,2,2,5,-3,A
1967-08-26,1967,Bolton Wanderers,Cardiff City,1-1,1,1,2,2,2,0,D
1967-08-26,1967,Carlisle United,Middlesbrough,2-2,2,2,2,2,4,0,D
1967-08-26,1967,Charlton Athletic,Preston North End,0-0,0,0,2,2,0,0,D
1967-08-26,1967,Crystal Palace,Derby County,1-0,1,0,2,2,1,1,H
1967-08-26,1967,Huddersfield Town,Birmingham City,2-3,2,3,2,2,5,-1,A
1967-08-26,1967,Ipswich Town,Bristol City,5-0,5,0,2,2,5,5,H
1967-08-26,1967,Plymouth Argyle,Portsmouth,1-2,1,2,2,2,3,-1,A
1967-08-26,1967,Queens Park Rangers,Norwich City,2-0,2,0,2,2,2,2,H
1967-08-28,1967,Aston Villa,Plymouth Argyle,0-1,0,1,2,2,1,-1,A
1967-08-28,1967,Preston North End,Norwich City,1-0,1,0,2,2,1,1,H
1967-08-28,1967,Rotherham United,Derby County,1-3,1,3,2,2,4,-2,A
1967-08-29,1967,Carlisle United,Blackburn Rovers,1-0,1,0,2,2,1,1,H
1967-08-29,1967,Ipswich Town,Blackpool,1-1,1,1,2,2,2,0,D
1967-08-29,1967,Middlesbrough,Birmingham City,1-1,1,1,2,2,2,0,D
1967-08-29,1967,Millwall,Huddersfield Town,1-1,1,1,2,2,2,0,D
1967-08-29,1967,Queens Park Rangers,Bristol City,3-1,3,1,2,2,4,2,H
1967-08-30,1967,Cardiff City,Crystal Palace,4-2,4,2,2,2,6,2,H
1967-08-30,1967,Hull City,Bolton Wanderers,1-2,1,2,2,2,3,-1,A
1967-09-02,1967,Birmingham City,Ipswich Town,0-0,0,0,2,2,0,0,D
1967-09-02,1967,Bolton Wanderers,Huddersfield Town,3-1,3,1,2,2,4,2,H
1967-09-02,1967,Bristol City,Carlisle United,1-0,1,0,2,2,1,1,H
1967-09-02,1967,Derby County,Aston Villa,3-1,3,1,2,2,4,2,H
1967-09-02,1967,Hull City,Blackpool,0-1,0,1,2,2,1,-1,A
1967-09-02,1967,Middlesbrough,Blackburn Rovers,0-0,0,0,2,2,0,0,D
1967-09-02,1967,Millwall,Charlton Athletic,0-0,0,0,2,2,0,0,D
1967-09-02,1967,Norwich City,Plymouth Argyle,2-0,2,0,2,2,2,2,H
1967-09-02,1967,Portsmouth,Cardiff City,3-1,3,1,2,2,4,2,H
1967-09-02,1967,Preston North End,Crystal Palace,0-0,0,0,2,2,0,0,D
1967-09-02,1967,Rotherham United,Queens Park Rangers,1-3,1,3,2,2,4,-2,A
1967-09-04,1967,Birmingham City,Hull City,6-2,6,2,2,2,8,4,H
1967-09-04,1967,Blackpool,Huddersfield Town,2-0,2,0,2,2,2,2,H
1967-09-05,1967,Bristol City,Middlesbrough,0-0,0,0,2,2,0,0,D
1967-09-05,1967,Carlisle United,Rotherham United,4-1,4,1,2,2,5,3,H
1967-09-05,1967,Charlton Athletic,Cardiff City,1-1,1,1,2,2,2,0,D
1967-09-05,1967,Queens Park Rangers,Aston Villa,3-0,3,0,2,2,3,3,H
1967-09-06,1967,Blackburn Rovers,Ipswich Town,2-1,2,1,2,2,3,1,H
1967-09-06,1967,Bolton Wanderers,Millwall,1-1,1,1,2,2,2,0,D
1967-09-06,1967,Crystal Palace,Plymouth Argyle,5-0,5,0,2,2,5,5,H
1967-09-06,1967,Norwich City,Derby County,3-2,3,2,2,2,5,1,H
1967-09-06,1967,Portsmouth,Preston North End,2-1,2,1,2,2,3,1,H
1967-09-09,1967,Aston Villa,Preston North End,1-0,1,0,2,2,1,1,H
1967-09-09,1967,Blackburn Rovers,Bristol City,2-0,2,0,2,2,2,2,H
1967-09-09,1967,Blackpool,Middlesbrough,3-0,3,0,2,2,3,3,H
1967-09-09,1967,Cardiff City,Norwich City,3-1,3,1,2,2,4,2,H
1967-09-09,1967,Carlisle United,Birmingham City,1-1,1,1,2,2,2,0,D
1967-09-09,1967,Crystal Palace,Charlton Athletic,3-0,3,0,2,2,3,3,H
1967-09-09,1967,Huddersfield Town,Portsmouth,2-2,2,2,2,2,4,0,D
1967-09-09,1967,Ipswich Town,Bolton Wanderers,1-1,1,1,2,2,2,0,D
1967-09-09,1967,Millwall,Hull City,1-1,1,1,2,2,2,0,D
1967-09-09,1967,Plymouth Argyle,Rotherham United,0-1,0,1,2,2,1,-1,A
1967-09-09,1967,Queens Park Rangers,Derby County,0-1,0,1,2,2,1,-1,A
1967-09-16,1967,Birmingham City,Blackburn Rovers,1-1,1,1,2,2,2,0,D
1967-09-16,1967,Bolton Wanderers,Carlisle United,2-3,2,3,2,2,5,-1,A
1967-09-16,1967,Bristol City,Blackpool,2-4,2,4,2,2,6,-2,A
1967-09-16,1967,Charlton Athletic,Aston Villa,3-0,3,0,2,2,3,3,H
1967-09-16,1967,Derby County,Plymouth Argyle,1-0,1,0,2,2,1,1,H
1967-09-16,1967,Huddersfield Town,Ipswich Town,1-4,1,4,2,2,5,-3,A
1967-09-16,1967,Hull City,Crystal Palace,1-1,1,1,2,2,2,0,D
1967-09-16,1967,Middlesbrough,Millwall,0-1,0,1,2,2,1,-1,A
1967-09-16,1967,Norwich City,Portsmouth,1-3,1,3,2,2,4,-2,A
1967-09-16,1967,Preston North End,Queens Park Rangers,0-2,0,2,2,2,2,-2,A
1967-09-16,1967,Rotherham United,Cardiff City,3-2,3,2,2,2,5,1,H
1967-09-23,1967,Aston Villa,Crystal Palace,0-1,0,1,2,2,1,-1,A
1967-09-23,1967,Blackburn Rovers,Bolton Wanderers,2-1,2,1,2,2,3,1,H
1967-09-23,1967,Blackpool,Birmingham City,1-0,1,0,2,2,1,1,H
1967-09-23,1967,Cardiff City,Derby County,1-5,1,5,2,2,6,-4,A
1967-09-23,1967,Carlisle United,Huddersfield Town,2-1,2,1,2,2,3,1,H
1967-09-23,1967,Hull City,Middlesbrough,0-2,0,2,2,2,2,-2,A
1967-09-23,1967,Ipswich Town,Norwich City,0-0,0,0,2,2,0,0,D
1967-09-23,1967,Millwall,Bristol City,1-1,1,1,2,2,2,0,D
1967-09-23,1967,Plymouth Argyle,Preston North End,1-2,1,2,2,2,3,-1,A
1967-09-23,1967,Portsmouth,Rotherham United,1-1,1,1,2,2,2,0,D
1967-09-23,1967,Queens Park Rangers,Charlton Athletic,2-1,2,1,2,2,3,1,H
1967-09-26,1967,Birmingham City,Middlesbrough,6-1,6,1,2,2,7,5,H
1967-09-27,1967,Crystal Palace,Cardiff City,2-1,2,1,2,2,3,1,H
1967-09-27,1967,Derby County,Rotherham United,4-1,4,1,2,2,5,3,H
1967-09-27,1967,Portsmouth,Charlton Athletic,4-0,4,0,2,2,4,4,H
1967-09-30,1967,Birmingham City,Millwall,2-3,2,3,2,2,5,-1,A
1967-09-30,1967,Bolton Wanderers,Blackpool,1-2,1,2,2,2,3,-1,A
1967-09-30,1967,Bristol City,Hull City,3-3,3,3,2,2,6,0,D
1967-09-30,1967,Charlton Athletic,Plymouth Argyle,1-0,1,0,2,2,1,1,H
1967-09-30,1967,Crystal Palace,Queens Park Rangers,1-0,1,0,2,2,1,1,H
1967-09-30,1967,Derby County,Portsmouth,0-1,0,1,2,2,1,-1,A
1967-09-30,1967,Huddersfield Town,Blackburn Rovers,2-1,2,1,2,2,3,1,H
1967-09-30,1967,Ipswich Town,Carlisle United,3-1,3,1,2,2,4,2,H
1967-09-30,1967,Middlesbrough,Aston Villa,1-1,1,1,2,2,2,0,D
1967-09-30,1967,Preston North End,Cardiff City,3-0,3,0,2,2,3,3,H
1967-09-30,1967,Rotherham United,Norwich City,1-3,1,3,2,2,4,-2,A
1967-10-03,1967,Charlton Athletic,Portsmouth,4-1,4,1,2,2,5,3,H
1967-10-07,1967,Aston Villa,Birmingham City,2-4,2,4,2,2,6,-2,A
1967-10-07,1967,Cardiff City,Ipswich Town,1-1,1,1,2,2,2,0,D
1967-10-07,1967,Charlton Athletic,Middlesbrough,2-2,2,2,2,2,4,0,D
1967-10-07,1967,Crystal Palace,Bristol City,2-0,2,0,2,2,2,2,H
1967-10-07,1967,Derby County,Millwall,3-3,3,3,2,2,6,0,D
1967-10-07,1967,Norwich City,Blackburn Rovers,1-0,1,0,2,2,1,1,H
1967-10-07,1967,Plymouth Argyle,Huddersfield Town,1-1,1,1,2,2,2,0,D
1967-10-07,1967,Portsmouth,Carlisle United,2-1,2,1,2,2,3,1,H
1967-10-07,1967,Preston North End,Hull City,3-2,3,2,2,2,5,1,H
1967-10-07,1967,Queens Park Rangers,Bolton Wanderers,1-0,1,0,2,2,1,1,H
1967-10-07,1967,Rotherham United,Blackpool,1-2,1,2,2,2,3,-1,A
1967-10-14,1967,Birmingham City,Portsmouth,2-2,2,2,2,2,4,0,D
1967-10-14,1967,Blackpool,Crystal Palace,2-0,2,0,2,2,2,2,H
1967-10-14,1967,Bolton Wanderers,Norwich City,2-0,2,0,2,2,2,2,H
1967-10-14,1967,Bristol City,Cardiff City,1-1,1,1,2,2,2,0,D
1967-10-14,1967,Carlisle United,Preston North End,4-1,4,1,2,2,5,3,H
1967-10-14,1967,Huddersfield Town,Rotherham United,2-0,2,0,2,2,2,2,H
1967-10-14,1967,Hull City,Queens Park Rangers,2-0,2,0,2,2,2,2,H
1967-10-14,1967,Ipswich Town,Derby County,4-0,4,0,2,2,4,4,H
1967-10-14,1967,Middlesbrough,Plymouth Argyle,5-0,5,0,2,2,5,5,H
1967-10-14,1967,Millwall,Aston Villa,1-2,1,2,2,2,3,-1,A
1967-10-21,1967,Aston Villa,Blackpool,3-2,3,2,2,2,5,1,H
1967-10-21,1967,Charlton Athletic,Carlisle United,2-2,2,2,2,2,4,0,D
1967-10-21,1967,Derby County,Huddersfield Town,1-0,1,0,2,2,1,1,H
1967-10-21,1967,Norwich City,Birmingham City,4-2,4,2,2,2,6,2,H
1967-10-21,1967,Plymouth Argyle,Hull City,2-5,2,5,2,2,7,-3,A
1967-10-21,1967,Portsmouth,Bristol City,2-0,2,0,2,2,2,2,H
1967-10-21,1967,Preston North End,Ipswich Town,1-1,1,1,2,2,2,0,D
1967-10-21,1967,Queens Park Rangers,Millwall,3-1,3,1,2,2,4,2,H
1967-10-21,1967,Rotherham United,Bolton Wanderers,2-2,2,2,2,2,4,0,D
1967-10-23,1967,Crystal Palace,Blackburn Rovers,1-0,1,0,2,2,1,1,H
1967-10-24,1967,Cardiff City,Middlesbrough,3-0,3,0,2,2,3,3,H
1967-10-24,1967,Millwall,Blackpool,1-1,1,1,2,2,2,0,D
1967-10-27,1967,Hull City,Cardiff City,1-2,1,2,2,2,3,-1,A
1967-10-28,1967,Birmingham City,Rotherham United,4-1,4,1,2,2,5,3,H
1967-10-28,1967,Blackpool,Queens Park Rangers,0-1,0,1,2,2,1,-1,A
1967-10-28,1967,Bolton Wanderers,Derby County,5-3,5,3,2,2,8,2,H
1967-10-28,1967,Carlisle United,Crystal Palace,3-0,3,0,2,2,3,3,H
1967-10-28,1967,Huddersfield Town,Preston North End,1-1,1,1,2,2,2,0,D
1967-10-28,1967,Ipswich Town,Charlton Athletic,3-2,3,2,2,2,5,1,H
1967-10-28,1967,Middlesbrough,Portsmouth,1-0,1,0,2,2,1,1,H
1967-10-28,1967,Millwall,Plymouth Argyle,3-0,3,0,2,2,3,3,H
1967-11-04,1967,Aston Villa,Carlisle United,1-0,1,0,2,2,1,1,H
1967-11-04,1967,Derby County,Birmingham City,2-2,2,2,2,2,4,0,D
1967-11-04,1967,Norwich City,Middlesbrough,2-1,2,1,2,2,3,1,H
1967-11-04,1967,Portsmouth,Hull City,3-0,3,0,2,2,3,3,H
1967-11-04,1967,Preston North End,Bolton Wanderers,1-1,1,1,2,2,2,0,D
1967-11-04,1967,Rotherham United,Bristol City,1-0,1,0,2,2,1,1,H
1967-11-10,1967,Bristol City,Derby County,1-0,1,0,2,2,1,1,H
1967-11-11,1967,Birmingham City,Preston North End,3-0,3,0,2,2,3,3,H
1967-11-11,1967,Blackpool,Cardiff City,3-1,3,1,2,2,4,2,H
1967-11-11,1967,Carlisle United,Queens Park Rangers,3-1,3,1,2,2,4,2,H
1967-11-11,1967,Huddersfield Town,Crystal Palace,1-1,1,1,2,2,2,0,D
1967-11-11,1967,Hull City,Norwich City,0-2,0,2,2,2,2,-2,A
1967-11-11,1967,Ipswich Town,Aston Villa,2-1,2,1,2,2,3,1,H
1967-11-11,1967,Middlesbrough,Rotherham United,1-1,1,1,2,2,2,0,D
1967-11-11,1967,Millwall,Portsmouth,3-2,3,2,2,2,5,1,H
1967-11-18,1967,Aston Villa,Hull City,2-3,2,3,2,2,5,-1,A
1967-11-18,1967,Cardiff City,Birmingham City,1-3,1,3,2,2,4,-2,A
1967-11-18,1967,Charlton Athletic,Blackpool,0-2,0,2,2,2,2,-2,A
1967-11-18,1967,Crystal Palace,Millwall,2-2,2,2,2,2,4,0,D
1967-11-18,1967,Derby County,Carlisle United,0-1,0,1,2,2,1,-1,A
1967-11-18,1967,Norwich City,Huddersfield Town,0-1,0,1,2,2,1,-1,A
1967-11-18,1967,Plymouth Argyle,Bristol City,0-1,0,1,2,2,1,-1,A
1967-11-18,1967,Portsmouth,Bolton Wanderers,3-0,3,0,2,2,3,3,H
1967-11-18,1967,Preston North End,Blackburn Rovers,3-5,3,5,2,2,8,-2,A
1967-11-18,1967,Queens Park Rangers,Middlesbrough,1-1,1,1,2,2,2,0,D
1967-11-18,1967,Rotherham United,Ipswich Town,1-3,1,3,2,2,4,-2,A
1967-11-22,1967,Bolton Wanderers,Charlton Athletic,2-0,2,0,2,2,2,2,H
1967-11-25,1967,Birmingham City,Crystal Palace,1-0,1,0,2,2,1,1,H
1967-11-25,1967,Blackburn Rovers,Portsmouth,2-2,2,2,2,2,4,0,D
1967-11-25,1967,Blackpool,Norwich City,0-2,0,2,2,2,2,-2,A
1967-11-25,1967,Bolton Wanderers,Aston Villa,2-3,2,3,2,2,5,-1,A
1967-11-25,1967,Bristol City,Charlton Athletic,0-2,0,2,2,2,2,-2,A
1967-11-25,1967,Carlisle United,Cardiff City,1-3,1,3,2,2,4,-2,A
1967-11-25,1967,Huddersfield Town,Queens Park Rangers,1-0,1,0,2,2,1,1,H
1967-11-25,1967,Hull City,Derby County,3-0,3,0,2,2,3,3,H
1967-11-25,1967,Ipswich Town,Plymouth Argyle,1-1,1,1,2,2,2,0,D
1967-11-25,1967,Middlesbrough,Preston North End,5-0,5,0,2,2,5,5,H
1967-11-25,1967,Millwall,Rotherham United,0-0,0,0,2,2,0,0,D
1967-12-02,1967,Aston Villa,Huddersfield Town,0-0,0,0,2,2,0,0,D
1967-12-02,1967,Cardiff City,Blackburn Rovers,3-2,3,2,2,2,5,1,H
1967-12-02,1967,Charlton Athletic,Birmingham City,3-1,3,1,2,2,4,2,H
1967-12-02,1967,Crystal Palace,Bolton Wanderers,0-3,0,3,2,2,3,-3,A
1967-12-02,1967,Derby County,Middlesbrough,2-4,2,4,2,2,6,-2,A
1967-12-02,1967,Norwich City,Millwall,5-2,5,2,2,2,7,3,H
1967-12-02,1967,Plymouth Argyle,Carlisle United,3-1,3,1,2,2,4,2,H
1967-12-02,1967,Portsmouth,Blackpool,3-1,3,1,2,2,4,2,H
1967-12-02,1967,Preston North End,Bristol City,0-1,0,1,2,2,1,-1,A
1967-12-02,1967,Queens Park Rangers,Ipswich Town,1-0,1,0,2,2,1,1,H
1967-12-02,1967,Rotherham United,Hull City,1-3,1,3,2,2,4,-2,A
1967-12-05,1967,Bristol City,Norwich City,0-2,0,2,2,2,2,-2,A
1967-12-05,1967,Cardiff City,Millwall,2-2,2,2,2,2,4,0,D
1967-12-09,1967,Birmingham City,Queens Park Rangers,2-0,2,0,2,2,2,2,H
1967-12-09,1967,Blackburn Rovers,Rotherham United,3-1,3,1,2,2,4,2,H
1967-12-09,1967,Blackpool,Derby County,1-1,1,1,2,2,2,0,D
1967-12-09,1967,Bolton Wanderers,Plymouth Argyle,1-2,1,2,2,2,3,-1,A
1967-12-09,1967,Carlisle United,Norwich City,2-2,2,2,2,2,4,0,D
1967-12-09,1967,Huddersfield Town,Cardiff City,1-0,1,0,2,2,1,1,H
1967-12-09,1967,Hull City,Charlton Athletic,1-1,1,1,2,2,2,0,D
1967-12-09,1967,Ipswich Town,Portsmouth,1-2,1,2,2,2,3,-1,A
1967-12-09,1967,Middlesbrough,Crystal Palace,3-0,3,0,2,2,3,3,H
1967-12-09,1967,Millwall,Preston North End,2-0,2,0,2,2,2,2,H
1967-12-12,1967,Queens Park Rangers,Blackburn Rovers,3-1,3,1,2,2,4,2,H
1967-12-16,1967,Aston Villa,Norwich City,4-2,4,2,2,2,6,2,H
1967-12-16,1967,Blackburn Rovers,Millwall,2-0,2,0,2,2,2,2,H
1967-12-16,1967,Blackpool,Preston North End,4-1,4,1,2,2,5,3,H
1967-12-16,1967,Bolton Wanderers,Birmingham City,1-1,1,1,2,2,2,0,D
1967-12-16,1967,Carlisle United,Hull City,1-1,1,1,2,2,2,0,D
1967-12-16,1967,Charlton Athletic,Derby County,1-2,1,2,2,2,3,-1,A
1967-12-16,1967,Crystal Palace,Rotherham United,1-0,1,0,2,2,1,1,H
1967-12-16,1967,Huddersfield Town,Bristol City,0-3,0,3,2,2,3,-3,A
1967-12-16,1967,Ipswich Town,Middlesbrough,1-2,1,2,2,2,3,-1,A
1967-12-16,1967,Plymouth Argyle,Cardiff City,0-0,0,0,2,2,0,0,D
1967-12-16,1967,Queens Park Rangers,Portsmouth,2-0,2,0,2,2,2,2,H
1967-12-22,1967,Bristol City,Ipswich Town,1-1,1,1,2,2,2,0,D
1967-12-22,1967,Hull City,Blackburn Rovers,1-1,1,1,2,2,2,0,D
1967-12-23,1967,Birmingham City,Huddersfield Town,6-1,6,1,2,2,7,5,H
1967-12-23,1967,Cardiff City,Bolton Wanderers,1-3,1,3,2,2,4,-2,A
1967-12-23,1967,Derby County,Crystal Palace,1-1,1,1,2,2,2,0,D
1967-12-23,1967,Middlesbrough,Carlisle United,4-0,4,0,2,2,4,4,H
1967-12-23,1967,Norwich City,Queens Park Rangers,0-0,0,0,2,2,0,0,D
1967-12-23,1967,Portsmouth,Plymouth Argyle,0-0,0,0,2,2,0,0,D
1967-12-23,1967,Preston North End,Charlton Athletic,4-1,4,1,2,2,5,3,H
1967-12-23,1967,Rotherham United,Aston Villa,0-2,0,2,2,2,2,-2,A
1967-12-26,1967,Birmingham City,Bristol City,4-1,4,1,2,2,5,3,H
1967-12-26,1967,Blackburn Rovers,Derby County,3-0,3,0,2,2,3,3,H
1967-12-26,1967,Blackpool,Carlisle United,1-1,1,1,2,2,2,0,D
1967-12-26,1967,Bolton Wanderers,Middlesbrough,2-0,2,0,2,2,2,2,H
1967-12-26,1967,Cardiff City,Aston Villa,3-0,3,0,2,2,3,3,H
1967-12-26,1967,Charlton Athletic,Norwich City,3-3,3,3,2,2,6,0,D
1967-12-26,1967,Crystal Palace,Portsmouth,2-2,2,2,2,2,4,0,D
1967-12-26,1967,Huddersfield Town,Hull City,2-0,2,0,2,2,2,2,H
1967-12-26,1967,Ipswich Town,Millwall,2-1,2,1,2,2,3,1,H
1967-12-26,1967,Plymouth Argyle,Queens Park Rangers,0-1,0,1,2,2,1,-1,A
1967-12-26,1967,Preston North End,Rotherham United,2-2,2,2,2,2,4,0,D
1967-12-30,1967,Aston Villa,Cardiff City,2-1,2,1,2,2,3,1,H
1967-12-30,1967,Bristol City,Birmingham City,3-1,3,1,2,2,4,2,H
1967-12-30,1967,Carlisle United,Blackpool,1-3,1,3,2,2,4,-2,A
1967-12-30,1967,Derby County,Blackburn Rovers,2-2,2,2,2,2,4,0,D
1967-12-30,1967,Hull City,Huddersfield Town,1-1,1,1,2,2,2,0,D
1967-12-30,1967,Middlesbrough,Bolton Wanderers,1-2,1,2,2,2,3,-1,A
1967-12-30,1967,Millwall,Ipswich Town,1-1,1,1,2,2,2,0,D
1967-12-30,1967,Norwich City,Charlton Athletic,1-1,1,1,2,2,2,0,D
1967-12-30,1967,Portsmouth,Crystal Palace,2-2,2,2,2,2,4,0,D
1967-12-30,1967,Queens Park Rangers,Plymouth Argyle,4-1,4,1,2,2,5,3,H
1967-12-30,1967,Rotherham United,Preston North End,1-0,1,0,2,2,1,1,H
1968-01-06,1967,Aston Villa,Derby County,2-1,2,1,2,2,3,1,H
1968-01-06,1967,Blackburn Rovers,Middlesbrough,3-0,3,0,2,2,3,3,H
1968-01-06,1967,Blackpool,Hull City,3-1,3,1,2,2,4,2,H
1968-01-06,1967,Cardiff City,Portsmouth,3-0,3,0,2,2,3,3,H
1968-01-06,1967,Carlisle United,Bristol City,0-0,0,0,2,2,0,0,D
1968-01-06,1967,Charlton Athletic,Millwall,1-0,1,0,2,2,1,1,H
1968-01-06,1967,Huddersfield Town,Bolton Wanderers,1-1,1,1,2,2,2,0,D
1968-01-06,1967,Ipswich Town,Birmingham City,2-1,2,1,2,2,3,1,H
1968-01-06,1967,Queens Park Rangers,Rotherham United,6-0,6,0,2,2,6,6,H
1968-01-10,1967,Plymouth Argyle,Norwich City,2-2,2,2,2,2,4,0,D
1968-01-13,1967,Birmingham City,Carlisle United,1-3,1,3,2,2,4,-2,A
1968-01-13,1967,Bristol City,Blackburn Rovers,0-0,0,0,2,2,0,0,D
1968-01-13,1967,Hull City,Millwall,1-1,1,1,2,2,2,0,D
1968-01-13,1967,Middlesbrough,Blackpool,0-0,0,0,2,2,0,0,D
1968-01-13,1967,Portsmouth,Huddersfield Town,3-1,3,1,2,2,4,2,H
1968-01-20,1967,Aston Villa,Charlton Athletic,4-1,4,1,2,2,5,3,H
1968-01-20,1967,Blackburn Rovers,Birmingham City,1-2,1,2,2,2,3,-1,A
1968-01-20,1967,Blackpool,Bristol City,1-1,1,1,2,2,2,0,D
1968-01-20,1967,Cardiff City,Rotherham United,2-2,2,2,2,2,4,0,D
1968-01-20,1967,Carlisle United,Bolton Wanderers,3-0,3,0,2,2,3,3,H
1968-01-20,1967,Crystal Palace,Hull City,0-1,0,1,2,2,1,-1,A
1968-01-20,1967,Ipswich Town,Huddersfield Town,2-0,2,0,2,2,2,2,H
1968-01-20,1967,Millwall,Middlesbrough,4-0,4,0,2,2,4,4,H
1968-01-20,1967,Plymouth Argyle,Derby County,3-4,3,4,2,2,7,-1,A
1968-01-20,1967,Portsmouth,Norwich City,3-0,3,0,2,2,3,3,H
1968-01-20,1967,Queens Park Rangers,Preston North End,2-0,2,0,2,2,2,2,H
1968-02-03,1967,Birmingham City,Blackpool,1-2,1,2,2,2,3,-1,A
1968-02-03,1967,Bolton Wanderers,Blackburn Rovers,2-1,2,1,2,2,3,1,H
1968-02-03,1967,Bristol City,Millwall,0-2,0,2,2,2,2,-2,A
1968-02-03,1967,Charlton Athletic,Queens Park Rangers,3-3,3,3,2,2,6,0,D
1968-02-03,1967,Crystal Palace,Aston Villa,0-1,0,1,2,2,1,-1,A
1968-02-03,1967,Derby County,Cardiff City,3-4,3,4,2,2,7,-1,A
1968-02-03,1967,Huddersfield Town,Carlisle United,1-1,1,1,2,2,2,0,D
1968-02-03,1967,Middlesbrough,Hull City,2-1,2,1,2,2,3,1,H
1968-02-03,1967,Norwich City,Ipswich Town,3-4,3,4,2,2,7,-1,A
1968-02-03,1967,Preston North End,Plymouth Argyle,2-0,2,0,2,2,2,2,H
1968-02-03,1967,Rotherham United,Portsmouth,1-1,1,1,2,2,2,0,D
1968-02-10,1967,Aston Villa,Middlesbrough,0-1,0,1,2,2,1,-1,A
1968-02-10,1967,Blackpool,Bolton Wanderers,1-1,1,1,2,2,2,0,D
1968-02-10,1967,Cardiff City,Preston North End,2-0,2,0,2,2,2,2,H
1968-02-10,1967,Carlisle United,Ipswich Town,4-1,4,1,2,2,5,3,H
1968-02-10,1967,Hull City,Bristol City,4-2,4,2,2,2,6,2,H
1968-02-10,1967,Millwall,Birmingham City,1-1,1,1,2,2,2,0,D
1968-02-10,1967,Norwich City,Rotherham United,2-2,2,2,2,2,4,0,D
1968-02-10,1967,Plymouth Argyle,Charlton Athletic,1-4,1,4,2,2,5,-3,A
1968-02-10,1967,Portsmouth,Derby County,3-2,3,2,2,2,5,1,H
1968-02-10,1967,Queens Park Rangers,Crystal Palace,2-1,2,1,2,2,3,1,H
1968-02-14,1967,Blackburn Rovers,Huddersfield Town,0-0,0,0,2,2,0,0,D
1968-02-16,1967,Millwall,Bolton Wanderers,3-0,3,0,2,2,3,3,H
1968-02-17,1967,Charlton Athletic,Huddersfield Town,4-2,4,2,2,2,6,2,H
1968-02-17,1967,Derby County,Queens Park Rangers,4-0,4,0,2,2,4,4,H
1968-02-17,1967,Plymouth Argyle,Blackburn Rovers,2-1,2,1,2,2,3,1,H
1968-02-23,1967,Carlisle United,Portsmouth,1-1,1,1,2,2,2,0,D
1968-02-24,1967,Birmingham City,Aston Villa,2-1,2,1,2,2,3,1,H
1968-02-24,1967,Blackburn Rovers,Norwich City,0-0,0,0,2,2,0,0,D
1968-02-24,1967,Blackpool,Rotherham United,1-1,1,1,2,2,2,0,D
1968-02-24,1967,Bolton Wanderers,Queens Park Rangers,1-1,1,1,2,2,2,0,D
1968-02-24,1967,Bristol City,Crystal Palace,2-1,2,1,2,2,3,1,H
1968-02-24,1967,Huddersfield Town,Plymouth Argyle,0-1,0,1,2,2,1,-1,A
1968-02-24,1967,Hull City,Preston North End,1-1,1,1,2,2,2,0,D
1968-02-24,1967,Ipswich Town,Cardiff City,4-2,4,2,2,2,6,2,H
1968-02-24,1967,Middlesbrough,Charlton Athletic,1-1,1,1,2,2,2,0,D
1968-02-24,1967,Millwall,Derby County,1-1,1,1,2,2,2,0,D
1968-02-27,1967,Bristol City,Aston Villa,0-0,0,0,2,2,0,0,D
1968-03-01,1967,Charlton Athletic,Blackburn Rovers,3-0,3,0,2,2,3,3,H
1968-03-02,1967,Aston Villa,Millwall,3-1,3,1,2,2,4,2,H
1968-03-02,1967,Cardiff City,Bristol City,0-1,0,1,2,2,1,-1,A
1968-03-02,1967,Crystal Palace,Blackpool,3-1,3,1,2,2,4,2,H
1968-03-02,1967,Derby County,Ipswich Town,2-3,2,3,2,2,5,-1,A
1968-03-02,1967,Norwich City,Bolton Wanderers,3-1,3,1,2,2,4,2,H
1968-03-02,1967,Plymouth Argyle,Middlesbrough,0-1,0,1,2,2,1,-1,A
1968-03-02,1967,Portsmouth,Birmingham City,1-2,1,2,2,2,3,-1,A
1968-03-02,1967,Preston North End,Carlisle United,0-2,0,2,2,2,2,-2,A
1968-03-02,1967,Rotherham United,Huddersfield Town,1-0,1,0,2,2,1,1,H
1968-03-05,1967,Charlton Athletic,Crystal Palace,0-1,0,1,2,2,1,-1,A
1968-03-09,1967,Blackburn Rovers,Charlton Athletic,3-2,3,2,2,2,5,1,H
1968-03-09,1967,Bolton Wanderers,Ipswich Town,1-2,1,2,2,2,3,-1,A
1968-03-09,1967,Derby County,Norwich City,1-1,1,1,2,2,2,0,D
1968-03-09,1967,Middlesbrough,Cardiff City,2-3,2,3,2,2,5,-1,A
1968-03-09,1967,Plymouth Argyle,Blackpool,2-2,2,2,2,2,4,0,D
1968-03-09,1967,Queens Park Rangers,Hull City,1-1,1,1,2,2,2,0,D
1968-03-13,1967,Blackburn Rovers,Aston Villa,2-1,2,1,2,2,3,1,H
1968-03-16,1967,Birmingham City,Norwich City,0-0,0,0,2,2,0,0,D
1968-03-16,1967,Blackburn Rovers,Crystal Palace,2-1,2,1,2,2,3,1,H
1968-03-16,1967,Blackpool,Aston Villa,1-0,1,0,2,2,1,1,H
1968-03-16,1967,Bolton Wanderers,Rotherham United,0-2,0,2,2,2,2,-2,A
1968-03-16,1967,Bristol City,Portsmouth,3-0,3,0,2,2,3,3,H
1968-03-16,1967,Carlisle United,Charlton Athletic,0-0,0,0,2,2,0,0,D
1968-03-16,1967,Huddersfield Town,Derby County,3-1,3,1,2,2,4,2,H
1968-03-16,1967,Hull City,Plymouth Argyle,0-2,0,2,2,2,2,-2,A
1968-03-16,1967,Ipswich Town,Preston North End,4-0,4,0,2,2,4,4,H
1968-03-16,1967,Millwall,Queens Park Rangers,1-1,1,1,2,2,2,0,D
1968-03-18,1967,Preston North End,Aston Villa,2-1,2,1,2,2,3,1,H
1968-03-19,1967,Rotherham United,Plymouth Argyle,1-0,1,0,2,2,1,1,H
1968-03-22,1967,Cardiff City,Hull City,2-3,2,3,2,2,5,-1,A
1968-03-23,1967,Aston Villa,Blackburn Rovers,1-2,1,2,2,2,3,-1,A
1968-03-23,1967,Charlton Athletic,Ipswich Town,0-1,0,1,2,2,1,-1,A
1968-03-23,1967,Crystal Palace,Carlisle United,1-1,1,1,2,2,2,0,D
1968-03-23,1967,Derby County,Bolton Wanderers,2-1,2,1,2,2,3,1,H
1968-03-23,1967,Norwich City,Bristol City,3-2,3,2,2,2,5,1,H
1968-03-23,1967,Plymouth Argyle,Millwall,2-1,2,1,2,2,3,1,H
1968-03-23,1967,Portsmouth,Middlesbrough,2-0,2,0,2,2,2,2,H
1968-03-23,1967,Preston North End,Huddersfield Town,3-1,3,1,2,2,4,2,H
1968-03-23,1967,Queens Park Rangers,Blackpool,2-0,2,0,2,2,2,2,H
1968-03-23,1967,Rotherham United,Birmingham City,1-1,1,1,2,2,2,0,D
1968-03-29,1967,Bristol City,Rotherham United,0-1,0,1,2,2,1,-1,A
1968-03-30,1967,Blackburn Rovers,Queens Park Rangers,0-1,0,1,2,2,1,-1,A
1968-03-30,1967,Blackpool,Plymouth Argyle,2-0,2,0,2,2,2,2,H
1968-03-30,1967,Bolton Wanderers,Preston North End,0-0,0,0,2,2,0,0,D
1968-03-30,1967,Carlisle United,Aston Villa,1-2,1,2,2,2,3,-1,A
1968-03-30,1967,Huddersfield Town,Charlton Athletic,4-1,4,1,2,2,5,3,H
1968-03-30,1967,Hull City,Portsmouth,1-1,1,1,2,2,2,0,D
1968-03-30,1967,Ipswich Town,Crystal Palace,2-2,2,2,2,2,4,0,D
1968-03-30,1967,Middlesbrough,Norwich City,2-0,2,0,2,2,2,2,H
1968-03-30,1967,Millwall,Cardiff City,3-1,3,1,2,2,4,2,H
1968-04-02,1967,Birmingham City,Derby County,3-1,3,1,2,2,4,2,H
1968-04-02,1967,Bristol City,Bolton Wanderers,1-1,1,1,2,2,2,0,D
1968-04-03,1967,Blackburn Rovers,Blackpool,2-1,2,1,2,2,3,1,H
1968-04-06,1967,Aston Villa,Ipswich Town,2-2,2,2,2,2,4,0,D
1968-04-06,1967,Cardiff City,Blackpool,1-3,1,3,2,2,4,-2,A
1968-04-06,1967,Charlton Athletic,Bolton Wanderers,2-0,2,0,2,2,2,2,H
1968-04-06,1967,Crystal Palace,Huddersfield Town,0-1,0,1,2,2,1,-1,A
1968-04-06,1967,Derby County,Bristol City,3-1,3,1,2,2,4,2,H
1968-04-06,1967,Norwich City,Hull City,2-2,2,2,2,2,4,0,D
1968-04-06,1967,Portsmouth,Millwall,0-0,0,0,2,2,0,0,D
1968-04-06,1967,Preston North End,Birmingham City,0-0,0,0,2,2,0,0,D
1968-04-06,1967,Queens Park Rangers,Carlisle United,1-0,1,0,2,2,1,1,H
1968-04-06,1967,Rotherham United,Middlesbrough,0-1,0,1,2,2,1,-1,A
1968-04-12,1967,Charlton Athletic,Rotherham United,4-1,4,1,2,2,5,3,H
1968-04-12,1967,Queens Park Rangers,Cardiff City,1-0,1,0,2,2,1,1,H
1968-04-13,1967,Birmingham City,Cardiff City,0-0,0,0,2,2,0,0,D
1968-04-13,1967,Blackburn Rovers,Preston North End,0-1,0,1,2,2,1,-1,A
1968-04-13,1967,Blackpool,Charlton Athletic,2-0,2,0,2,2,2,2,H
1968-04-13,1967,Bolton Wanderers,Portsmouth,1-2,1,2,2,2,3,-1,A
1968-04-13,1967,Bristol City,Plymouth Argyle,2-0,2,0,2,2,2,2,H
1968-04-13,1967,Carlisle United,Derby County,1-1,1,1,2,2,2,0,D
1968-04-13,1967,Huddersfield Town,Norwich City,2-0,2,0,2,2,2,2,H
1968-04-13,1967,Hull City,Aston Villa,3-0,3,0,2,2,3,3,H
1968-04-13,1967,Ipswich Town,Rotherham United,2-0,2,0,2,2,2,2,H
1968-04-13,1967,Middlesbrough,Queens Park Rangers,3-1,3,1,2,2,4,2,H
1968-04-13,1967,Millwall,Crystal Palace,5-1,5,1,2,2,6,4,H
1968-04-15,1967,Blackpool,Blackburn Rovers,2-1,2,1,2,2,3,1,H
1968-04-15,1967,Derby County,Preston North End,1-2,1,2,2,2,3,-1,A
1968-04-15,1967,Hull City,Ipswich Town,1-1,1,1,2,2,2,0,D
1968-04-15,1967,Middlesbrough,Huddersfield Town,3-2,3,2,2,2,5,1,H
1968-04-15,1967,Millwall,Carlisle United,1-0,1,0,2,2,1,1,H
1968-04-15,1967,Norwich City,Crystal Palace,2-1,2,1,2,2,3,1,H
1968-04-15,1967,Plymouth Argyle,Birmingham City,1-2,1,2,2,2,3,-1,A
1968-04-15,1967,Portsmouth,Aston Villa,2-2,2,2,2,2,4,0,D
1968-04-16,1967,Aston Villa,Portsmouth,1-0,1,0,2,2,1,1,H
1968-04-16,1967,Birmingham City,Plymouth Argyle,2-2,2,2,2,2,4,0,D
1968-04-16,1967,Cardiff City,Queens Park Rangers,1-0,1,0,2,2,1,1,H
1968-04-16,1967,Carlisle United,Millwall,1-1,1,1,2,2,2,0,D
1968-04-16,1967,Crystal Palace,Norwich City,6-0,6,0,2,2,6,6,H
1968-04-16,1967,Huddersfield Town,Middlesbrough,1-0,1,0,2,2,1,1,H
1968-04-16,1967,Ipswich Town,Hull City,2-0,2,0,2,2,2,2,H
1968-04-16,1967,Preston North End,Derby County,1-1,1,1,2,2,2,0,D
1968-04-16,1967,Rotherham United,Charlton Athletic,1-1,1,1,2,2,2,0,D
1968-04-17,1967,Bolton Wanderers,Bristol City,1-0,1,0,2,2,1,1,H
1968-04-20,1967,Aston Villa,Bolton Wanderers,1-1,1,1,2,2,2,0,D
1968-04-20,1967,Cardiff City,Carlisle United,1-0,1,0,2,2,1,1,H
1968-04-20,1967,Charlton Athletic,Bristol City,1-2,1,2,2,2,3,-1,A
1968-04-20,1967,Crystal Palace,Birmingham City,0-0,0,0,2,2,0,0,D
1968-04-20,1967,Derby County,Hull City,1-2,1,2,2,2,3,-1,A
1968-04-20,1967,Norwich City,Blackpool,1-2,1,2,2,2,3,-1,A
1968-04-20,1967,Plymouth Argyle,Ipswich Town,0-1,0,1,2,2,1,-1,A
1968-04-20,1967,Portsmouth,Blackburn Rovers,2-1,2,1,2,2,3,1,H
1968-04-20,1967,Preston North End,Middlesbrough,0-0,0,0,2,2,0,0,D
1968-04-20,1967,Queens Park Rangers,Huddersfield Town,3-0,3,0,2,2,3,3,H
1968-04-20,1967,Rotherham United,Millwall,2-0,2,0,2,2,2,2,H
1968-04-24,1967,Blackburn Rovers,Plymouth Argyle,1-1,1,1,2,2,2,0,D
1968-04-25,1967,Hull City,Rotherham United,2-1,2,1,2,2,3,1,H
1968-04-27,1967,Blackburn Rovers,Cardiff City,1-1,1,1,2,2,2,0,D
1968-04-27,1967,Blackpool,Portsmouth,2-0,2,0,2,2,2,2,H
1968-04-27,1967,Bolton Wanderers,Crystal Palace,2-2,2,2,2,2,4,0,D
1968-04-27,1967,Bristol City,Preston North End,4-1,4,1,2,2,5,3,H
1968-04-27,1967,Carlisle United,Plymouth Argyle,2-0,2,0,2,2,2,2,H
1968-04-27,1967,Huddersfield Town,Aston Villa,0-0,0,0,2,2,0,0,D
1968-04-27,1967,Ipswich Town,Queens Park Rangers,2-2,2,2,2,2,4,0,D
1968-04-27,1967,Middlesbrough,Derby County,2-2,2,2,2,2,4,0,D
1968-04-27,1967,Millwall,Norwich City,1-0,1,0,2,2,1,1,H
1968-05-01,1967,Crystal Palace,Ipswich Town,1-3,1,3,2,2,4,-2,A
1968-05-04,1967,Aston Villa,Bristol City,2-4,2,4,2,2,6,-2,A
1968-05-04,1967,Cardiff City,Huddersfield Town,0-0,0,0,2,2,0,0,D
1968-05-04,1967,Charlton Athletic,Hull City,5-1,5,1,2,2,6,4,H
1968-05-04,1967,Crystal Palace,Middlesbrough,1-3,1,3,2,2,4,-2,A
1968-05-04,1967,Derby County,Blackpool,1-3,1,3,2,2,4,-2,A
1968-05-04,1967,Norwich City,Carlisle United,2-1,2,1,2,2,3,1,H
1968-05-04,1967,Plymouth Argyle,Bolton Wanderers,1-2,1,2,2,2,3,-1,A
1968-05-04,1967,Portsmouth,Ipswich Town,1-2,1,2,2,2,3,-1,A
1968-05-04,1967,Preston North End,Millwall,0-1,0,1,2,2,1,-1,A
1968-05-04,1967,Queens Park Rangers,Birmingham City,2-0,2,0,2,2,2,2,H
1968-05-04,1967,Rotherham United,Blackburn Rovers,1-0,1,0,2,2,1,1,H
1968-05-07,1967,Birmingham City,Charlton Athletic,4-0,4,0,2,2,4,4,H
1968-05-08,1967,Norwich City,Cardiff City,1-0,1,0,2,2,1,1,H
1968-05-11,1967,Aston Villa,Queens Park Rangers,1-2,1,2,2,2,3,-1,A
1968-05-11,1967,Cardiff City,Charlton Athletic,0-0,0,0,2,2,0,0,D
1968-05-11,1967,Huddersfield Town,Blackpool,1-3,1,3,2,2,4,-2,A
1968-05-11,1967,Hull City,Birmingham City,0-1,0,1,2,2,1,-1,A
1968-05-11,1967,Ipswich Town,Blackburn Rovers,1-1,1,1,2,2,2,0,D
1968-05-11,1967,Middlesbrough,Bristol City,2-1,2,1,2,2,3,1,H
1968-05-11,1967,Plymouth Argyle,Crystal Palace,2-1,2,1,2,2,3,1,H
1968-05-11,1967,Preston North End,Portsmouth,3-1,3,1,2,2,4,2,H
1968-05-11,1967,Rotherham United,Carlisle United,1-2,1,2,2,2,3,-1,A
1968-05-15,1967,Crystal Palace,Preston North End,2-0,2,0,2,2,2,2,H
1968-08-10,1968,Birmingham City,Norwich City,1-2,1,2,2,2,3,-1,A
1968-08-10,1968,Blackburn Rovers,Derby County,1-1,1,1,2,2,2,0,D
1968-08-10,1968,Blackpool,Hull City,2-0,2,0,2,2,2,2,H
1968-08-10,1968,Bury,Carlisle United,3-2,3,2,2,2,5,1,H
1968-08-10,1968,Cardiff City,Crystal Palace,0-4,0,4,2,2,4,-4,A
1968-08-10,1968,Charlton Athletic,Millwall,3-4,3,4,2,2,7,-1,A
1968-08-10,1968,Fulham,Bristol City,1-0,1,0,2,2,1,1,H
1968-08-10,1968,Huddersfield Town,Portsmouth,0-0,0,0,2,2,0,0,D
1968-08-10,1968,Middlesbrough,Preston North End,2-1,2,1,2,2,3,1,H
1968-08-10,1968,Oxford United,Bolton Wanderers,1-1,1,1,2,2,2,0,D
1968-08-10,1968,Sheffield United,Aston Villa,3-1,3,1,2,2,4,2,H
1968-08-13,1968,Carlisle United,Portsmouth,0-0,0,0,2,2,0,0,D
1968-08-14,1968,Cardiff City,Charlton Athletic,0-1,0,1,2,2,1,-1,A
1968-08-14,1968,Crystal Palace,Huddersfield Town,2-1,2,1,2,2,3,1,H
1968-08-14,1968,Norwich City,Middlesbrough,0-2,0,2,2,2,2,-2,A
1968-08-17,1968,Aston Villa,Fulham,1-1,1,1,2,2,2,0,D
1968-08-17,1968,Bolton Wanderers,Bury,2-0,2,0,2,2,2,2,H
1968-08-17,1968,Bristol City,Sheffield United,1-1,1,1,2,2,2,0,D
1968-08-17,1968,Carlisle United,Charlton Athletic,1-1,1,1,2,2,2,0,D
1968-08-17,1968,Crystal Palace,Birmingham City,3-2,3,2,2,2,5,1,H
1968-08-17,1968,Derby County,Blackpool,1-1,1,1,2,2,2,0,D
1968-08-17,1968,Hull City,Blackburn Rovers,1-3,1,3,2,2,4,-2,A
1968-08-17,1968,Millwall,Oxford United,2-1,2,1,2,2,3,1,H
1968-08-17,1968,Norwich City,Cardiff City,3-1,3,1,2,2,4,2,H
1968-08-17,1968,Portsmouth,Middlesbrough,3-0,3,0,2,2,3,3,H
1968-08-17,1968,Preston North End,Huddersfield Town,1-0,1,0,2,2,1,1,H
1968-08-19,1968,Aston Villa,Millwall,1-1,1,1,2,2,2,0,D
1968-08-20,1968,Bristol City,Bolton Wanderers,2-2,2,2,2,2,4,0,D
1968-08-20,1968,Charlton Athletic,Birmingham City,3-1,3,1,2,2,4,2,H
1968-08-20,1968,Huddersfield Town,Norwich City,2-2,2,2,2,2,4,0,D
1968-08-20,1968,Middlesbrough,Crystal Palace,4-0,4,0,2,2,4,4,H
1968-08-20,1968,Sheffield United,Derby County,2-0,2,0,2,2,2,2,H
1968-08-21,1968,Bury,Cardiff City,3-3,3,3,2,2,6,0,D
1968-08-21,1968,Fulham,Hull City,0-0,0,0,2,2,0,0,D
1968-08-21,1968,Oxford United,Blackpool,0-0,0,0,2,2,0,0,D
1968-08-21,1968,Portsmouth,Blackburn Rovers,0-1,0,1,2,2,1,-1,A
1968-08-24,1968,Birmingham City,Portsmouth,5-2,5,2,2,2,7,3,H
1968-08-24,1968,Blackburn Rovers,Aston Villa,2-0,2,0,2,2,2,2,H
1968-08-24,1968,Blackpool,Bristol City,2-2,2,2,2,2,4,0,D
1968-08-24,1968,Bury,Crystal Palace,2-1,2,1,2,2,3,1,H
1968-08-24,1968,Cardiff City,Preston North End,1-0,1,0,2,2,1,1,H
1968-08-24,1968,Charlton Athletic,Norwich City,2-1,2,1,2,2,3,1,H
1968-08-24,1968,Fulham,Bolton Wanderers,0-2,0,2,2,2,2,-2,A
1968-08-24,1968,Huddersfield Town,Derby County,2-0,2,0,2,2,2,2,H
1968-08-24,1968,Middlesbrough,Carlisle United,1-0,1,0,2,2,1,1,H
1968-08-24,1968,Oxford United,Hull City,1-1,1,1,2,2,2,0,D
1968-08-24,1968,Sheffield United,Millwall,1-0,1,0,2,2,1,1,H
1968-08-26,1968,Aston Villa,Bristol City,1-0,1,0,2,2,1,1,H
1968-08-26,1968,Millwall,Bolton Wanderers,3-1,3,1,2,2,4,2,H
1968-08-26,1968,Preston North End,Portsmouth,0-0,0,0,2,2,0,0,D
1968-08-27,1968,Bury,Charlton Athletic,2-3,2,3,2,2,5,-1,A
1968-08-27,1968,Carlisle United,Oxford United,0-2,0,2,2,2,2,-2,A
1968-08-27,1968,Middlesbrough,Huddersfield Town,1-1,1,1,2,2,2,0,D
1968-08-27,1968,Sheffield United,Fulham,1-0,1,0,2,2,1,1,H
1968-08-28,1968,Blackburn Rovers,Blackpool,1-1,1,1,2,2,2,0,D
1968-08-28,1968,Cardiff City,Birmingham City,4-0,4,0,2,2,4,4,H
1968-08-28,1968,Crystal Palace,Norwich City,2-0,2,0,2,2,2,2,H
1968-08-28,1968,Derby County,Hull City,2-2,2,2,2,2,4,0,D
1968-08-31,1968,Aston Villa,Blackpool,0-1,0,1,2,2,1,-1,A
1968-08-31,1968,Bolton Wanderers,Sheffield United,4-2,4,2,2,2,6,2,H
1968-08-31,1968,Bristol City,Blackburn Rovers,1-0,1,0,2,2,1,1,H
1968-08-31,1968,Carlisle United,Huddersfield Town,0-0,0,0,2,2,0,0,D
1968-08-31,1968,Crystal Palace,Charlton Athletic,3-3,3,3,2,2,6,0,D
1968-08-31,1968,Derby County,Oxford United,2-0,2,0,2,2,2,2,H
1968-08-31,1968,Hull City,Middlesbrough,3-0,3,0,2,2,3,3,H
1968-08-31,1968,Millwall,Fulham,2-0,2,0,2,2,2,2,H
1968-08-31,1968,Norwich City,Bury,2-2,2,2,2,2,4,0,D
1968-08-31,1968,Portsmouth,Cardiff City,1-3,1,3,2,2,4,-2,A
1968-08-31,1968,Preston North End,Birmingham City,4-1,4,1,2,2,5,3,H
1968-09-07,1968,Birmingham City,Huddersfield Town,5-1,5,1,2,2,6,4,H
1968-09-07,1968,Blackburn Rovers,Millwall,2-4,2,4,2,2,6,-2,A
1968-09-07,1968,Blackpool,Bolton Wanderers,1-0,1,0,2,2,1,1,H
1968-09-07,1968,Bury,Preston North End,0-1,0,1,2,2,1,-1,A
1968-09-07,1968,Cardiff City,Middlesbrough,2-0,2,0,2,2,2,2,H
1968-09-07,1968,Charlton Athletic,Portsmouth,2-1,2,1,2,2,3,1,H
1968-09-07,1968,Crystal Palace,Carlisle United,5-0,5,0,2,2,5,5,H
1968-09-07,1968,Derby County,Aston Villa,3-1,3,1,2,2,4,2,H
1968-09-07,1968,Hull City,Bristol City,1-1,1,1,2,2,2,0,D
1968-09-07,1968,Norwich City,Sheffield United,2-0,2,0,2,2,2,2,H
1968-09-07,1968,Oxford United,Fulham,1-0,1,0,2,2,1,1,H
1968-09-13,1968,Fulham,Crystal Palace,1-0,1,0,2,2,1,1,H
1968-09-13,1968,Portsmouth,Bury,1-2,1,2,2,2,3,-1,A
1968-09-14,1968,Aston Villa,Hull City,1-1,1,1,2,2,2,0,D
1968-09-14,1968,Bolton Wanderers,Blackburn Rovers,1-1,1,1,2,2,2,0,D
1968-09-14,1968,Bristol City,Derby County,0-0,0,0,2,2,0,0,D
1968-09-14,1968,Carlisle United,Norwich City,0-4,0,4,2,2,4,-4,A
1968-09-14,1968,Huddersfield Town,Cardiff City,3-0,3,0,2,2,3,3,H
1968-09-14,1968,Middlesbrough,Birmingham City,3-1,3,1,2,2,4,2,H
1968-09-14,1968,Millwall,Blackpool,1-2,1,2,2,2,3,-1,A
1968-09-14,1968,Preston North End,Charlton Athletic,1-1,1,1,2,2,2,0,D
1968-09-14,1968,Sheffield United,Oxford United,1-2,1,2,2,2,3,-1,A
1968-09-16,1968,Blackpool,Preston North End,1-1,1,1,2,2,2,0,D
1968-09-16,1968,Millwall,Bristol City,2-2,2,2,2,2,4,0,D
1968-09-17,1968,Birmingham City,Bury,1-3,1,3,2,2,4,-2,A
1968-09-18,1968,Blackburn Rovers,Oxford United,1-0,1,0,2,2,1,1,H
1968-09-18,1968,Bolton Wanderers,Aston Villa,4-1,4,1,2,2,5,3,H
1968-09-18,1968,Derby County,Fulham,1-0,1,0,2,2,1,1,H
1968-09-18,1968,Hull City,Sheffield United,1-1,1,1,2,2,2,0,D
1968-09-21,1968,Birmingham City,Aston Villa,4-0,4,0,2,2,4,4,H
1968-09-21,1968,Blackburn Rovers,Sheffield United,1-0,1,0,2,2,1,1,H
1968-09-21,1968,Blackpool,Fulham,2-2,2,2,2,2,4,0,D
1968-09-21,1968,Bury,Middlesbrough,2-3,2,3,2,2,5,-1,A
1968-09-21,1968,Cardiff City,Carlisle United,2-1,2,1,2,2,3,1,H
1968-09-21,1968,Charlton Athletic,Huddersfield Town,1-0,1,0,2,2,1,1,H
1968-09-21,1968,Crystal Palace,Preston North End,1-2,1,2,2,2,3,-1,A
1968-09-21,1968,Derby County,Millwall,1-0,1,0,2,2,1,1,H
1968-09-21,1968,Hull City,Bolton Wanderers,1-0,1,0,2,2,1,1,H
1968-09-21,1968,Norwich City,Portsmouth,0-1,0,1,2,2,1,-1,A
1968-09-21,1968,Oxford United,Bristol City,0-0,0,0,2,2,0,0,D
1968-09-28,1968,Aston Villa,Oxford United,2-0,2,0,2,2,2,2,H
1968-09-28,1968,Bolton Wanderers,Derby County,1-2,1,2,2,2,3,-1,A
1968-09-28,1968,Bristol City,Cardiff City,0-3,0,3,2,2,3,-3,A
1968-09-28,1968,Carlisle United,Birmingham City,2-3,2,3,2,2,5,-1,A
1968-09-28,1968,Fulham,Blackburn Rovers,1-1,1,1,2,2,2,0,D
1968-09-28,1968,Huddersfield Town,Bury,4-1,4,1,2,2,5,3,H
1968-09-28,1968,Middlesbrough,Charlton Athletic,1-0,1,0,2,2,1,1,H
1968-09-28,1968,Millwall,Hull City,2-3,2,3,2,2,5,-1,A
1968-09-28,1968,Portsmouth,Crystal Palace,3-3,3,3,2,2,6,0,D
1968-09-28,1968,Preston North End,Norwich City,1-3,1,3,2,2,4,-2,A
1968-09-28,1968,Sheffield United,Blackpool,2-1,2,1,2,2,3,1,H
1968-09-30,1968,Preston North End,Carlisle United,2-2,2,2,2,2,4,0,D
1968-10-05,1968,Birmingham City,Fulham,5-4,5,4,2,2,9,1,H
1968-10-05,1968,Bury,Millwall,0-0,0,0,2,2,0,0,D
1968-10-05,1968,Cardiff City,Aston Villa,1-1,1,1,2,2,2,0,D
1968-10-05,1968,Carlisle United,Bolton Wanderers,1-1,1,1,2,2,2,0,D
1968-10-05,1968,Charlton Athletic,Bristol City,0-0,0,0,2,2,0,0,D
1968-10-05,1968,Crystal Palace,Sheffield United,1-1,1,1,2,2,2,0,D
1968-10-05,1968,Huddersfield Town,Blackpool,2-1,2,1,2,2,3,1,H
1968-10-05,1968,Middlesbrough,Derby County,0-0,0,0,2,2,0,0,D
1968-10-05,1968,Norwich City,Hull City,1-2,1,2,2,2,3,-1,A
1968-10-05,1968,Portsmouth,Oxford United,3-0,3,0,2,2,3,3,H
1968-10-05,1968,Preston North End,Blackburn Rovers,1-1,1,1,2,2,2,0,D
1968-10-07,1968,Blackpool,Blackburn Rovers,0-1,0,1,2,2,1,-1,A
1968-10-08,1968,Birmingham City,Cardiff City,2-0,2,0,2,2,2,2,H
1968-10-08,1968,Bristol City,Aston Villa,1-0,1,0,2,2,1,1,H
1968-10-08,1968,Charlton Athletic,Bury,2-2,2,2,2,2,4,0,D
1968-10-08,1968,Huddersfield Town,Middlesbrough,3-0,3,0,2,2,3,3,H
1968-10-09,1968,Bolton Wanderers,Millwall,0-4,0,4,2,2,4,-4,A
1968-10-09,1968,Fulham,Sheffield United,2-2,2,2,2,2,4,0,D
1968-10-09,1968,Hull City,Derby County,1-0,1,0,2,2,1,1,H
1968-10-09,1968,Norwich City,Crystal Palace,0-1,0,1,2,2,1,-1,A
1968-10-09,1968,Oxford United,Carlisle United,0-1,0,1,2,2,1,-1,A
1968-10-09,1968,Portsmouth,Preston North End,1-1,1,1,2,2,2,0,D
1968-10-12,1968,Aston Villa,Crystal Palace,1-1,1,1,2,2,2,0,D
1968-10-12,1968,Blackburn Rovers,Carlisle United,0-2,0,2,2,2,2,-2,A
1968-10-12,1968,Blackpool,Portsmouth,1-1,1,1,2,2,2,0,D
1968-10-12,1968,Bolton Wanderers,Charlton Athletic,3-0,3,0,2,2,3,3,H
1968-10-12,1968,Bristol City,Birmingham City,0-0,0,0,2,2,0,0,D
1968-10-12,1968,Derby County,Preston North End,1-0,1,0,2,2,1,1,H
1968-10-12,1968,Fulham,Norwich City,1-3,1,3,2,2,4,-2,A
1968-10-12,1968,Hull City,Huddersfield Town,3-0,3,0,2,2,3,3,H
1968-10-12,1968,Millwall,Cardiff City,2-0,2,0,2,2,2,2,H
1968-10-12,1968,Oxford United,Bury,2-2,2,2,2,2,4,0,D
1968-10-12,1968,Sheffield United,Middlesbrough,1-3,1,3,2,2,4,-2,A
1968-10-19,1968,Birmingham City,Millwall,1-2,1,2,2,2,3,-1,A
1968-10-19,1968,Bury,Blackburn Rovers,1-3,1,3,2,2,4,-2,A
1968-10-19,1968,Cardiff City,Bolton Wanderers,0-2,0,2,2,2,2,-2,A
1968-10-19,1968,Carlisle United,Blackpool,1-0,1,0,2,2,1,1,H
1968-10-19,1968,Charlton Athletic,Oxford United,1-0,1,0,2,2,1,1,H
1968-10-19,1968,Crystal Palace,Bristol City,2-1,2,1,2,2,3,1,H
1968-10-19,1968,Huddersfield Town,Sheffield United,1-0,1,0,2,2,1,1,H
1968-10-19,1968,Middlesbrough,Fulham,2-0,2,0,2,2,2,2,H
1968-10-19,1968,Norwich City,Aston Villa,1-1,1,1,2,2,2,0,D
1968-10-19,1968,Portsmouth,Derby County,0-1,0,1,2,2,1,-1,A
1968-10-19,1968,Preston North End,Hull City,1-0,1,0,2,2,1,1,H
1968-10-26,1968,Aston Villa,Carlisle United,0-0,0,0,2,2,0,0,D
1968-10-26,1968,Blackburn Rovers,Norwich City,3-0,3,0,2,2,3,3,H
1968-10-26,1968,Blackpool,Crystal Palace,3-0,3,0,2,2,3,3,H
1968-10-26,1968,Bolton Wanderers,Huddersfield Town,2-3,2,3,2,2,5,-1,A
1968-10-26,1968,Bristol City,Portsmouth,2-2,2,2,2,2,4,0,D
1968-10-26,1968,Derby County,Birmingham City,1-0,1,0,2,2,1,1,H
1968-10-26,1968,Fulham,Bury,0-0,0,0,2,2,0,0,D
1968-10-26,1968,Hull City,Cardiff City,3-3,3,3,2,2,6,0,D
1968-10-26,1968,Millwall,Preston North End,0-0,0,0,2,2,0,0,D
1968-10-26,1968,Oxford United,Middlesbrough,2-4,2,4,2,2,6,-2,A
1968-10-26,1968,Sheffield United,Charlton Athletic,2-0,2,0,2,2,2,2,H
1968-11-02,1968,Birmingham City,Oxford United,0-1,0,1,2,2,1,-1,A
1968-11-02,1968,Cardiff City,Blackburn Rovers,2-1,2,1,2,2,3,1,H
1968-11-02,1968,Charlton Athletic,Blackpool,0-0,0,0,2,2,0,0,D
1968-11-02,1968,Crystal Palace,Bolton Wanderers,2-1,2,1,2,2,3,1,H
1968-11-02,1968,Huddersfield Town,Aston Villa,3-1,3,1,2,2,4,2,H
1968-11-02,1968,Norwich City,Millwall,0-3,0,3,2,2,3,-3,A
1968-11-02,1968,Portsmouth,Sheffield United,2-1,2,1,2,2,3,1,H
1968-11-04,1968,Carlisle United,Hull City,1-0,1,0,2,2,1,1,H
1968-11-08,1968,Hull City,Bury,3-0,3,0,2,2,3,3,H
1968-11-09,1968,Aston Villa,Preston North End,0-1,0,1,2,2,1,-1,A
1968-11-09,1968,Blackburn Rovers,Birmingham City,3-2,3,2,2,2,5,1,H
1968-11-09,1968,Blackpool,Cardiff City,1-2,1,2,2,2,3,-1,A
1968-11-09,1968,Bristol City,Huddersfield Town,0-1,0,1,2,2,1,-1,A
1968-11-09,1968,Derby County,Charlton Athletic,2-1,2,1,2,2,3,1,H
1968-11-09,1968,Fulham,Portsmouth,2-2,2,2,2,2,4,0,D
1968-11-09,1968,Millwall,Middlesbrough,2-0,2,0,2,2,2,2,H
1968-11-09,1968,Oxford United,Crystal Palace,0-2,0,2,2,2,2,-2,A
1968-11-09,1968,Sheffield United,Carlisle United,0-1,0,1,2,2,1,-1,A
1968-11-16,1968,Birmingham City,Blackpool,1-0,1,0,2,2,1,1,H
1968-11-16,1968,Bury,Sheffield United,0-2,0,2,2,2,2,-2,A
1968-11-16,1968,Cardiff City,Derby County,1-1,1,1,2,2,2,0,D
1968-11-16,1968,Carlisle United,Fulham,2-0,2,0,2,2,2,2,H
1968-11-16,1968,Charlton Athletic,Hull City,1-1,1,1,2,2,2,0,D
1968-11-16,1968,Crystal Palace,Blackburn Rovers,1-0,1,0,2,2,1,1,H
1968-11-16,1968,Huddersfield Town,Millwall,0-2,0,2,2,2,2,-2,A
1968-11-16,1968,Middlesbrough,Bolton Wanderers,0-0,0,0,2,2,0,0,D
1968-11-16,1968,Norwich City,Oxford United,1-1,1,1,2,2,2,0,D
1968-11-16,1968,Portsmouth,Aston Villa,2-0,2,0,2,2,2,2,H
1968-11-16,1968,Preston North End,Bristol City,1-0,1,0,2,2,1,1,H
1968-11-23,1968,Aston Villa,Middlesbrough,1-0,1,0,2,2,1,1,H
1968-11-23,1968,Blackburn Rovers,Charlton Athletic,0-1,0,1,2,2,1,-1,A
1968-11-23,1968,Blackpool,Bury,6-0,6,0,2,2,6,6,H
1968-11-23,1968,Bolton Wanderers,Birmingham City,0-0,0,0,2,2,0,0,D
1968-11-23,1968,Bristol City,Norwich City,0-1,0,1,2,2,1,-1,A
1968-11-23,1968,Derby County,Carlisle United,3-3,3,3,2,2,6,0,D
1968-11-23,1968,Fulham,Huddersfield Town,4-3,4,3,2,2,7,1,H
1968-11-23,1968,Hull City,Portsmouth,2-2,2,2,2,2,4,0,D
1968-11-23,1968,Millwall,Crystal Palace,0-2,0,2,2,2,2,-2,A
1968-11-23,1968,Oxford United,Cardiff City,0-2,0,2,2,2,2,-2,A
1968-11-23,1968,Sheffield United,Preston North End,4-0,4,0,2,2,4,4,H
1968-11-25,1968,Preston North End,Fulham,0-0,0,0,2,2,0,0,D
1968-11-30,1968,Birmingham City,Hull City,5-2,5,2,2,2,7,3,H
1968-11-30,1968,Bury,Aston Villa,3-2,3,2,2,2,5,1,H
1968-11-30,1968,Cardiff City,Sheffield United,4-1,4,1,2,2,5,3,H
1968-11-30,1968,Carlisle United,Bristol City,3-0,3,0,2,2,3,3,H
1968-11-30,1968,Charlton Athletic,Fulham,5-3,5,3,2,2,8,2,H
1968-11-30,1968,Crystal Palace,Derby County,1-2,1,2,2,2,3,-1,A
1968-11-30,1968,Huddersfield Town,Oxford United,2-1,2,1,2,2,3,1,H
1968-11-30,1968,Middlesbrough,Blackburn Rovers,2-0,2,0,2,2,2,2,H
1968-11-30,1968,Norwich City,Blackpool,0-1,0,1,2,2,1,-1,A
1968-11-30,1968,Portsmouth,Millwall,3-0,3,0,2,2,3,3,H
1968-11-30,1968,Preston North End,Bolton Wanderers,1-4,1,4,2,2,5,-3,A
1968-12-03,1968,Middlesbrough,Bristol City,4-1,4,1,2,2,5,3,H
1968-12-04,1968,Bolton Wanderers,Norwich City,1-1,1,1,2,2,2,0,D
1968-12-07,1968,Aston Villa,Charlton Athletic,0-0,0,0,2,2,0,0,D
1968-12-07,1968,Blackburn Rovers,Huddersfield Town,0-0,0,0,2,2,0,0,D
1968-12-07,1968,Blackpool,Middlesbrough,1-1,1,1,2,2,2,0,D
1968-12-07,1968,Bolton Wanderers,Portsmouth,1-0,1,0,2,2,1,1,H
1968-12-07,1968,Bristol City,Bury,2-1,2,1,2,2,3,1,H
1968-12-07,1968,Derby County,Norwich City,1-1,1,1,2,2,2,0,D
1968-12-07,1968,Fulham,Cardiff City,1-5,1,5,2,2,6,-4,A
1968-12-07,1968,Hull City,Crystal Palace,2-0,2,0,2,2,2,2,H
1968-12-07,1968,Millwall,Carlisle United,1-1,1,1,2,2,2,0,D
1968-12-07,1968,Oxford United,Preston North End,2-1,2,1,2,2,3,1,H
1968-12-07,1968,Sheffield United,Birmingham City,2-0,2,0,2,2,2,2,H
1968-12-14,1968,Birmingham City,Bristol City,2-0,2,0,2,2,2,2,H
1968-12-14,1968,Bury,Oxford United,3-1,3,1,2,2,4,2,H
1968-12-14,1968,Cardiff City,Millwall,2-0,2,0,2,2,2,2,H
1968-12-14,1968,Carlisle United,Blackburn Rovers,4-1,4,1,2,2,5,3,H
1968-12-14,1968,Charlton Athletic,Bolton Wanderers,2-2,2,2,2,2,4,0,D
1968-12-14,1968,Crystal Palace,Aston Villa,4-2,4,2,2,2,6,2,H
1968-12-14,1968,Huddersfield Town,Hull City,0-3,0,3,2,2,3,-3,A
1968-12-14,1968,Norwich City,Fulham,2-0,2,0,2,2,2,2,H
1968-12-14,1968,Portsmouth,Blackpool,1-0,1,0,2,2,1,1,H
1968-12-14,1968,Preston North End,Derby County,0-0,0,0,2,2,0,0,D
1968-12-20,1968,Hull City,Preston North End,1-1,1,1,2,2,2,0,D
1968-12-21,1968,Aston Villa,Norwich City,2-1,2,1,2,2,3,1,H
1968-12-21,1968,Blackburn Rovers,Bury,3-0,3,0,2,2,3,3,H
1968-12-21,1968,Blackpool,Carlisle United,1-0,1,0,2,2,1,1,H
1968-12-21,1968,Bolton Wanderers,Cardiff City,1-2,1,2,2,2,3,-1,A
1968-12-21,1968,Derby County,Portsmouth,2-1,2,1,2,2,3,1,H
1968-12-21,1968,Fulham,Middlesbrough,0-3,0,3,2,2,3,-3,A
1968-12-21,1968,Millwall,Birmingham City,1-3,1,3,2,2,4,-2,A
1968-12-21,1968,Oxford United,Charlton Athletic,0-1,0,1,2,2,1,-1,A
1968-12-21,1968,Sheffield United,Huddersfield Town,0-0,0,0,2,2,0,0,D
1968-12-26,1968,Aston Villa,Cardiff City,2-0,2,0,2,2,2,2,H
1968-12-26,1968,Blackburn Rovers,Preston North End,1-0,1,0,2,2,1,1,H
1968-12-26,1968,Blackpool,Huddersfield Town,0-0,0,0,2,2,0,0,D
1968-12-26,1968,Bolton Wanderers,Carlisle United,0-1,0,1,2,2,1,-1,A
1968-12-26,1968,Bristol City,Charlton Athletic,2-0,2,0,2,2,2,2,H
1968-12-26,1968,Derby County,Middlesbrough,3-2,3,2,2,2,5,1,H
1968-12-26,1968,Fulham,Birmingham City,2-0,2,0,2,2,2,2,H
1968-12-26,1968,Hull City,Norwich City,0-1,0,1,2,2,1,-1,A
1968-12-26,1968,Millwall,Bury,1-0,1,0,2,2,1,1,H
1968-12-26,1968,Sheffield United,Crystal Palace,1-1,1,1,2,2,2,0,D
1968-12-28,1968,Bury,Fulham,5-1,5,1,2,2,6,4,H
1968-12-28,1968,Cardiff City,Hull City,3-0,3,0,2,2,3,3,H
1968-12-28,1968,Carlisle United,Aston Villa,0-1,0,1,2,2,1,-1,A
1968-12-28,1968,Portsmouth,Bristol City,1-1,1,1,2,2,2,0,D
1969-01-11,1968,Aston Villa,Huddersfield Town,1-0,1,0,2,2,1,1,H
1969-01-11,1968,Blackburn Rovers,Cardiff City,1-0,1,0,2,2,1,1,H
1969-01-11,1968,Blackpool,Charlton Athletic,2-3,2,3,2,2,5,-1,A
1969-01-11,1968,Bolton Wanderers,Crystal Palace,2-2,2,2,2,2,4,0,D
1969-01-11,1968,Bristol City,Middlesbrough,3-0,3,0,2,2,3,3,H
1969-01-11,1968,Derby County,Bury,2-0,2,0,2,2,2,2,H
1969-01-11,1968,Hull City,Carlisle United,1-2,1,2,2,2,3,-1,A
1969-01-11,1968,Millwall,Norwich City,3-1,3,1,2,2,4,2,H
1969-01-11,1968,Oxford United,Birmingham City,1-2,1,2,2,2,3,-1,A
1969-01-11,1968,Sheffield United,Portsmouth,2-0,2,0,2,2,2,2,H
1969-01-14,1968,Birmingham City,Derby County,1-1,1,1,2,2,2,0,D
1969-01-18,1968,Birmingham City,Blackburn Rovers,3-1,3,1,2,2,4,2,H
1969-01-18,1968,Bury,Hull City,0-0,0,0,2,2,0,0,D
1969-01-18,1968,Carlisle United,Sheffield United,0-1,0,1,2,2,1,-1,A
1969-01-18,1968,Charlton Athletic,Derby County,2-0,2,0,2,2,2,2,H
1969-01-18,1968,Huddersfield Town,Bristol City,4-1,4,1,2,2,5,3,H
1969-01-18,1968,Middlesbrough,Millwall,1-1,1,1,2,2,2,0,D
1969-01-18,1968,Norwich City,Bolton Wanderers,2-0,2,0,2,2,2,2,H
1969-01-18,1968,Portsmouth,Fulham,3-1,3,1,2,2,4,2,H
1969-01-18,1968,Preston North End,Aston Villa,1-0,1,0,2,2,1,1,H
1969-01-24,1968,Middlesbrough,Oxford United,2-0,2,0,2,2,2,2,H
1969-01-25,1968,Bury,Derby County,0-1,0,1,2,2,1,-1,A
1969-01-25,1968,Cardiff City,Bristol City,3-0,3,0,2,2,3,3,H
1969-01-25,1968,Crystal Palace,Blackpool,1-2,1,2,2,2,3,-1,A
1969-01-28,1968,Middlesbrough,Sheffield United,3-1,3,1,2,2,4,2,H
1969-02-01,1968,Aston Villa,Portsmouth,2-0,2,0,2,2,2,2,H
1969-02-01,1968,Blackpool,Birmingham City,2-1,2,1,2,2,3,1,H
1969-02-01,1968,Bolton Wanderers,Middlesbrough,0-0,0,0,2,2,0,0,D
1969-02-01,1968,Bristol City,Preston North End,2-1,2,1,2,2,3,1,H
1969-02-01,1968,Derby County,Cardiff City,2-0,2,0,2,2,2,2,H
1969-02-01,1968,Fulham,Carlisle United,0-2,0,2,2,2,2,-2,A
1969-02-01,1968,Hull City,Charlton Athletic,5-2,5,2,2,2,7,3,H
1969-02-01,1968,Millwall,Huddersfield Town,5-1,5,1,2,2,6,4,H
1969-02-01,1968,Oxford United,Norwich City,0-2,0,2,2,2,2,-2,A
1969-02-01,1968,Sheffield United,Bury,5-0,5,0,2,2,5,5,H
1969-02-08,1968,Cardiff City,Oxford United,5-0,5,0,2,2,5,5,H
1969-02-08,1968,Portsmouth,Hull City,1-0,1,0,2,2,1,1,H
1969-02-12,1968,Cardiff City,Blackpool,1-0,1,0,2,2,1,1,H
1969-02-15,1968,Aston Villa,Bury,1-0,1,0,2,2,1,1,H
1969-02-15,1968,Bristol City,Carlisle United,3-0,3,0,2,2,3,3,H
1969-02-15,1968,Fulham,Charlton Athletic,0-1,0,1,2,2,1,-1,A
1969-02-15,1968,Millwall,Portsmouth,0-0,0,0,2,2,0,0,D
1969-02-15,1968,Oxford United,Huddersfield Town,3-0,3,0,2,2,3,3,H
1969-02-22,1968,Carlisle United,Millwall,1-0,1,0,2,2,1,1,H
1969-02-22,1968,Charlton Athletic,Aston Villa,1-1,1,1,2,2,2,0,D
1969-02-22,1968,Crystal Palace,Hull City,2-0,2,0,2,2,2,2,H
1969-02-22,1968,Middlesbrough,Blackpool,2-1,2,1,2,2,3,1,H
1969-02-22,1968,Portsmouth,Bolton Wanderers,2-2,2,2,2,2,4,0,D
1969-02-22,1968,Preston North End,Oxford United,2-1,2,1,2,2,3,1,H
1969-02-25,1968,Bristol City,Crystal Palace,1-1,1,1,2,2,2,0,D
1969-02-26,1968,Fulham,Preston North End,2-1,2,1,2,2,3,1,H
1969-03-01,1968,Aston Villa,Sheffield United,3-1,3,1,2,2,4,2,H
1969-03-01,1968,Bolton Wanderers,Oxford United,1-1,1,1,2,2,2,0,D
1969-03-01,1968,Bristol City,Fulham,6-0,6,0,2,2,6,6,H
1969-03-01,1968,Carlisle United,Bury,2-0,2,0,2,2,2,2,H
1969-03-01,1968,Crystal Palace,Cardiff City,3-1,3,1,2,2,4,2,H
1969-03-01,1968,Derby County,Blackburn Rovers,4-2,4,2,2,2,6,2,H
1969-03-01,1968,Hull City,Blackpool,2-2,2,2,2,2,4,0,D
1969-03-01,1968,Millwall,Charlton Athletic,3-2,3,2,2,2,5,1,H
1969-03-01,1968,Norwich City,Birmingham City,1-1,1,1,2,2,2,0,D
1969-03-01,1968,Portsmouth,Huddersfield Town,1-2,1,2,2,2,3,-1,A
1969-03-01,1968,Preston North End,Middlesbrough,1-2,1,2,2,2,3,-1,A
1969-03-03,1968,Preston North End,Millwall,0-1,0,1,2,2,1,-1,A
1969-03-04,1968,Birmingham City,Sheffield United,2-2,2,2,2,2,4,0,D
1969-03-04,1968,Huddersfield Town,Bolton Wanderers,3-0,3,0,2,2,3,3,H
1969-03-04,1968,Middlesbrough,Aston Villa,0-0,0,0,2,2,0,0,D
1969-03-05,1968,Derby County,Crystal Palace,0-1,0,1,2,2,1,-1,A
1969-03-05,1968,Oxford United,Portsmouth,3-1,3,1,2,2,4,2,H
1969-03-07,1968,Bury,Bolton Wanderers,2-1,2,1,2,2,3,1,H
1969-03-07,1968,Cardiff City,Norwich City,3-1,3,1,2,2,4,2,H
1969-03-08,1968,Birmingham City,Crystal Palace,0-1,0,1,2,2,1,-1,A
1969-03-08,1968,Blackburn Rovers,Hull City,1-1,1,1,2,2,2,0,D
1969-03-08,1968,Blackpool,Derby County,2-3,2,3,2,2,5,-1,A
1969-03-08,1968,Charlton Athletic,Carlisle United,1-1,1,1,2,2,2,0,D
1969-03-08,1968,Fulham,Aston Villa,1-1,1,1,2,2,2,0,D
1969-03-08,1968,Huddersfield Town,Preston North End,1-1,1,1,2,2,2,0,D
1969-03-08,1968,Middlesbrough,Portsmouth,1-0,1,0,2,2,1,1,H
1969-03-08,1968,Oxford United,Millwall,1-0,1,0,2,2,1,1,H
1969-03-08,1968,Sheffield United,Bristol City,2-1,2,1,2,2,3,1,H
1969-03-11,1968,Carlisle United,Derby County,1-1,1,1,2,2,2,0,D
1969-03-11,1968,Sheffield United,Cardiff City,2-2,2,2,2,2,4,0,D
1969-03-14,1968,Hull City,Oxford United,0-0,0,0,2,2,0,0,D
1969-03-14,1968,Millwall,Sheffield United,1-0,1,0,2,2,1,1,H
1969-03-15,1968,Aston Villa,Blackburn Rovers,1-1,1,1,2,2,2,0,D
1969-03-15,1968,Bolton Wanderers,Fulham,3-2,3,2,2,2,5,1,H
1969-03-15,1968,Bristol City,Blackpool,1-1,1,1,2,2,2,0,D
1969-03-15,1968,Carlisle United,Middlesbrough,3-0,3,0,2,2,3,3,H
1969-03-15,1968,Crystal Palace,Bury,1-0,1,0,2,2,1,1,H
1969-03-15,1968,Derby County,Huddersfield Town,1-0,1,0,2,2,1,1,H
1969-03-15,1968,Norwich City,Charlton Athletic,0-1,0,1,2,2,1,-1,A
1969-03-15,1968,Portsmouth,Birmingham City,0-0,0,0,2,2,0,0,D
1969-03-15,1968,Preston North End,Cardiff City,0-1,0,1,2,2,1,-1,A
1969-03-17,1968,Preston North End,Sheffield United,2-2,2,2,2,2,4,0,D
1969-03-19,1968,Blackpool,Norwich City,2-1,2,1,2,2,3,1,H
1969-03-19,1968,Crystal Palace,Millwall,4-2,4,2,2,2,6,2,H
1969-03-21,1968,Birmingham City,Preston North End,3-1,3,1,2,2,4,2,H
1969-03-21,1968,Cardiff City,Portsmouth,2-2,2,2,2,2,4,0,D
1969-03-22,1968,Blackburn Rovers,Bristol City,1-3,1,3,2,2,4,-2,A
1969-03-22,1968,Blackpool,Aston Villa,1-1,1,1,2,2,2,0,D
1969-03-22,1968,Bury,Norwich City,1-2,1,2,2,2,3,-1,A
1969-03-22,1968,Charlton Athletic,Crystal Palace,1-1,1,1,2,2,2,0,D
1969-03-22,1968,Fulham,Millwall,2-0,2,0,2,2,2,2,H
1969-03-22,1968,Huddersfield Town,Carlisle United,2-0,2,0,2,2,2,2,H
1969-03-22,1968,Middlesbrough,Hull City,5-3,5,3,2,2,8,2,H
1969-03-22,1968,Oxford United,Derby County,0-2,0,2,2,2,2,-2,A
1969-03-22,1968,Sheffield United,Bolton Wanderers,5-2,5,2,2,2,7,3,H
1969-03-24,1968,Cardiff City,Fulham,0-2,0,2,2,2,2,-2,A
1969-03-25,1968,Birmingham City,Bolton Wanderers,5-0,5,0,2,2,5,5,H
1969-03-25,1968,Blackburn Rovers,Middlesbrough,1-1,1,1,2,2,2,0,D
1969-03-25,1968,Charlton Athletic,Sheffield United,2-1,2,1,2,2,3,1,H
1969-03-26,1968,Bury,Blackpool,2-0,2,0,2,2,2,2,H
1969-03-26,1968,Crystal Palace,Oxford United,1-1,1,1,2,2,2,0,D
1969-03-26,1968,Norwich City,Bristol City,1-1,1,1,2,2,2,0,D
1969-03-28,1968,Millwall,Blackburn Rovers,2-2,2,2,2,2,4,0,D
1969-03-29,1968,Aston Villa,Derby County,0-1,0,1,2,2,1,-1,A
1969-03-29,1968,Bolton Wanderers,Blackpool,1-4,1,4,2,2,5,-3,A
1969-03-29,1968,Bristol City,Hull City,1-1,1,1,2,2,2,0,D
1969-03-29,1968,Carlisle United,Crystal Palace,1-2,1,2,2,2,3,-1,A
1969-03-29,1968,Fulham,Oxford United,0-1,0,1,2,2,1,-1,A
1969-03-29,1968,Huddersfield Town,Birmingham City,0-0,0,0,2,2,0,0,D
1969-03-29,1968,Middlesbrough,Cardiff City,0-0,0,0,2,2,0,0,D
1969-03-29,1968,Portsmouth,Charlton Athletic,4-1,4,1,2,2,5,3,H
1969-03-29,1968,Preston North End,Bury,3-0,3,0,2,2,3,3,H
1969-03-29,1968,Sheffield United,Norwich City,1-0,1,0,2,2,1,1,H
1969-04-02,1968,Fulham,Derby County,0-1,0,1,2,2,1,-1,A
1969-04-04,1968,Charlton Athletic,Cardiff City,4-1,4,1,2,2,5,3,H
1969-04-04,1968,Crystal Palace,Middlesbrough,0-0,0,0,2,2,0,0,D
1969-04-04,1968,Millwall,Aston Villa,0-1,0,1,2,2,1,-1,A
1969-04-04,1968,Oxford United,Blackburn Rovers,2-1,2,1,2,2,3,1,H
1969-04-05,1968,Birmingham City,Carlisle United,3-0,3,0,2,2,3,3,H
1969-04-05,1968,Blackburn Rovers,Fulham,2-2,2,2,2,2,4,0,D
1969-04-05,1968,Blackpool,Sheffield United,1-1,1,1,2,2,2,0,D
1969-04-05,1968,Bury,Huddersfield Town,1-1,1,1,2,2,2,0,D
1969-04-05,1968,Charlton Athletic,Middlesbrough,2-0,2,0,2,2,2,2,H
1969-04-05,1968,Crystal Palace,Portsmouth,3-1,3,1,2,2,4,2,H
1969-04-05,1968,Derby County,Bolton Wanderers,5-1,5,1,2,2,6,4,H
1969-04-05,1968,Hull City,Millwall,2-0,2,0,2,2,2,2,H
1969-04-05,1968,Norwich City,Preston North End,1-1,1,1,2,2,2,0,D
1969-04-05,1968,Oxford United,Aston Villa,1-0,1,0,2,2,1,1,H
1969-04-07,1968,Birmingham City,Charlton Athletic,0-0,0,0,2,2,0,0,D
1969-04-07,1968,Blackburn Rovers,Portsmouth,3-1,3,1,2,2,4,2,H
1969-04-07,1968,Blackpool,Oxford United,1-0,1,0,2,2,1,1,H
1969-04-07,1968,Bolton Wanderers,Bristol City,1-0,1,0,2,2,1,1,H
1969-04-07,1968,Cardiff City,Bury,2-0,2,0,2,2,2,2,H
1969-04-07,1968,Carlisle United,Preston North End,1-0,1,0,2,2,1,1,H
1969-04-07,1968,Derby County,Sheffield United,1-0,1,0,2,2,1,1,H
1969-04-07,1968,Hull City,Fulham,4-0,4,0,2,2,4,4,H
1969-04-07,1968,Norwich City,Huddersfield Town,1-0,1,0,2,2,1,1,H
1969-04-08,1968,Aston Villa,Bolton Wanderers,1-1,1,1,2,2,2,0,D
1969-04-08,1968,Bristol City,Millwall,0-0,0,0,2,2,0,0,D
1969-04-08,1968,Bury,Birmingham City,1-2,1,2,2,2,3,-1,A
1969-04-08,1968,Huddersfield Town,Crystal Palace,0-0,0,0,2,2,0,0,D
1969-04-08,1968,Middlesbrough,Norwich City,0-0,0,0,2,2,0,0,D
1969-04-08,1968,Preston North End,Blackpool,1-0,1,0,2,2,1,1,H
1969-04-08,1968,Sheffield United,Hull City,1-1,1,1,2,2,2,0,D
1969-04-09,1968,Portsmouth,Carlisle United,2-1,2,1,2,2,3,1,H
1969-04-12,1968,Aston Villa,Birmingham City,1-0,1,0,2,2,1,1,H
1969-04-12,1968,Bolton Wanderers,Hull City,1-0,1,0,2,2,1,1,H
1969-04-12,1968,Bristol City,Oxford United,2-0,2,0,2,2,2,2,H
1969-04-12,1968,Carlisle United,Cardiff City,1-0,1,0,2,2,1,1,H
1969-04-12,1968,Fulham,Blackpool,0-0,0,0,2,2,0,0,D
1969-04-12,1968,Huddersfield Town,Charlton Athletic,0-0,0,0,2,2,0,0,D
1969-04-12,1968,Middlesbrough,Bury,2-3,2,3,2,2,5,-1,A
1969-04-12,1968,Millwall,Derby County,0-1,0,1,2,2,1,-1,A
1969-04-12,1968,Portsmouth,Norwich City,5-2,5,2,2,2,7,3,H
1969-04-12,1968,Preston North End,Crystal Palace,0-0,0,0,2,2,0,0,D
1969-04-12,1968,Sheffield United,Blackburn Rovers,3-0,3,0,2,2,3,3,H
1969-04-15,1968,Bury,Bristol City,1-2,1,2,2,2,3,-1,A
1969-04-15,1968,Charlton Athletic,Blackburn Rovers,4-0,4,0,2,2,4,4,H
1969-04-15,1968,Huddersfield Town,Fulham,3-0,3,0,2,2,3,3,H
1969-04-15,1968,Hull City,Birmingham City,1-2,1,2,2,2,3,-1,A
1969-04-16,1968,Bolton Wanderers,Preston North End,0-0,0,0,2,2,0,0,D
1969-04-16,1968,Norwich City,Derby County,1-4,1,4,2,2,5,-3,A
1969-04-18,1968,Bury,Portsmouth,3-2,3,2,2,2,5,1,H
1969-04-19,1968,Birmingham City,Middlesbrough,3-1,3,1,2,2,4,2,H
1969-04-19,1968,Blackburn Rovers,Bolton Wanderers,2-3,2,3,2,2,5,-1,A
1969-04-19,1968,Blackpool,Millwall,1-0,1,0,2,2,1,1,H
1969-04-19,1968,Cardiff City,Huddersfield Town,0-2,0,2,2,2,2,-2,A
1969-04-19,1968,Charlton Athletic,Preston North End,0-1,0,1,2,2,1,-1,A
1969-04-19,1968,Crystal Palace,Fulham,3-2,3,2,2,2,5,1,H
1969-04-19,1968,Derby County,Bristol City,5-0,5,0,2,2,5,5,H
1969-04-19,1968,Hull City,Aston Villa,1-0,1,0,2,2,1,1,H
1969-04-19,1968,Norwich City,Carlisle United,2-1,2,1,2,2,3,1,H
1969-04-19,1968,Oxford United,Sheffield United,1-0,1,0,2,2,1,1,H
1969-04-23,1968,Norwich City,Blackburn Rovers,3-1,3,1,2,2,4,2,H
1969-04-28,1968,Blackburn Rovers,Crystal Palace,1-2,1,2,2,2,3,-1,A
1969-04-30,1968,Huddersfield Town,Blackburn Rovers,2-1,2,1,2,2,3,1,H
1969-08-09,1969,Aston Villa,Norwich City,0-1,0,1,2,2,1,-1,A
1969-08-09,1969,Blackburn Rovers,Swindon Town,2-0,2,0,2,2,2,2,H
1969-08-09,1969,Blackpool,Portsmouth,2-1,2,1,2,2,3,1,H
1969-08-09,1969,Bolton Wanderers,Millwall,4-1,4,1,2,2,5,3,H
1969-08-09,1969,Bristol City,Watford,1-0,1,0,2,2,1,1,H
1969-08-09,1969,Carlisle United,Cardiff City,2-3,2,3,2,2,5,-1,A
1969-08-09,1969,Charlton Athletic,Preston North End,2-1,2,1,2,2,3,1,H
1969-08-09,1969,Leicester City,Birmingham City,3-1,3,1,2,2,4,2,H
1969-08-09,1969,Oxford United,Huddersfield Town,1-2,1,2,2,2,3,-1,A
1969-08-09,1969,Queens Park Rangers,Hull City,3-0,3,0,2,2,3,3,H
1969-08-09,1969,Sheffield United,Middlesbrough,3-0,3,0,2,2,3,3,H
1969-08-12,1969,Middlesbrough,Millwall,3-1,3,1,2,2,4,2,H
1969-08-12,1969,Sheffield United,Charlton Athletic,2-0,2,0,2,2,2,2,H
1969-08-13,1969,Cardiff City,Swindon Town,2-2,2,2,2,2,4,0,D
1969-08-13,1969,Hull City,Norwich City,1-0,1,0,2,2,1,1,H
1969-08-16,1969,Birmingham City,Oxford United,1-3,1,3,2,2,4,-2,A
1969-08-16,1969,Cardiff City,Blackburn Rovers,0-0,0,0,2,2,0,0,D
1969-08-16,1969,Huddersfield Town,Aston Villa,2-0,2,0,2,2,2,2,H
1969-08-16,1969,Hull City,Bristol City,2-0,2,0,2,2,2,2,H
1969-08-16,1969,Middlesbrough,Leicester City,2-1,2,1,2,2,3,1,H
1969-08-16,1969,Millwall,Charlton Athletic,1-1,1,1,2,2,2,0,D
1969-08-16,1969,Norwich City,Blackpool,3-1,3,1,2,2,4,2,H
1969-08-16,1969,Portsmouth,Sheffield United,1-5,1,5,2,2,6,-4,A
1969-08-16,1969,Preston North End,Queens Park Rangers,0-0,0,0,2,2,0,0,D
1969-08-16,1969,Swindon Town,Carlisle United,2-2,2,2,2,2,4,0,D
1969-08-16,1969,Watford,Bolton Wanderers,0-0,0,0,2,2,0,0,D
1969-08-18,1969,Blackpool,Blackburn Rovers,0-0,0,0,2,2,0,0,D
1969-08-18,1969,Millwall,Middlesbrough,1-1,1,1,2,2,2,0,D
1969-08-19,1969,Birmingham City,Portsmouth,1-1,1,1,2,2,2,0,D
1969-08-19,1969,Carlisle United,Aston Villa,1-1,1,1,2,2,2,0,D
1969-08-19,1969,Charlton Athletic,Sheffield United,3-2,3,2,2,2,5,1,H
1969-08-19,1969,Huddersfield Town,Preston North End,3-2,3,2,2,2,5,1,H
1969-08-19,1969,Swindon Town,Cardiff City,2-1,2,1,2,2,3,1,H
1969-08-20,1969,Leicester City,Bolton Wanderers,2-2,2,2,2,2,4,0,D
1969-08-20,1969,Norwich City,Hull City,2-1,2,1,2,2,3,1,H
1969-08-20,1969,Watford,Queens Park Rangers,0-1,0,1,2,2,1,-1,A
1969-08-23,1969,Aston Villa,Swindon Town,0-2,0,2,2,2,2,-2,A
1969-08-23,1969,Blackburn Rovers,Hull City,2-1,2,1,2,2,3,1,H
1969-08-23,1969,Blackpool,Birmingham City,2-0,2,0,2,2,2,2,H
1969-08-23,1969,Bolton Wanderers,Preston North End,2-0,2,0,2,2,2,2,H
1969-08-23,1969,Bristol City,Cardiff City,0-2,0,2,2,2,2,-2,A
1969-08-23,1969,Carlisle United,Middlesbrough,1-0,1,0,2,2,1,1,H
1969-08-23,1969,Charlton Athletic,Watford,0-0,0,0,2,2,0,0,D
1969-08-23,1969,Leicester City,Norwich City,3-0,3,0,2,2,3,3,H
1969-08-23,1969,Oxford United,Portsmouth,0-2,0,2,2,2,2,-2,A
1969-08-23,1969,Queens Park Rangers,Millwall,3-2,3,2,2,2,5,1,H
1969-08-23,1969,Sheffield United,Huddersfield Town,0-0,0,0,2,2,0,0,D
1969-08-25,1969,Preston North End,Watford,3-0,3,0,2,2,3,3,H
1969-08-26,1969,Carlisle United,Bolton Wanderers,2-1,2,1,2,2,3,1,H
1969-08-26,1969,Charlton Athletic,Oxford United,1-0,1,0,2,2,1,1,H
1969-08-26,1969,Huddersfield Town,Blackburn Rovers,0-1,0,1,2,2,1,-1,A
1969-08-26,1969,Queens Park Rangers,Blackpool,6-1,6,1,2,2,7,5,H
1969-08-26,1969,Sheffield United,Bristol City,2-1,2,1,2,2,3,1,H
1969-08-27,1969,Aston Villa,Leicester City,0-1,0,1,2,2,1,-1,A
1969-08-27,1969,Cardiff City,Middlesbrough,1-0,1,0,2,2,1,1,H
1969-08-27,1969,Hull City,Birmingham City,0-0,0,0,2,2,0,0,D
1969-08-27,1969,Norwich City,Portsmouth,0-0,0,0,2,2,0,0,D
1969-08-29,1969,Hull City,Blackpool,1-0,1,0,2,2,1,1,H
1969-08-30,1969,Birmingham City,Queens Park Rangers,3-0,3,0,2,2,3,3,H
1969-08-30,1969,Cardiff City,Bolton Wanderers,2-1,2,1,2,2,3,1,H
1969-08-30,1969,Huddersfield Town,Bristol City,3-0,3,0,2,2,3,3,H
1969-08-30,1969,Middlesbrough,Aston Villa,1-0,1,0,2,2,1,1,H
1969-08-30,1969,Millwall,Leicester City,0-1,0,1,2,2,1,-1,A
1969-08-30,1969,Norwich City,Carlisle United,1-0,1,0,2,2,1,1,H
1969-08-30,1969,Portsmouth,Blackburn Rovers,2-0,2,0,2,2,2,2,H
1969-08-30,1969,Preston North End,Oxford United,0-1,0,1,2,2,1,-1,A
1969-08-30,1969,Swindon Town,Charlton Athletic,5-0,5,0,2,2,5,5,H
1969-08-30,1969,Watford,Sheffield United,1-2,1,2,2,2,3,-1,A
1969-09-06,1969,Aston Villa,Millwall,2-2,2,2,2,2,4,0,D
1969-09-06,1969,Blackburn Rovers,Middlesbrough,4-0,4,0,2,2,4,4,H
1969-09-06,1969,Blackpool,Swindon Town,3-2,3,2,2,2,5,1,H
1969-09-06,1969,Bolton Wanderers,Birmingham City,2-0,2,0,2,2,2,2,H
1969-09-06,1969,Bristol City,Preston North End,0-0,0,0,2,2,0,0,D
1969-09-06,1969,Carlisle United,Hull City,2-1,2,1,2,2,3,1,H
1969-09-06,1969,Charlton Athletic,Cardiff City,0-0,0,0,2,2,0,0,D
1969-09-06,1969,Leicester City,Portsmouth,2-1,2,1,2,2,3,1,H
1969-09-06,1969,Oxford United,Watford,2-1,2,1,2,2,3,1,H
1969-09-06,1969,Queens Park Rangers,Huddersfield Town,4-2,4,2,2,2,6,2,H
1969-09-06,1969,Sheffield United,Norwich City,1-0,1,0,2,2,1,1,H
1969-09-13,1969,Birmingham City,Sheffield United,2-1,2,1,2,2,3,1,H
1969-09-13,1969,Cardiff City,Leicester City,1-1,1,1,2,2,2,0,D
1969-09-13,1969,Huddersfield Town,Blackpool,2-0,2,0,2,2,2,2,H
1969-09-13,1969,Hull City,Bolton Wanderers,4-2,4,2,2,2,6,2,H
1969-09-13,1969,Middlesbrough,Bristol City,2-0,2,0,2,2,2,2,H
1969-09-13,1969,Millwall,Carlisle United,4-2,4,2,2,2,6,2,H
1969-09-13,1969,Norwich City,Charlton Athletic,1-1,1,1,2,2,2,0,D
1969-09-13,1969,Portsmouth,Queens Park Rangers,1-3,1,3,2,2,4,-2,A
1969-09-13,1969,Preston North End,Blackburn Rovers,0-0,0,0,2,2,0,0,D
1969-09-13,1969,Swindon Town,Oxford United,0-0,0,0,2,2,0,0,D
1969-09-13,1969,Watford,Aston Villa,3-0,3,0,2,2,3,3,H
1969-09-15,1969,Blackpool,Preston North End,0-0,0,0,2,2,0,0,D
1969-09-16,1969,Birmingham City,Norwich City,3-1,3,1,2,2,4,2,H
1969-09-16,1969,Middlesbrough,Swindon Town,0-0,0,0,2,2,0,0,D
1969-09-17,1969,Blackburn Rovers,Queens Park Rangers,0-1,0,1,2,2,1,-1,A
1969-09-17,1969,Bolton Wanderers,Aston Villa,2-1,2,1,2,2,3,1,H
1969-09-17,1969,Leicester City,Carlisle United,1-2,1,2,2,2,3,-1,A
1969-09-17,1969,Oxford United,Sheffield United,0-0,0,0,2,2,0,0,D
1969-09-17,1969,Portsmouth,Hull City,1-4,1,4,2,2,5,-3,A
1969-09-17,1969,Watford,Huddersfield Town,1-1,1,1,2,2,2,0,D
1969-09-20,1969,Aston Villa,Hull City,3-2,3,2,2,2,5,1,H
1969-09-20,1969,Blackburn Rovers,Millwall,4-0,4,0,2,2,4,4,H
1969-09-20,1969,Blackpool,Watford,0-3,0,3,2,2,3,-3,A
1969-09-20,1969,Bolton Wanderers,Portsmouth,0-1,0,1,2,2,1,-1,A
1969-09-20,1969,Bristol City,Norwich City,4-0,4,0,2,2,4,4,H
1969-09-20,1969,Carlisle United,Preston North End,1-0,1,0,2,2,1,1,H
1969-09-20,1969,Charlton Athletic,Birmingham City,0-1,0,1,2,2,1,-1,A
1969-09-20,1969,Leicester City,Huddersfield Town,1-1,1,1,2,2,2,0,D
1969-09-20,1969,Oxford United,Middlesbrough,1-1,1,1,2,2,2,0,D
1969-09-20,1969,Queens Park Rangers,Swindon Town,2-0,2,0,2,2,2,2,H
1969-09-20,1969,Sheffield United,Cardiff City,1-0,1,0,2,2,1,1,H
1969-09-23,1969,Bristol City,Charlton Athletic,6-0,6,0,2,2,6,6,H
1969-09-27,1969,Birmingham City,Carlisle United,1-1,1,1,2,2,2,0,D
1969-09-27,1969,Cardiff City,Queens Park Rangers,4-2,4,2,2,2,6,2,H
1969-09-27,1969,Huddersfield Town,Bolton Wanderers,1-0,1,0,2,2,1,1,H
1969-09-27,1969,Hull City,Charlton Athletic,1-1,1,1,2,2,2,0,D
1969-09-27,1969,Middlesbrough,Blackpool,0-2,0,2,2,2,2,-2,A
1969-09-27,1969,Millwall,Bristol City,1-1,1,1,2,2,2,0,D
1969-09-27,1969,Norwich City,Oxford United,2-0,2,0,2,2,2,2,H
1969-09-27,1969,Portsmouth,Aston Villa,0-0,0,0,2,2,0,0,D
1969-09-27,1969,Preston North End,Sheffield United,2-1,2,1,2,2,3,1,H
1969-09-27,1969,Swindon Town,Leicester City,1-1,1,1,2,2,2,0,D
1969-09-27,1969,Watford,Blackburn Rovers,0-2,0,2,2,2,2,-2,A
1969-09-30,1969,Swindon Town,Millwall,2-1,2,1,2,2,3,1,H
1969-10-04,1969,Aston Villa,Preston North End,0-0,0,0,2,2,0,0,D
1969-10-04,1969,Blackburn Rovers,Norwich City,3-1,3,1,2,2,4,2,H
1969-10-04,1969,Blackpool,Cardiff City,3-2,3,2,2,2,5,1,H
1969-10-04,1969,Bolton Wanderers,Swindon Town,0-1,0,1,2,2,1,-1,A
1969-10-04,1969,Bristol City,Birmingham City,2-0,2,0,2,2,2,2,H
1969-10-04,1969,Carlisle United,Huddersfield Town,0-2,0,2,2,2,2,-2,A
1969-10-04,1969,Charlton Athletic,Portsmouth,2-2,2,2,2,2,4,0,D
1969-10-04,1969,Leicester City,Watford,3-1,3,1,2,2,4,2,H
1969-10-04,1969,Oxford United,Millwall,0-0,0,0,2,2,0,0,D
1969-10-04,1969,Queens Park Rangers,Middlesbrough,4-0,4,0,2,2,4,4,H
1969-10-04,1969,Sheffield United,Hull City,3-0,3,0,2,2,3,3,H
1969-10-06,1969,Blackpool,Norwich City,0-0,0,0,2,2,0,0,D
1969-10-07,1969,Bristol City,Hull City,3-1,3,1,2,2,4,2,H
1969-10-07,1969,Carlisle United,Swindon Town,2-2,2,2,2,2,4,0,D
1969-10-07,1969,Charlton Athletic,Millwall,2-2,2,2,2,2,4,0,D
1969-10-07,1969,Queens Park Rangers,Preston North End,0-0,0,0,2,2,0,0,D
1969-10-07,1969,Sheffield United,Portsmouth,5-0,5,0,2,2,5,5,H
1969-10-08,1969,Aston Villa,Huddersfield Town,4-1,4,1,2,2,5,3,H
1969-10-08,1969,Blackburn Rovers,Cardiff City,1-0,1,0,2,2,1,1,H
1969-10-08,1969,Bolton Wanderers,Watford,2-3,2,3,2,2,5,-1,A
1969-10-08,1969,Leicester City,Middlesbrough,2-1,2,1,2,2,3,1,H
1969-10-08,1969,Oxford United,Birmingham City,2-0,2,0,2,2,2,2,H
1969-10-11,1969,Birmingham City,Blackburn Rovers,3-0,3,0,2,2,3,3,H
1969-10-11,1969,Cardiff City,Aston Villa,4-0,4,0,2,2,4,4,H
1969-10-11,1969,Huddersfield Town,Charlton Athletic,4-0,4,0,2,2,4,4,H
1969-10-11,1969,Hull City,Oxford United,3-1,3,1,2,2,4,2,H
1969-10-11,1969,Middlesbrough,Bolton Wanderers,4-0,4,0,2,2,4,4,H
1969-10-11,1969,Millwall,Blackpool,1-3,1,3,2,2,4,-2,A
1969-10-11,1969,Norwich City,Queens Park Rangers,1-0,1,0,2,2,1,1,H
1969-10-11,1969,Portsmouth,Bristol City,0-0,0,0,2,2,0,0,D
1969-10-11,1969,Preston North End,Leicester City,2-1,2,1,2,2,3,1,H
1969-10-11,1969,Swindon Town,Sheffield United,2-1,2,1,2,2,3,1,H
1969-10-11,1969,Watford,Carlisle United,1-2,1,2,2,2,3,-1,A
1969-10-18,1969,Aston Villa,Birmingham City,0-0,0,0,2,2,0,0,D
1969-10-18,1969,Bolton Wanderers,Oxford United,1-1,1,1,2,2,2,0,D
1969-10-18,1969,Cardiff City,Norwich City,0-1,0,1,2,2,1,-1,A
1969-10-18,1969,Carlisle United,Queens Park Rangers,3-2,3,2,2,2,5,1,H
1969-10-18,1969,Charlton Athletic,Blackburn Rovers,0-0,0,0,2,2,0,0,D
1969-10-18,1969,Huddersfield Town,Middlesbrough,0-0,0,0,2,2,0,0,D
1969-10-18,1969,Leicester City,Bristol City,2-0,2,0,2,2,2,2,H
1969-10-18,1969,Preston North End,Millwall,1-1,1,1,2,2,2,0,D
1969-10-18,1969,Sheffield United,Blackpool,2-3,2,3,2,2,5,-1,A
1969-10-18,1969,Swindon Town,Hull City,1-0,1,0,2,2,1,1,H
1969-10-18,1969,Watford,Portsmouth,4-0,4,0,2,2,4,4,H
1969-10-25,1969,Birmingham City,Cardiff City,1-1,1,1,2,2,2,0,D
1969-10-25,1969,Blackburn Rovers,Leicester City,3-1,3,1,2,2,4,2,H
1969-10-25,1969,Blackpool,Bolton Wanderers,1-1,1,1,2,2,2,0,D
1969-10-25,1969,Bristol City,Carlisle United,0-0,0,0,2,2,0,0,D
1969-10-25,1969,Hull City,Huddersfield Town,2-3,2,3,2,2,5,-1,A
1969-10-25,1969,Middlesbrough,Watford,3-1,3,1,2,2,4,2,H
1969-10-25,1969,Millwall,Sheffield United,1-0,1,0,2,2,1,1,H
1969-10-25,1969,Norwich City,Preston North End,1-2,1,2,2,2,3,-1,A
1969-10-25,1969,Oxford United,Aston Villa,2-2,2,2,2,2,4,0,D
1969-10-25,1969,Portsmouth,Swindon Town,3-1,3,1,2,2,4,2,H
1969-10-25,1969,Queens Park Rangers,Charlton Athletic,1-1,1,1,2,2,2,0,D
1969-11-01,1969,Aston Villa,Queens Park Rangers,1-1,1,1,2,2,2,0,D
1969-11-01,1969,Bolton Wanderers,Bristol City,3-1,3,1,2,2,4,2,H
1969-11-01,1969,Cardiff City,Hull City,6-0,6,0,2,2,6,6,H
1969-11-01,1969,Carlisle United,Portsmouth,3-3,3,3,2,2,6,0,D
1969-11-01,1969,Charlton Athletic,Blackpool,0-2,0,2,2,2,2,-2,A
1969-11-01,1969,Huddersfield Town,Millwall,0-0,0,0,2,2,0,0,D
1969-11-01,1969,Leicester City,Oxford United,2-1,2,1,2,2,3,1,H
1969-11-01,1969,Preston North End,Middlesbrough,0-1,0,1,2,2,1,-1,A
1969-11-01,1969,Sheffield United,Blackburn Rovers,4-0,4,0,2,2,4,4,H
1969-11-01,1969,Swindon Town,Norwich City,2-0,2,0,2,2,2,2,H
1969-11-01,1969,Watford,Birmingham City,2-3,2,3,2,2,5,-1,A
1969-11-08,1969,Birmingham City,Swindon Town,2-0,2,0,2,2,2,2,H
1969-11-08,1969,Blackburn Rovers,Bolton Wanderers,3-1,3,1,2,2,4,2,H
1969-11-08,1969,Blackpool,Leicester City,1-1,1,1,2,2,2,0,D
1969-11-08,1969,Bristol City,Aston Villa,1-0,1,0,2,2,1,1,H
1969-11-08,1969,Hull City,Preston North End,3-1,3,1,2,2,4,2,H
1969-11-08,1969,Middlesbrough,Charlton Athletic,2-0,2,0,2,2,2,2,H
1969-11-08,1969,Millwall,Watford,1-0,1,0,2,2,1,1,H
1969-11-08,1969,Norwich City,Huddersfield Town,1-2,1,2,2,2,3,-1,A
1969-11-08,1969,Oxford United,Carlisle United,1-0,1,0,2,2,1,1,H
1969-11-08,1969,Portsmouth,Cardiff City,3-0,3,0,2,2,3,3,H
1969-11-08,1969,Queens Park Rangers,Sheffield United,2-1,2,1,2,2,3,1,H
1969-11-10,1969,Preston North End,Huddersfield Town,1-3,1,3,2,2,4,-2,A
1969-11-11,1969,Bristol City,Oxford United,2-0,2,0,2,2,2,2,H
1969-11-11,1969,Queens Park Rangers,Watford,2-1,2,1,2,2,3,1,H
1969-11-12,1969,Aston Villa,Carlisle United,1-0,1,0,2,2,1,1,H
1969-11-12,1969,Blackburn Rovers,Blackpool,2-1,2,1,2,2,3,1,H
1969-11-12,1969,Bolton Wanderers,Leicester City,2-3,2,3,2,2,5,-1,A
1969-11-12,1969,Portsmouth,Birmingham City,1-1,1,1,2,2,2,0,D
1969-11-15,1969,Aston Villa,Blackpool,0-0,0,0,2,2,0,0,D
1969-11-15,1969,Bolton Wanderers,Sheffield United,0-0,0,0,2,2,0,0,D
1969-11-15,1969,Bristol City,Queens Park Rangers,2-0,2,0,2,2,2,2,H
1969-11-15,1969,Carlisle United,Blackburn Rovers,0-1,0,1,2,2,1,-1,A
1969-11-15,1969,Huddersfield Town,Portsmouth,4-0,4,0,2,2,4,4,H
1969-11-15,1969,Leicester City,Charlton Athletic,2-2,2,2,2,2,4,0,D
1969-11-15,1969,Middlesbrough,Hull City,1-0,1,0,2,2,1,1,H
1969-11-15,1969,Millwall,Norwich City,1-0,1,0,2,2,1,1,H
1969-11-15,1969,Oxford United,Cardiff City,1-1,1,1,2,2,2,0,D
1969-11-15,1969,Preston North End,Birmingham City,4-1,4,1,2,2,5,3,H
1969-11-15,1969,Watford,Swindon Town,0-0,0,0,2,2,0,0,D
1969-11-19,1969,Aston Villa,Bolton Wanderers,3-0,3,0,2,2,3,3,H
1969-11-22,1969,Birmingham City,Millwall,2-0,2,0,2,2,2,2,H
1969-11-22,1969,Blackburn Rovers,Bristol City,3-3,3,3,2,2,6,0,D
1969-11-22,1969,Blackpool,Oxford United,1-0,1,0,2,2,1,1,H
1969-11-22,1969,Cardiff City,Preston North End,2-1,2,1,2,2,3,1,H
1969-11-22,1969,Charlton Athletic,Carlisle United,2-1,2,1,2,2,3,1,H
1969-11-22,1969,Hull City,Watford,1-1,1,1,2,2,2,0,D
1969-11-22,1969,Norwich City,Bolton Wanderers,1-0,1,0,2,2,1,1,H
1969-11-22,1969,Portsmouth,Middlesbrough,2-3,2,3,2,2,5,-1,A
1969-11-22,1969,Queens Park Rangers,Leicester City,1-1,1,1,2,2,2,0,D
1969-11-22,1969,Sheffield United,Aston Villa,5-0,5,0,2,2,5,5,H
1969-11-22,1969,Swindon Town,Huddersfield Town,2-1,2,1,2,2,3,1,H
1969-11-29,1969,Bolton Wanderers,Queens Park Rangers,6-4,6,4,2,2,10,2,H
1969-11-29,1969,Bristol City,Blackpool,2-1,2,1,2,2,3,1,H
1969-11-29,1969,Carlisle United,Sheffield United,0-1,0,1,2,2,1,-1,A
1969-11-29,1969,Oxford United,Blackburn Rovers,1-0,1,0,2,2,1,1,H
1969-11-29,1969,Preston North End,Swindon Town,3-1,3,1,2,2,4,2,H
1969-12-06,1969,Birmingham City,Huddersfield Town,2-2,2,2,2,2,4,0,D
1969-12-06,1969,Blackburn Rovers,Aston Villa,2-0,2,0,2,2,2,2,H
1969-12-06,1969,Blackpool,Carlisle United,1-1,1,1,2,2,2,0,D
1969-12-06,1969,Cardiff City,Watford,3-1,3,1,2,2,4,2,H
1969-12-06,1969,Charlton Athletic,Bolton Wanderers,1-1,1,1,2,2,2,0,D
1969-12-06,1969,Portsmouth,Preston North End,4-0,4,0,2,2,4,4,H
1969-12-06,1969,Queens Park Rangers,Oxford United,1-2,1,2,2,2,3,-1,A
1969-12-06,1969,Sheffield United,Leicester City,1-0,1,0,2,2,1,1,H
1969-12-06,1969,Swindon Town,Bristol City,1-1,1,1,2,2,2,0,D
1969-12-08,1969,Millwall,Portsmouth,3-1,3,1,2,2,4,2,H
1969-12-13,1969,Aston Villa,Watford,0-2,0,2,2,2,2,-2,A
1969-12-13,1969,Blackburn Rovers,Preston North End,4-2,4,2,2,2,6,2,H
1969-12-13,1969,Blackpool,Huddersfield Town,2-0,2,0,2,2,2,2,H
1969-12-13,1969,Bolton Wanderers,Hull City,2-1,2,1,2,2,3,1,H
1969-12-13,1969,Bristol City,Middlesbrough,0-0,0,0,2,2,0,0,D
1969-12-13,1969,Carlisle United,Millwall,4-0,4,0,2,2,4,4,H
1969-12-13,1969,Charlton Athletic,Norwich City,3-0,3,0,2,2,3,3,H
1969-12-13,1969,Leicester City,Cardiff City,1-2,1,2,2,2,3,-1,A
1969-12-13,1969,Oxford United,Swindon Town,0-0,0,0,2,2,0,0,D
1969-12-13,1969,Queens Park Rangers,Portsmouth,2-0,2,0,2,2,2,2,H
1969-12-13,1969,Sheffield United,Birmingham City,6-0,6,0,2,2,6,6,H
1969-12-15,1969,Millwall,Cardiff City,1-2,1,2,2,2,3,-1,A
1969-12-16,1969,Middlesbrough,Birmingham City,4-2,4,2,2,2,6,2,H
1969-12-17,1969,Leicester City,Hull City,2-2,2,2,2,2,4,0,D
1969-12-20,1969,Cardiff City,Charlton Athletic,1-0,1,0,2,2,1,1,H
1969-12-20,1969,Hull City,Carlisle United,2-4,2,4,2,2,6,-2,A
1969-12-20,1969,Norwich City,Sheffield United,1-1,1,1,2,2,2,0,D
1969-12-20,1969,Portsmouth,Leicester City,2-3,2,3,2,2,5,-1,A
1969-12-20,1969,Watford,Oxford United,2-0,2,0,2,2,2,2,H
1969-12-26,1969,Birmingham City,Blackpool,2-3,2,3,2,2,5,-1,A
1969-12-26,1969,Huddersfield Town,Sheffield United,2-1,2,1,2,2,3,1,H
1969-12-26,1969,Hull City,Blackburn Rovers,3-0,3,0,2,2,3,3,H
1969-12-26,1969,Middlesbrough,Carlisle United,0-2,0,2,2,2,2,-2,A
1969-12-26,1969,Millwall,Queens Park Rangers,2-0,2,0,2,2,2,2,H
1969-12-26,1969,Norwich City,Leicester City,3-0,3,0,2,2,3,3,H
1969-12-26,1969,Preston North End,Bolton Wanderers,1-3,1,3,2,2,4,-2,A
1969-12-26,1969,Swindon Town,Aston Villa,1-1,1,1,2,2,2,0,D
1969-12-26,1969,Watford,Charlton Athletic,1-1,1,1,2,2,2,0,D
1969-12-27,1969,Blackburn Rovers,Portsmouth,0-3,0,3,2,2,3,-3,A
1969-12-27,1969,Bristol City,Huddersfield Town,1-2,1,2,2,2,3,-1,A
1969-12-27,1969,Carlisle United,Norwich City,2-1,2,1,2,2,3,1,H
1969-12-27,1969,Charlton Athletic,Swindon Town,1-1,1,1,2,2,2,0,D
1969-12-27,1969,Leicester City,Millwall,1-1,1,1,2,2,2,0,D
1969-12-27,1969,Queens Park Rangers,Birmingham City,2-1,2,1,2,2,3,1,H
1969-12-27,1969,Sheffield United,Watford,1-1,1,1,2,2,2,0,D
1969-12-29,1969,Cardiff City,Bristol City,1-0,1,0,2,2,1,1,H
1970-01-10,1969,Birmingham City,Charlton Athletic,3-0,3,0,2,2,3,3,H
1970-01-10,1969,Cardiff City,Sheffield United,3-0,3,0,2,2,3,3,H
1970-01-10,1969,Middlesbrough,Oxford United,2-0,2,0,2,2,2,2,H
1970-01-10,1969,Norwich City,Bristol City,4-1,4,1,2,2,5,3,H
1970-01-10,1969,Portsmouth,Bolton Wanderers,1-1,1,1,2,2,2,0,D
1970-01-10,1969,Preston North End,Carlisle United,3-1,3,1,2,2,4,2,H
1970-01-10,1969,Swindon Town,Queens Park Rangers,0-0,0,0,2,2,0,0,D
1970-01-10,1969,Watford,Blackpool,0-1,0,1,2,2,1,-1,A
1970-01-13,1969,Middlesbrough,Blackburn Rovers,4-1,4,1,2,2,5,3,H
1970-01-17,1969,Aston Villa,Portsmouth,3-5,3,5,2,2,8,-2,A
1970-01-17,1969,Blackburn Rovers,Watford,1-0,1,0,2,2,1,1,H
1970-01-17,1969,Blackpool,Middlesbrough,1-1,1,1,2,2,2,0,D
1970-01-17,1969,Bolton Wanderers,Huddersfield Town,1-1,1,1,2,2,2,0,D
1970-01-17,1969,Bristol City,Millwall,1-1,1,1,2,2,2,0,D
1970-01-17,1969,Carlisle United,Birmingham City,4-3,4,3,2,2,7,1,H
1970-01-17,1969,Charlton Athletic,Hull City,1-4,1,4,2,2,5,-3,A
1970-01-17,1969,Leicester City,Swindon Town,0-2,0,2,2,2,2,-2,A
1970-01-17,1969,Oxford United,Norwich City,1-0,1,0,2,2,1,1,H
1970-01-17,1969,Queens Park Rangers,Cardiff City,2-1,2,1,2,2,3,1,H
1970-01-17,1969,Sheffield United,Preston North End,2-0,2,0,2,2,2,2,H
1970-01-20,1969,Huddersfield Town,Queens Park Rangers,2-0,2,0,2,2,2,2,H
1970-01-20,1969,Millwall,Blackburn Rovers,3-1,3,1,2,2,4,2,H
1970-01-24,1969,Huddersfield Town,Cardiff City,1-0,1,0,2,2,1,1,H
1970-01-24,1969,Hull City,Millwall,2-1,2,1,2,2,3,1,H
1970-01-24,1969,Portsmouth,Oxford United,2-1,2,1,2,2,3,1,H
1970-01-24,1969,Preston North End,Bristol City,0-1,0,1,2,2,1,-1,A
1970-01-31,1969,Birmingham City,Bristol City,2-2,2,2,2,2,4,0,D
1970-01-31,1969,Cardiff City,Blackpool,2-2,2,2,2,2,4,0,D
1970-01-31,1969,Huddersfield Town,Carlisle United,1-0,1,0,2,2,1,1,H
1970-01-31,1969,Hull City,Sheffield United,2-3,2,3,2,2,5,-1,A
1970-01-31,1969,Middlesbrough,Queens Park Rangers,1-0,1,0,2,2,1,1,H
1970-01-31,1969,Millwall,Oxford United,0-0,0,0,2,2,0,0,D
1970-01-31,1969,Norwich City,Blackburn Rovers,0-1,0,1,2,2,1,-1,A
1970-01-31,1969,Portsmouth,Charlton Athletic,5-1,5,1,2,2,6,4,H
1970-01-31,1969,Preston North End,Aston Villa,1-1,1,1,2,2,2,0,D
1970-01-31,1969,Swindon Town,Bolton Wanderers,3-2,3,2,2,2,5,1,H
1970-01-31,1969,Watford,Leicester City,2-1,2,1,2,2,3,1,H
1970-02-07,1969,Aston Villa,Cardiff City,1-1,1,1,2,2,2,0,D
1970-02-07,1969,Blackpool,Millwall,1-1,1,1,2,2,2,0,D
1970-02-07,1969,Bristol City,Portsmouth,3-0,3,0,2,2,3,3,H
1970-02-07,1969,Charlton Athletic,Huddersfield Town,1-2,1,2,2,2,3,-1,A
1970-02-07,1969,Oxford United,Hull City,0-0,0,0,2,2,0,0,D
1970-02-09,1969,Sheffield United,Swindon Town,1-2,1,2,2,2,3,-1,A
1970-02-10,1969,Carlisle United,Watford,5-0,5,0,2,2,5,5,H
1970-02-11,1969,Bolton Wanderers,Middlesbrough,2-1,2,1,2,2,3,1,H
1970-02-14,1969,Birmingham City,Leicester City,0-1,0,1,2,2,1,-1,A
1970-02-14,1969,Cardiff City,Carlisle United,1-1,1,1,2,2,2,0,D
1970-02-14,1969,Hull City,Queens Park Rangers,1-2,1,2,2,2,3,-1,A
1970-02-14,1969,Millwall,Bolton Wanderers,2-0,2,0,2,2,2,2,H
1970-02-14,1969,Norwich City,Aston Villa,3-1,3,1,2,2,4,2,H
1970-02-14,1969,Portsmouth,Blackpool,2-3,2,3,2,2,5,-1,A
1970-02-14,1969,Watford,Bristol City,2-0,2,0,2,2,2,2,H
1970-02-17,1969,Queens Park Rangers,Norwich City,4-0,4,0,2,2,4,4,H
1970-02-18,1969,Oxford United,Preston North End,3-1,3,1,2,2,4,2,H
1970-02-21,1969,Aston Villa,Bristol City,0-2,0,2,2,2,2,-2,A
1970-02-21,1969,Bolton Wanderers,Blackpool,0-2,0,2,2,2,2,-2,A
1970-02-21,1969,Cardiff City,Birmingham City,3-1,3,1,2,2,4,2,H
1970-02-21,1969,Carlisle United,Oxford United,1-1,1,1,2,2,2,0,D
1970-02-21,1969,Huddersfield Town,Norwich City,1-1,1,1,2,2,2,0,D
1970-02-21,1969,Preston North End,Hull City,3-3,3,3,2,2,6,0,D
1970-02-24,1969,Birmingham City,Bolton Wanderers,2-0,2,0,2,2,2,2,H
1970-02-24,1969,Huddersfield Town,Oxford United,1-0,1,0,2,2,1,1,H
1970-02-24,1969,Sheffield United,Queens Park Rangers,2-0,2,0,2,2,2,2,H
1970-02-24,1969,Watford,Millwall,1-1,1,1,2,2,2,0,D
1970-02-25,1969,Aston Villa,Charlton Athletic,1-0,1,0,2,2,1,1,H
1970-02-25,1969,Leicester City,Preston North End,3-0,3,0,2,2,3,3,H
1970-02-28,1969,Birmingham City,Watford,0-0,0,0,2,2,0,0,D
1970-02-28,1969,Blackburn Rovers,Sheffield United,1-2,1,2,2,2,3,-1,A
1970-02-28,1969,Blackpool,Charlton Athletic,2-0,2,0,2,2,2,2,H
1970-02-28,1969,Bristol City,Leicester City,0-0,0,0,2,2,0,0,D
1970-02-28,1969,Hull City,Swindon Town,1-1,1,1,2,2,2,0,D
1970-02-28,1969,Middlesbrough,Preston North End,1-1,1,1,2,2,2,0,D
1970-02-28,1969,Millwall,Huddersfield Town,1-0,1,0,2,2,1,1,H
1970-02-28,1969,Norwich City,Cardiff City,1-1,1,1,2,2,2,0,D
1970-02-28,1969,Oxford United,Bolton Wanderers,3-1,3,1,2,2,4,2,H
1970-02-28,1969,Portsmouth,Carlisle United,4-0,4,0,2,2,4,4,H
1970-02-28,1969,Queens Park Rangers,Aston Villa,4-2,4,2,2,2,6,2,H
1970-03-03,1969,Charlton Athletic,Middlesbrough,0-2,0,2,2,2,2,-2,A
1970-03-03,1969,Swindon Town,Portsmouth,3-1,3,1,2,2,4,2,H
1970-03-04,1969,Blackburn Rovers,Birmingham City,1-1,1,1,2,2,2,0,D
1970-03-06,1969,Watford,Hull City,1-1,1,1,2,2,2,0,D
1970-03-07,1969,Bristol City,Blackburn Rovers,4-0,4,0,2,2,4,4,H
1970-03-07,1969,Carlisle United,Charlton Athletic,1-1,1,1,2,2,2,0,D
1970-03-07,1969,Middlesbrough,Portsmouth,2-1,2,1,2,2,3,1,H
1970-03-10,1969,Huddersfield Town,Leicester City,1-1,1,1,2,2,2,0,D
1970-03-10,1969,Hull City,Aston Villa,3-1,3,1,2,2,4,2,H
1970-03-11,1969,Millwall,Birmingham City,6-2,6,2,2,2,8,4,H
1970-03-11,1969,Norwich City,Middlesbrough,2-0,2,0,2,2,2,2,H
1970-03-13,1969,Sheffield United,Carlisle United,1-0,1,0,2,2,1,1,H
1970-03-14,1969,Birmingham City,Middlesbrough,0-0,0,0,2,2,0,0,D
1970-03-14,1969,Blackburn Rovers,Oxford United,2-0,2,0,2,2,2,2,H
1970-03-14,1969,Blackpool,Bristol City,1-0,1,0,2,2,1,1,H
1970-03-14,1969,Cardiff City,Huddersfield Town,0-1,0,1,2,2,1,-1,A
1970-03-14,1969,Charlton Athletic,Aston Villa,1-0,1,0,2,2,1,1,H
1970-03-14,1969,Hull City,Leicester City,4-1,4,1,2,2,5,3,H
1970-03-14,1969,Portsmouth,Millwall,0-1,0,1,2,2,1,-1,A
1970-03-14,1969,Queens Park Rangers,Bolton Wanderers,0-4,0,4,2,2,4,-4,A
1970-03-14,1969,Swindon Town,Preston North End,1-0,1,0,2,2,1,1,H
1970-03-16,1969,Millwall,Aston Villa,2-0,2,0,2,2,2,2,H
1970-03-16,1969,Preston North End,Charlton Athletic,4-1,4,1,2,2,5,3,H
1970-03-17,1969,Leicester City,Blackburn Rovers,2-1,2,1,2,2,3,1,H
1970-03-17,1969,Middlesbrough,Sheffield United,1-0,1,0,2,2,1,1,H
1970-03-18,1969,Blackpool,Hull City,0-1,0,1,2,2,1,-1,A
1970-03-18,1969,Bolton Wanderers,Cardiff City,0-1,0,1,2,2,1,-1,A
1970-03-18,1969,Oxford United,Bristol City,2-0,2,0,2,2,2,2,H
1970-03-21,1969,Aston Villa,Blackburn Rovers,1-1,1,1,2,2,2,0,D
1970-03-21,1969,Bolton Wanderers,Charlton Athletic,1-1,1,1,2,2,2,0,D
1970-03-21,1969,Bristol City,Swindon Town,3-3,3,3,2,2,6,0,D
1970-03-21,1969,Carlisle United,Blackpool,1-2,1,2,2,2,3,-1,A
1970-03-21,1969,Huddersfield Town,Birmingham City,2-0,2,0,2,2,2,2,H
1970-03-21,1969,Leicester City,Sheffield United,2-1,2,1,2,2,3,1,H
1970-03-21,1969,Middlesbrough,Norwich City,0-0,0,0,2,2,0,0,D
1970-03-21,1969,Millwall,Hull City,2-1,2,1,2,2,3,1,H
1970-03-21,1969,Oxford United,Queens Park Rangers,0-0,0,0,2,2,0,0,D
1970-03-21,1969,Preston North End,Portsmouth,1-2,1,2,2,2,3,-1,A
1970-03-21,1969,Watford,Cardiff City,2-1,2,1,2,2,3,1,H
1970-03-24,1969,Huddersfield Town,Swindon Town,1-1,1,1,2,2,2,0,D
1970-03-25,1969,Cardiff City,Portsmouth,2-0,2,0,2,2,2,2,H
1970-03-27,1969,Bristol City,Bolton Wanderers,2-2,2,2,2,2,4,0,D
1970-03-27,1969,Oxford United,Leicester City,0-1,0,1,2,2,1,-1,A
1970-03-27,1969,Queens Park Rangers,Carlisle United,0-0,0,0,2,2,0,0,D
1970-03-27,1969,Watford,Middlesbrough,2-3,2,3,2,2,5,-1,A
1970-03-28,1969,Birmingham City,Preston North End,1-0,1,0,2,2,1,1,H
1970-03-28,1969,Blackburn Rovers,Carlisle United,1-0,1,0,2,2,1,1,H
1970-03-28,1969,Blackpool,Aston Villa,2-1,2,1,2,2,3,1,H
1970-03-28,1969,Cardiff City,Oxford United,0-0,0,0,2,2,0,0,D
1970-03-28,1969,Charlton Athletic,Leicester City,0-5,0,5,2,2,5,-5,A
1970-03-28,1969,Hull City,Middlesbrough,3-2,3,2,2,2,5,1,H
1970-03-28,1969,Norwich City,Millwall,2-1,2,1,2,2,3,1,H
1970-03-28,1969,Portsmouth,Huddersfield Town,1-3,1,3,2,2,4,-2,A
1970-03-28,1969,Queens Park Rangers,Bristol City,2-2,2,2,2,2,4,0,D
1970-03-28,1969,Sheffield United,Bolton Wanderers,0-1,0,1,2,2,1,-1,A
1970-03-28,1969,Swindon Town,Watford,1-0,1,0,2,2,1,1,H
1970-03-30,1969,Birmingham City,Aston Villa,0-2,0,2,2,2,2,-2,A
1970-03-30,1969,Blackpool,Sheffield United,1-0,1,0,2,2,1,1,H
1970-03-30,1969,Bolton Wanderers,Blackburn Rovers,1-0,1,0,2,2,1,1,H
1970-03-30,1969,Huddersfield Town,Hull City,2-2,2,2,2,2,4,0,D
1970-03-30,1969,Millwall,Preston North End,2-1,2,1,2,2,3,1,H
1970-03-30,1969,Norwich City,Swindon Town,1-0,1,0,2,2,1,1,H
1970-03-31,1969,Aston Villa,Oxford United,0-0,0,0,2,2,0,0,D
1970-03-31,1969,Carlisle United,Bristol City,2-1,2,1,2,2,3,1,H
1970-03-31,1969,Charlton Athletic,Queens Park Rangers,1-1,1,1,2,2,2,0,D
1970-03-31,1969,Hull City,Cardiff City,1-1,1,1,2,2,2,0,D
1970-03-31,1969,Leicester City,Blackpool,0-0,0,0,2,2,0,0,D
1970-03-31,1969,Middlesbrough,Huddersfield Town,1-1,1,1,2,2,2,0,D
1970-03-31,1969,Preston North End,Norwich City,1-1,1,1,2,2,2,0,D
1970-03-31,1969,Sheffield United,Millwall,3-1,3,1,2,2,4,2,H
1970-03-31,1969,Swindon Town,Birmingham City,4-1,4,1,2,2,5,3,H
1970-04-01,1969,Portsmouth,Watford,3-1,3,1,2,2,4,2,H
1970-04-04,1969,Birmingham City,Hull City,2-4,2,4,2,2,6,-2,A
1970-04-04,1969,Blackburn Rovers,Huddersfield Town,0-2,0,2,2,2,2,-2,A
1970-04-04,1969,Blackpool,Queens Park Rangers,1-1,1,1,2,2,2,0,D
1970-04-04,1969,Bolton Wanderers,Carlisle United,0-0,0,0,2,2,0,0,D
1970-04-04,1969,Bristol City,Sheffield United,0-1,0,1,2,2,1,-1,A
1970-04-04,1969,Leicester City,Aston Villa,1-0,1,0,2,2,1,1,H
1970-04-04,1969,Middlesbrough,Cardiff City,2-1,2,1,2,2,3,1,H
1970-04-04,1969,Millwall,Swindon Town,3-1,3,1,2,2,4,2,H
1970-04-04,1969,Oxford United,Charlton Athletic,1-1,1,1,2,2,2,0,D
1970-04-04,1969,Portsmouth,Norwich City,1-4,1,4,2,2,5,-3,A
1970-04-04,1969,Watford,Preston North End,0-0,0,0,2,2,0,0,D
1970-04-07,1969,Swindon Town,Blackpool,1-1,1,1,2,2,2,0,D
1970-04-07,1969,Watford,Norwich City,1-1,1,1,2,2,2,0,D
1970-04-08,1969,Aston Villa,Middlesbrough,2-0,2,0,2,2,2,2,H
1970-04-08,1969,Blackburn Rovers,Charlton Athletic,3-0,3,0,2,2,3,3,H
1970-04-09,1969,Bolton Wanderers,Norwich City,0-0,0,0,2,2,0,0,D
1970-04-13,1969,Aston Villa,Sheffield United,1-0,1,0,2,2,1,1,H
1970-04-13,1969,Preston North End,Blackpool,0-3,0,3,2,2,3,-3,A
1970-04-14,1969,Carlisle United,Leicester City,2-2,2,2,2,2,4,0,D
1970-04-14,1969,Charlton Athletic,Bristol City,2-1,2,1,2,2,3,1,H
1970-04-14,1969,Huddersfield Town,Watford,3-1,3,1,2,2,4,2,H
1970-04-14,1969,Queens Park Rangers,Blackburn Rovers,2-3,2,3,2,2,5,-1,A
1970-04-14,1969,Swindon Town,Middlesbrough,0-3,0,3,2,2,3,-3,A
1970-04-15,1969,Cardiff City,Millwall,0-0,0,0,2,2,0,0,D
1970-04-15,1969,Hull City,Portsmouth,3-3,3,3,2,2,6,0,D
1970-04-15,1969,Norwich City,Birmingham City,6-0,6,0,2,2,6,6,H
1970-04-15,1969,Sheffield United,Oxford United,5-1,5,1,2,2,6,4,H
1970-04-18,1969,Leicester City,Queens Park Rangers,2-1,2,1,2,2,3,1,H
1970-04-18,1969,Norwich City,Watford,1-1,1,1,2,2,2,0,D
1970-04-18,1969,Oxford United,Blackpool,2-0,2,0,2,2,2,2,H
1970-04-20,1969,Preston North End,Cardiff City,1-2,1,2,2,2,3,-1,A
1970-04-20,1969,Swindon Town,Blackburn Rovers,1-0,1,0,2,2,1,1,H
1970-08-15,1970,Birmingham City,Queens Park Rangers,2-1,2,1,2,2,3,1,H
1970-08-15,1970,Bolton Wanderers,Luton Town,4-2,4,2,2,2,6,2,H
1970-08-15,1970,Bristol City,Sunderland,4-3,4,3,2,2,7,1,H
1970-08-15,1970,Leicester City,Cardiff City,0-1,0,1,2,2,1,-1,A
1970-08-15,1970,Leyton Orient,Sheffield United,3-1,3,1,2,2,4,2,H
1970-08-15,1970,Middlesbrough,Carlisle United,2-1,2,1,2,2,3,1,H
1970-08-15,1970,Millwall,Oxford United,1-2,1,2,2,2,3,-1,A
1970-08-15,1970,Norwich City,Portsmouth,1-1,1,1,2,2,2,0,D
1970-08-15,1970,Sheffield Wednesday,Charlton Athletic,1-0,1,0,2,2,1,1,H
1970-08-15,1970,Swindon Town,Hull City,1-1,1,1,2,2,2,0,D
1970-08-15,1970,Watford,Blackburn Rovers,2-1,2,1,2,2,3,1,H
1970-08-19,1970,Bolton Wanderers,Sheffield Wednesday,2-1,2,1,2,2,3,1,H
1970-08-22,1970,Blackburn Rovers,Leyton Orient,0-0,0,0,2,2,0,0,D
1970-08-22,1970,Cardiff City,Millwall,2-2,2,2,2,2,4,0,D
1970-08-22,1970,Carlisle United,Birmingham City,0-3,0,3,2,2,3,-3,A
1970-08-22,1970,Charlton Athletic,Bristol City,1-1,1,1,2,2,2,0,D
1970-08-22,1970,Hull City,Middlesbrough,1-0,1,0,2,2,1,1,H
1970-08-22,1970,Luton Town,Norwich City,0-0,0,0,2,2,0,0,D
1970-08-22,1970,Oxford United,Sheffield Wednesday,1-1,1,1,2,2,2,0,D
1970-08-22,1970,Portsmouth,Bolton Wanderers,4-0,4,0,2,2,4,4,H
1970-08-22,1970,Queens Park Rangers,Leicester City,1-3,1,3,2,2,4,-2,A
1970-08-22,1970,Sheffield United,Swindon Town,2-1,2,1,2,2,3,1,H
1970-08-22,1970,Sunderland,Watford,3-3,3,3,2,2,6,0,D
1970-08-26,1970,Sheffield Wednesday,Cardiff City,1-2,1,2,2,2,3,-1,A
1970-08-29,1970,Birmingham City,Luton Town,1-1,1,1,2,2,2,0,D
1970-08-29,1970,Bolton Wanderers,Queens Park Rangers,2-2,2,2,2,2,4,0,D
1970-08-29,1970,Bristol City,Cardiff City,1-0,1,0,2,2,1,1,H
1970-08-29,1970,Leicester City,Carlisle United,2-2,2,2,2,2,4,0,D
1970-08-29,1970,Leyton Orient,Charlton Athletic,0-0,0,0,2,2,0,0,D
1970-08-29,1970,Middlesbrough,Oxford United,0-2,0,2,2,2,2,-2,A
1970-08-29,1970,Millwall,Portsmouth,0-0,0,0,2,2,0,0,D
1970-08-29,1970,Norwich City,Sheffield United,1-0,1,0,2,2,1,1,H
1970-08-29,1970,Sheffield Wednesday,Blackburn Rovers,1-1,1,1,2,2,2,0,D
1970-08-29,1970,Swindon Town,Sunderland,2-0,2,0,2,2,2,2,H
1970-08-29,1970,Watford,Hull City,1-2,1,2,2,2,3,-1,A
1970-09-01,1970,Birmingham City,Middlesbrough,0-1,0,1,2,2,1,-1,A
1970-09-01,1970,Carlisle United,Hull City,2-0,2,0,2,2,2,2,H
1970-09-01,1970,Luton Town,Oxford United,4-0,4,0,2,2,4,4,H
1970-09-01,1970,Swindon Town,Watford,1-1,1,1,2,2,2,0,D
1970-09-02,1970,Blackburn Rovers,Queens Park Rangers,0-2,0,2,2,2,2,-2,A
1970-09-02,1970,Cardiff City,Sheffield United,1-1,1,1,2,2,2,0,D
1970-09-02,1970,Leicester City,Bristol City,4-0,4,0,2,2,4,4,H
1970-09-02,1970,Norwich City,Millwall,1-0,1,0,2,2,1,1,H
1970-09-02,1970,Portsmouth,Leyton Orient,1-1,1,1,2,2,2,0,D
1970-09-02,1970,Sheffield Wednesday,Bolton Wanderers,1-1,1,1,2,2,2,0,D
1970-09-02,1970,Sunderland,Charlton Athletic,3-0,3,0,2,2,3,3,H
1970-09-05,1970,Blackburn Rovers,Swindon Town,1-0,1,0,2,2,1,1,H
1970-09-05,1970,Cardiff City,Birmingham City,2-0,2,0,2,2,2,2,H
1970-09-05,1970,Carlisle United,Leyton Orient,2-0,2,0,2,2,2,2,H
1970-09-05,1970,Charlton Athletic,Millwall,1-3,1,3,2,2,4,-2,A
1970-09-05,1970,Hull City,Bolton Wanderers,1-0,1,0,2,2,1,1,H
1970-09-05,1970,Luton Town,Middlesbrough,1-0,1,0,2,2,1,1,H
1970-09-05,1970,Oxford United,Leicester City,1-0,1,0,2,2,1,1,H
1970-09-05,1970,Portsmouth,Sheffield Wednesday,2-0,2,0,2,2,2,2,H
1970-09-05,1970,Queens Park Rangers,Watford,1-1,1,1,2,2,2,0,D
1970-09-05,1970,Sheffield United,Bristol City,3-3,3,3,2,2,6,0,D
1970-09-05,1970,Sunderland,Norwich City,2-1,2,1,2,2,3,1,H
1970-09-12,1970,Birmingham City,Oxford United,1-1,1,1,2,2,2,0,D
1970-09-12,1970,Bolton Wanderers,Cardiff City,0-2,0,2,2,2,2,-2,A
1970-09-12,1970,Bristol City,Hull City,3-3,3,3,2,2,6,0,D
1970-09-12,1970,Leicester City,Luton Town,1-0,1,0,2,2,1,1,H
1970-09-12,1970,Leyton Orient,Sunderland,1-0,1,0,2,2,1,1,H
1970-09-12,1970,Middlesbrough,Blackburn Rovers,1-1,1,1,2,2,2,0,D
1970-09-12,1970,Norwich City,Charlton Athletic,2-0,2,0,2,2,2,2,H
1970-09-12,1970,Sheffield Wednesday,Queens Park Rangers,1-0,1,0,2,2,1,1,H
1970-09-12,1970,Swindon Town,Portsmouth,2-1,2,1,2,2,3,1,H
1970-09-12,1970,Watford,Carlisle United,0-0,0,0,2,2,0,0,D
1970-09-14,1970,Millwall,Sheffield United,1-2,1,2,2,2,3,-1,A
1970-09-19,1970,Blackburn Rovers,Bolton Wanderers,0-2,0,2,2,2,2,-2,A
1970-09-19,1970,Cardiff City,Norwich City,1-1,1,1,2,2,2,0,D
1970-09-19,1970,Carlisle United,Swindon Town,2-1,2,1,2,2,3,1,H
1970-09-19,1970,Charlton Athletic,Leicester City,0-1,0,1,2,2,1,-1,A
1970-09-19,1970,Hull City,Millwall,2-0,2,0,2,2,2,2,H
1970-09-19,1970,Luton Town,Leyton Orient,4-0,4,0,2,2,4,4,H
1970-09-19,1970,Oxford United,Watford,2-1,2,1,2,2,3,1,H
1970-09-19,1970,Portsmouth,Birmingham City,1-0,1,0,2,2,1,1,H
1970-09-19,1970,Queens Park Rangers,Bristol City,2-1,2,1,2,2,3,1,H
1970-09-19,1970,Sheffield United,Middlesbrough,1-1,1,1,2,2,2,0,D
1970-09-19,1970,Sunderland,Sheffield Wednesday,3-1,3,1,2,2,4,2,H
1970-09-21,1970,Blackburn Rovers,Oxford United,0-0,0,0,2,2,0,0,D
1970-09-26,1970,Birmingham City,Charlton Athletic,1-1,1,1,2,2,2,0,D
1970-09-26,1970,Bolton Wanderers,Oxford United,0-2,0,2,2,2,2,-2,A
1970-09-26,1970,Bristol City,Blackburn Rovers,1-1,1,1,2,2,2,0,D
1970-09-26,1970,Leicester City,Portsmouth,2-0,2,0,2,2,2,2,H
1970-09-26,1970,Leyton Orient,Cardiff City,0-0,0,0,2,2,0,0,D
1970-09-26,1970,Middlesbrough,Queens Park Rangers,6-2,6,2,2,2,8,4,H
1970-09-26,1970,Millwall,Sunderland,0-0,0,0,2,2,0,0,D
1970-09-26,1970,Norwich City,Hull City,0-2,0,2,2,2,2,-2,A
1970-09-26,1970,Sheffield Wednesday,Carlisle United,3-0,3,0,2,2,3,3,H
1970-09-26,1970,Swindon Town,Luton Town,0-0,0,0,2,2,0,0,D
1970-09-26,1970,Watford,Sheffield United,0-0,0,0,2,2,0,0,D
1970-09-29,1970,Bristol City,Birmingham City,2-1,2,1,2,2,3,1,H
1970-09-29,1970,Charlton Athletic,Carlisle United,1-1,1,1,2,2,2,0,D
1970-09-29,1970,Queens Park Rangers,Luton Town,0-1,0,1,2,2,1,-1,A
1970-09-29,1970,Swindon Town,Millwall,3-0,3,0,2,2,3,3,H
1970-09-30,1970,Bolton Wanderers,Leyton Orient,0-1,0,1,2,2,1,-1,A
1970-09-30,1970,Leicester City,Middlesbrough,3-2,3,2,2,2,5,1,H
1970-09-30,1970,Portsmouth,Sheffield United,1-5,1,5,2,2,6,-4,A
1970-09-30,1970,Watford,Norwich City,2-0,2,0,2,2,2,2,H
1970-10-02,1970,Carlisle United,Millwall,3-0,3,0,2,2,3,3,H
1970-10-03,1970,Blackburn Rovers,Leicester City,2-2,2,2,2,2,4,0,D
1970-10-03,1970,Cardiff City,Middlesbrough,3-4,3,4,2,2,7,-1,A
1970-10-03,1970,Charlton Athletic,Swindon Town,2-1,2,1,2,2,3,1,H
1970-10-03,1970,Hull City,Birmingham City,0-1,0,1,2,2,1,-1,A
1970-10-03,1970,Luton Town,Bristol City,3-0,3,0,2,2,3,3,H
1970-10-03,1970,Oxford United,Norwich City,1-1,1,1,2,2,2,0,D
1970-10-03,1970,Portsmouth,Watford,5-0,5,0,2,2,5,5,H
1970-10-03,1970,Queens Park Rangers,Leyton Orient,5-1,5,1,2,2,6,4,H
1970-10-03,1970,Sheffield United,Sheffield Wednesday,3-2,3,2,2,2,5,1,H
1970-10-03,1970,Sunderland,Bolton Wanderers,4-1,4,1,2,2,5,3,H
1970-10-07,1970,Sunderland,Hull City,0-1,0,1,2,2,1,-1,A
1970-10-10,1970,Birmingham City,Sheffield United,0-1,0,1,2,2,1,-1,A
1970-10-10,1970,Bolton Wanderers,Charlton Athletic,4-0,4,0,2,2,4,4,H
1970-10-10,1970,Bristol City,Oxford United,0-4,0,4,2,2,4,-4,A
1970-10-10,1970,Leicester City,Sunderland,1-0,1,0,2,2,1,1,H
1970-10-10,1970,Leyton Orient,Hull City,0-1,0,1,2,2,1,-1,A
1970-10-10,1970,Middlesbrough,Portsmouth,3-2,3,2,2,2,5,1,H
1970-10-10,1970,Millwall,Blackburn Rovers,2-0,2,0,2,2,2,2,H
1970-10-10,1970,Norwich City,Carlisle United,1-1,1,1,2,2,2,0,D
1970-10-10,1970,Sheffield Wednesday,Luton Town,1-5,1,5,2,2,6,-4,A
1970-10-10,1970,Swindon Town,Queens Park Rangers,1-0,1,0,2,2,1,1,H
1970-10-10,1970,Watford,Cardiff City,0-1,0,1,2,2,1,-1,A
1970-10-16,1970,Hull City,Swindon Town,2-0,2,0,2,2,2,2,H
1970-10-17,1970,Blackburn Rovers,Watford,2-3,2,3,2,2,5,-1,A
1970-10-17,1970,Cardiff City,Leicester City,2-2,2,2,2,2,4,0,D
1970-10-17,1970,Carlisle United,Middlesbrough,1-0,1,0,2,2,1,1,H
1970-10-17,1970,Charlton Athletic,Sheffield Wednesday,2-3,2,3,2,2,5,-1,A
1970-10-17,1970,Luton Town,Bolton Wanderers,2-0,2,0,2,2,2,2,H
1970-10-17,1970,Oxford United,Millwall,2-3,2,3,2,2,5,-1,A
1970-10-17,1970,Portsmouth,Norwich City,0-2,0,2,2,2,2,-2,A
1970-10-17,1970,Queens Park Rangers,Birmingham City,5-2,5,2,2,2,7,3,H
1970-10-17,1970,Sheffield United,Leyton Orient,3-1,3,1,2,2,4,2,H
1970-10-17,1970,Sunderland,Bristol City,1-0,1,0,2,2,1,1,H
1970-10-19,1970,Leyton Orient,Sheffield Wednesday,1-1,1,1,2,2,2,0,D
1970-10-19,1970,Millwall,Watford,3-0,3,0,2,2,3,3,H
1970-10-20,1970,Birmingham City,Leicester City,0-0,0,0,2,2,0,0,D
1970-10-20,1970,Carlisle United,Sunderland,0-0,0,0,2,2,0,0,D
1970-10-20,1970,Luton Town,Blackburn Rovers,2-0,2,0,2,2,2,2,H
1970-10-20,1970,Middlesbrough,Bristol City,1-0,1,0,2,2,1,1,H
1970-10-20,1970,Sheffield United,Bolton Wanderers,2-2,2,2,2,2,4,0,D
1970-10-21,1970,Hull City,Charlton Athletic,2-0,2,0,2,2,2,2,H
1970-10-21,1970,Norwich City,Swindon Town,1-0,1,0,2,2,1,1,H
1970-10-21,1970,Oxford United,Queens Park Rangers,1-3,1,3,2,2,4,-2,A
1970-10-24,1970,Blackburn Rovers,Norwich City,2-1,2,1,2,2,3,1,H
1970-10-24,1970,Bolton Wanderers,Bristol City,1-0,1,0,2,2,1,1,H
1970-10-24,1970,Carlisle United,Cardiff City,1-1,1,1,2,2,2,0,D
1970-10-24,1970,Charlton Athletic,Luton Town,1-1,1,1,2,2,2,0,D
1970-10-24,1970,Hull City,Sheffield United,1-1,1,1,2,2,2,0,D
1970-10-24,1970,Leyton Orient,Millwall,0-0,0,0,2,2,0,0,D
1970-10-24,1970,Queens Park Rangers,Portsmouth,2-0,2,0,2,2,2,2,H
1970-10-24,1970,Sheffield Wednesday,Leicester City,0-3,0,3,2,2,3,-3,A
1970-10-24,1970,Sunderland,Oxford United,0-1,0,1,2,2,1,-1,A
1970-10-24,1970,Swindon Town,Middlesbrough,3-0,3,0,2,2,3,3,H
1970-10-24,1970,Watford,Birmingham City,2-1,2,1,2,2,3,1,H
1970-10-28,1970,Cardiff City,Portsmouth,1-0,1,0,2,2,1,1,H
1970-10-31,1970,Birmingham City,Swindon Town,2-1,2,1,2,2,3,1,H
1970-10-31,1970,Bristol City,Sheffield Wednesday,1-2,1,2,2,2,3,-1,A
1970-10-31,1970,Cardiff City,Hull City,5-1,5,1,2,2,6,4,H
1970-10-31,1970,Leicester City,Bolton Wanderers,1-0,1,0,2,2,1,1,H
1970-10-31,1970,Luton Town,Sunderland,1-2,1,2,2,2,3,-1,A
1970-10-31,1970,Middlesbrough,Watford,2-2,2,2,2,2,4,0,D
1970-10-31,1970,Millwall,Queens Park Rangers,3-0,3,0,2,2,3,3,H
1970-10-31,1970,Norwich City,Leyton Orient,4-2,4,2,2,2,6,2,H
1970-10-31,1970,Oxford United,Charlton Athletic,2-1,2,1,2,2,3,1,H
1970-10-31,1970,Portsmouth,Blackburn Rovers,4-1,4,1,2,2,5,3,H
1970-10-31,1970,Sheffield United,Carlisle United,2-2,2,2,2,2,4,0,D
1970-11-07,1970,Blackburn Rovers,Sheffield United,1-3,1,3,2,2,4,-2,A
1970-11-07,1970,Bolton Wanderers,Norwich City,0-1,0,1,2,2,1,-1,A
1970-11-07,1970,Carlisle United,Oxford United,3-2,3,2,2,2,5,1,H
1970-11-07,1970,Charlton Athletic,Portsmouth,2-2,2,2,2,2,4,0,D
1970-11-07,1970,Hull City,Luton Town,0-2,0,2,2,2,2,-2,A
1970-11-07,1970,Leyton Orient,Middlesbrough,0-0,0,0,2,2,0,0,D
1970-11-07,1970,Queens Park Rangers,Cardiff City,0-1,0,1,2,2,1,-1,A
1970-11-07,1970,Sheffield Wednesday,Millwall,1-0,1,0,2,2,1,1,H
1970-11-07,1970,Sunderland,Birmingham City,2-1,2,1,2,2,3,1,H
1970-11-07,1970,Swindon Town,Bristol City,2-1,2,1,2,2,3,1,H
1970-11-07,1970,Watford,Leicester City,0-1,0,1,2,2,1,-1,A
1970-11-14,1970,Birmingham City,Leyton Orient,1-0,1,0,2,2,1,1,H
1970-11-14,1970,Bristol City,Watford,3-0,3,0,2,2,3,3,H
1970-11-14,1970,Cardiff City,Blackburn Rovers,4-1,4,1,2,2,5,3,H
1970-11-14,1970,Leicester City,Swindon Town,3-1,3,1,2,2,4,2,H
1970-11-14,1970,Luton Town,Carlisle United,3-3,3,3,2,2,6,0,D
1970-11-14,1970,Middlesbrough,Charlton Athletic,3-0,3,0,2,2,3,3,H
1970-11-14,1970,Millwall,Bolton Wanderers,2-0,2,0,2,2,2,2,H
1970-11-14,1970,Norwich City,Sheffield Wednesday,0-0,0,0,2,2,0,0,D
1970-11-14,1970,Oxford United,Hull City,0-3,0,3,2,2,3,-3,A
1970-11-14,1970,Portsmouth,Sunderland,2-1,2,1,2,2,3,1,H
1970-11-14,1970,Sheffield United,Queens Park Rangers,1-1,1,1,2,2,2,0,D
1970-11-21,1970,Bolton Wanderers,Birmingham City,3-0,3,0,2,2,3,3,H
1970-11-21,1970,Carlisle United,Blackburn Rovers,1-0,1,0,2,2,1,1,H
1970-11-21,1970,Charlton Athletic,Cardiff City,2-1,2,1,2,2,3,1,H
1970-11-21,1970,Hull City,Queens Park Rangers,1-1,1,1,2,2,2,0,D
1970-11-21,1970,Leyton Orient,Watford,1-1,1,1,2,2,2,0,D
1970-11-21,1970,Luton Town,Portsmouth,2-1,2,1,2,2,3,1,H
1970-11-21,1970,Millwall,Bristol City,2-0,2,0,2,2,2,2,H
1970-11-21,1970,Norwich City,Leicester City,2-2,2,2,2,2,4,0,D
1970-11-21,1970,Oxford United,Swindon Town,0-0,0,0,2,2,0,0,D
1970-11-21,1970,Sheffield Wednesday,Middlesbrough,3-2,3,2,2,2,5,1,H
1970-11-21,1970,Sunderland,Sheffield United,0-0,0,0,2,2,0,0,D
1970-11-28,1970,Birmingham City,Norwich City,2-2,2,2,2,2,4,0,D
1970-11-28,1970,Blackburn Rovers,Sunderland,0-1,0,1,2,2,1,-1,A
1970-11-28,1970,Bristol City,Carlisle United,2-1,2,1,2,2,3,1,H
1970-11-28,1970,Cardiff City,Luton Town,0-0,0,0,2,2,0,0,D
1970-11-28,1970,Leicester City,Leyton Orient,4-0,4,0,2,2,4,4,H
1970-11-28,1970,Middlesbrough,Millwall,1-0,1,0,2,2,1,1,H
1970-11-28,1970,Portsmouth,Hull City,2-2,2,2,2,2,4,0,D
1970-11-28,1970,Queens Park Rangers,Charlton Athletic,1-4,1,4,2,2,5,-3,A
1970-11-28,1970,Sheffield United,Oxford United,3-0,3,0,2,2,3,3,H
1970-11-28,1970,Swindon Town,Sheffield Wednesday,3-0,3,0,2,2,3,3,H
1970-11-28,1970,Watford,Bolton Wanderers,1-1,1,1,2,2,2,0,D
1970-12-05,1970,Bolton Wanderers,Swindon Town,0-3,0,3,2,2,3,-3,A
1970-12-05,1970,Carlisle United,Portsmouth,6-0,6,0,2,2,6,6,H
1970-12-05,1970,Charlton Athletic,Blackburn Rovers,2-4,2,4,2,2,6,-2,A
1970-12-05,1970,Hull City,Leicester City,3-0,3,0,2,2,3,3,H
1970-12-05,1970,Leyton Orient,Bristol City,1-1,1,1,2,2,2,0,D
1970-12-05,1970,Luton Town,Sheffield United,2-1,2,1,2,2,3,1,H
1970-12-05,1970,Millwall,Birmingham City,2-1,2,1,2,2,3,1,H
1970-12-05,1970,Norwich City,Middlesbrough,1-1,1,1,2,2,2,0,D
1970-12-05,1970,Oxford United,Cardiff City,1-0,1,0,2,2,1,1,H
1970-12-05,1970,Sheffield Wednesday,Watford,2-1,2,1,2,2,3,1,H
1970-12-05,1970,Sunderland,Queens Park Rangers,3-1,3,1,2,2,4,2,H
1970-12-12,1970,Birmingham City,Sheffield Wednesday,1-0,1,0,2,2,1,1,H
1970-12-12,1970,Blackburn Rovers,Hull City,0-1,0,1,2,2,1,-1,A
1970-12-12,1970,Bristol City,Norwich City,0-1,0,1,2,2,1,-1,A
1970-12-12,1970,Cardiff City,Sunderland,3-1,3,1,2,2,4,2,H
1970-12-12,1970,Leicester City,Millwall,2-1,2,1,2,2,3,1,H
1970-12-12,1970,Middlesbrough,Bolton Wanderers,1-0,1,0,2,2,1,1,H
1970-12-12,1970,Portsmouth,Oxford United,1-0,1,0,2,2,1,1,H
1970-12-12,1970,Queens Park Rangers,Carlisle United,1-1,1,1,2,2,2,0,D
1970-12-12,1970,Sheffield United,Charlton Athletic,3-0,3,0,2,2,3,3,H
1970-12-12,1970,Swindon Town,Leyton Orient,1-1,1,1,2,2,2,0,D
1970-12-12,1970,Watford,Luton Town,0-1,0,1,2,2,1,-1,A
1970-12-19,1970,Birmingham City,Carlisle United,1-0,1,0,2,2,1,1,H
1970-12-19,1970,Bolton Wanderers,Portsmouth,1-1,1,1,2,2,2,0,D
1970-12-19,1970,Bristol City,Charlton Athletic,2-2,2,2,2,2,4,0,D
1970-12-19,1970,Leicester City,Queens Park Rangers,0-0,0,0,2,2,0,0,D
1970-12-19,1970,Leyton Orient,Blackburn Rovers,1-1,1,1,2,2,2,0,D
1970-12-19,1970,Middlesbrough,Hull City,1-0,1,0,2,2,1,1,H
1970-12-19,1970,Millwall,Cardiff City,2-1,2,1,2,2,3,1,H
1970-12-19,1970,Norwich City,Luton Town,1-1,1,1,2,2,2,0,D
1970-12-19,1970,Sheffield Wednesday,Oxford United,1-1,1,1,2,2,2,0,D
1970-12-19,1970,Swindon Town,Sheffield United,3-0,3,0,2,2,3,3,H
1970-12-19,1970,Watford,Sunderland,1-1,1,1,2,2,2,0,D
1970-12-26,1970,Blackburn Rovers,Birmingham City,2-2,2,2,2,2,4,0,D
1970-12-26,1970,Cardiff City,Swindon Town,1-1,1,1,2,2,2,0,D
1970-12-26,1970,Carlisle United,Bolton Wanderers,1-0,1,0,2,2,1,1,H
1970-12-26,1970,Hull City,Sheffield Wednesday,4-4,4,4,2,2,8,0,D
1970-12-26,1970,Sheffield United,Leicester City,2-1,2,1,2,2,3,1,H
1970-12-26,1970,Sunderland,Middlesbrough,2-2,2,2,2,2,4,0,D
1971-01-09,1970,Birmingham City,Bristol City,2-0,2,0,2,2,2,2,H
1971-01-09,1970,Cardiff City,Sheffield Wednesday,4-0,4,0,2,2,4,4,H
1971-01-09,1970,Carlisle United,Charlton Athletic,1-1,1,1,2,2,2,0,D
1971-01-09,1970,Hull City,Sunderland,4-0,4,0,2,2,4,4,H
1971-01-09,1970,Leyton Orient,Bolton Wanderers,3-1,3,1,2,2,4,2,H
1971-01-09,1970,Luton Town,Queens Park Rangers,0-0,0,0,2,2,0,0,D
1971-01-09,1970,Middlesbrough,Leicester City,1-0,1,0,2,2,1,1,H
1971-01-09,1970,Millwall,Swindon Town,2-2,2,2,2,2,4,0,D
1971-01-09,1970,Norwich City,Watford,2-1,2,1,2,2,3,1,H
1971-01-09,1970,Oxford United,Blackburn Rovers,2-1,2,1,2,2,3,1,H
1971-01-09,1970,Sheffield United,Portsmouth,2-0,2,0,2,2,2,2,H
1971-01-16,1970,Blackburn Rovers,Luton Town,1-0,1,0,2,2,1,1,H
1971-01-16,1970,Bolton Wanderers,Sheffield United,2-1,2,1,2,2,3,1,H
1971-01-16,1970,Bristol City,Middlesbrough,0-2,0,2,2,2,2,-2,A
1971-01-16,1970,Charlton Athletic,Hull City,0-1,0,1,2,2,1,-1,A
1971-01-16,1970,Leicester City,Birmingham City,1-4,1,4,2,2,5,-3,A
1971-01-16,1970,Portsmouth,Cardiff City,1-3,1,3,2,2,4,-2,A
1971-01-16,1970,Queens Park Rangers,Oxford United,2-0,2,0,2,2,2,2,H
1971-01-16,1970,Sheffield Wednesday,Leyton Orient,2-1,2,1,2,2,3,1,H
1971-01-16,1970,Sunderland,Carlisle United,2-0,2,0,2,2,2,2,H
1971-01-16,1970,Swindon Town,Norwich City,3-2,3,2,2,2,5,1,H
1971-01-16,1970,Watford,Millwall,0-4,0,4,2,2,4,-4,A
1971-01-23,1970,Millwall,Norwich City,2-2,2,2,2,2,4,0,D
1971-01-30,1970,Bolton Wanderers,Watford,0-1,0,1,2,2,1,-1,A
1971-01-30,1970,Carlisle United,Bristol City,2-1,2,1,2,2,3,1,H
1971-01-30,1970,Hull City,Portsmouth,0-1,0,1,2,2,1,-1,A
1971-01-30,1970,Millwall,Middlesbrough,1-0,1,0,2,2,1,1,H
1971-01-30,1970,Norwich City,Birmingham City,2-2,2,2,2,2,4,0,D
1971-01-30,1970,Oxford United,Sheffield United,1-2,1,2,2,2,3,-1,A
1971-01-30,1970,Sheffield Wednesday,Swindon Town,2-2,2,2,2,2,4,0,D
1971-01-30,1970,Sunderland,Blackburn Rovers,3-2,3,2,2,2,5,1,H
1971-02-06,1970,Birmingham City,Millwall,3-1,3,1,2,2,4,2,H
1971-02-06,1970,Blackburn Rovers,Charlton Athletic,1-0,1,0,2,2,1,1,H
1971-02-06,1970,Bristol City,Leyton Orient,0-0,0,0,2,2,0,0,D
1971-02-06,1970,Cardiff City,Oxford United,1-0,1,0,2,2,1,1,H
1971-02-06,1970,Leicester City,Hull City,0-0,0,0,2,2,0,0,D
1971-02-06,1970,Middlesbrough,Norwich City,5-0,5,0,2,2,5,5,H
1971-02-06,1970,Portsmouth,Carlisle United,1-4,1,4,2,2,5,-3,A
1971-02-06,1970,Queens Park Rangers,Sunderland,2-0,2,0,2,2,2,2,H
1971-02-06,1970,Sheffield United,Luton Town,2-1,2,1,2,2,3,1,H
1971-02-06,1970,Swindon Town,Bolton Wanderers,3-1,3,1,2,2,4,2,H
1971-02-06,1970,Watford,Sheffield Wednesday,3-0,3,0,2,2,3,3,H
1971-02-13,1970,Bolton Wanderers,Middlesbrough,0-3,0,3,2,2,3,-3,A
1971-02-13,1970,Carlisle United,Queens Park Rangers,3-0,3,0,2,2,3,3,H
1971-02-13,1970,Charlton Athletic,Sheffield United,0-2,0,2,2,2,2,-2,A
1971-02-13,1970,Leyton Orient,Swindon Town,1-0,1,0,2,2,1,1,H
1971-02-13,1970,Luton Town,Watford,1-0,1,0,2,2,1,1,H
1971-02-13,1970,Norwich City,Bristol City,3-2,3,2,2,2,5,1,H
1971-02-13,1970,Sheffield Wednesday,Birmingham City,3-3,3,3,2,2,6,0,D
1971-02-13,1970,Sunderland,Cardiff City,0-4,0,4,2,2,4,-4,A
1971-02-20,1970,Birmingham City,Bolton Wanderers,4-0,4,0,2,2,4,4,H
1971-02-20,1970,Blackburn Rovers,Carlisle United,0-2,0,2,2,2,2,-2,A
1971-02-20,1970,Bristol City,Millwall,3-2,3,2,2,2,5,1,H
1971-02-20,1970,Cardiff City,Charlton Athletic,1-1,1,1,2,2,2,0,D
1971-02-20,1970,Leicester City,Norwich City,2-1,2,1,2,2,3,1,H
1971-02-20,1970,Middlesbrough,Sheffield Wednesday,1-0,1,0,2,2,1,1,H
1971-02-20,1970,Portsmouth,Luton Town,0-1,0,1,2,2,1,-1,A
1971-02-20,1970,Queens Park Rangers,Hull City,1-1,1,1,2,2,2,0,D
1971-02-20,1970,Sheffield United,Sunderland,1-0,1,0,2,2,1,1,H
1971-02-20,1970,Swindon Town,Oxford United,3-0,3,0,2,2,3,3,H
1971-02-20,1970,Watford,Leyton Orient,0-0,0,0,2,2,0,0,D
1971-02-23,1970,Hull City,Blackburn Rovers,0-0,0,0,2,2,0,0,D
1971-02-26,1970,Charlton Athletic,Oxford United,2-0,2,0,2,2,2,2,H
1971-02-26,1970,Leyton Orient,Norwich City,1-0,1,0,2,2,1,1,H
1971-02-26,1970,Watford,Middlesbrough,1-0,1,0,2,2,1,1,H
1971-02-27,1970,Blackburn Rovers,Portsmouth,1-1,1,1,2,2,2,0,D
1971-02-27,1970,Bolton Wanderers,Leicester City,0-3,0,3,2,2,3,-3,A
1971-02-27,1970,Carlisle United,Sheffield United,1-0,1,0,2,2,1,1,H
1971-02-27,1970,Hull City,Cardiff City,1-1,1,1,2,2,2,0,D
1971-02-27,1970,Queens Park Rangers,Millwall,2-0,2,0,2,2,2,2,H
1971-02-27,1970,Sheffield Wednesday,Bristol City,2-0,2,0,2,2,2,2,H
1971-02-27,1970,Sunderland,Luton Town,0-0,0,0,2,2,0,0,D
1971-02-27,1970,Swindon Town,Birmingham City,1-2,1,2,2,2,3,-1,A
1971-03-01,1970,Millwall,Leicester City,0-0,0,0,2,2,0,0,D
1971-03-02,1970,Charlton Athletic,Watford,1-2,1,2,2,2,3,-1,A
1971-03-06,1970,Birmingham City,Watford,2-0,2,0,2,2,2,2,H
1971-03-06,1970,Bristol City,Bolton Wanderers,1-1,1,1,2,2,2,0,D
1971-03-06,1970,Cardiff City,Carlisle United,4-0,4,0,2,2,4,4,H
1971-03-06,1970,Luton Town,Charlton Athletic,1-1,1,1,2,2,2,0,D
1971-03-06,1970,Middlesbrough,Swindon Town,3-0,3,0,2,2,3,3,H
1971-03-06,1970,Millwall,Leyton Orient,0-1,0,1,2,2,1,-1,A
1971-03-06,1970,Norwich City,Blackburn Rovers,2-1,2,1,2,2,3,1,H
1971-03-06,1970,Oxford United,Sunderland,0-0,0,0,2,2,0,0,D
1971-03-06,1970,Portsmouth,Queens Park Rangers,2-0,2,0,2,2,2,2,H
1971-03-09,1970,Sheffield United,Hull City,1-2,1,2,2,2,3,-1,A
1971-03-10,1970,Leicester City,Sheffield Wednesday,1-0,1,0,2,2,1,1,H
1971-03-10,1970,Oxford United,Leyton Orient,0-1,0,1,2,2,1,-1,A
1971-03-10,1970,Portsmouth,Bristol City,1-1,1,1,2,2,2,0,D
1971-03-13,1970,Blackburn Rovers,Cardiff City,1-1,1,1,2,2,2,0,D
1971-03-13,1970,Bolton Wanderers,Millwall,1-1,1,1,2,2,2,0,D
1971-03-13,1970,Carlisle United,Luton Town,1-0,1,0,2,2,1,1,H
1971-03-13,1970,Charlton Athletic,Middlesbrough,1-0,1,0,2,2,1,1,H
1971-03-13,1970,Hull City,Oxford United,0-1,0,1,2,2,1,-1,A
1971-03-13,1970,Leyton Orient,Birmingham City,0-2,0,2,2,2,2,-2,A
1971-03-13,1970,Queens Park Rangers,Sheffield United,2-2,2,2,2,2,4,0,D
1971-03-13,1970,Sheffield Wednesday,Norwich City,2-1,2,1,2,2,3,1,H
1971-03-13,1970,Sunderland,Portsmouth,0-0,0,0,2,2,0,0,D
1971-03-13,1970,Swindon Town,Leicester City,0-1,0,1,2,2,1,-1,A
1971-03-13,1970,Watford,Bristol City,0-3,0,3,2,2,3,-3,A
1971-03-20,1970,Birmingham City,Sunderland,3-1,3,1,2,2,4,2,H
1971-03-20,1970,Bristol City,Swindon Town,2-1,2,1,2,2,3,1,H
1971-03-20,1970,Cardiff City,Queens Park Rangers,1-0,1,0,2,2,1,1,H
1971-03-20,1970,Leicester City,Watford,1-1,1,1,2,2,2,0,D
1971-03-20,1970,Luton Town,Hull City,3-1,3,1,2,2,4,2,H
1971-03-20,1970,Middlesbrough,Leyton Orient,0-1,0,1,2,2,1,-1,A
1971-03-20,1970,Millwall,Sheffield Wednesday,1-0,1,0,2,2,1,1,H
1971-03-20,1970,Norwich City,Bolton Wanderers,2-1,2,1,2,2,3,1,H
1971-03-20,1970,Oxford United,Carlisle United,1-1,1,1,2,2,2,0,D
1971-03-20,1970,Portsmouth,Charlton Athletic,2-0,2,0,2,2,2,2,H
1971-03-20,1970,Sheffield United,Blackburn Rovers,5-0,5,0,2,2,5,5,H
1971-03-23,1970,Queens Park Rangers,Norwich City,0-1,0,1,2,2,1,-1,A
1971-03-24,1970,Oxford United,Portsmouth,1-1,1,1,2,2,2,0,D
1971-03-27,1970,Birmingham City,Cardiff City,2-0,2,0,2,2,2,2,H
1971-03-27,1970,Bolton Wanderers,Hull City,0-0,0,0,2,2,0,0,D
1971-03-27,1970,Bristol City,Sheffield United,0-1,0,1,2,2,1,-1,A
1971-03-27,1970,Leicester City,Oxford United,0-0,0,0,2,2,0,0,D
1971-03-27,1970,Leyton Orient,Carlisle United,1-1,1,1,2,2,2,0,D
1971-03-27,1970,Middlesbrough,Luton Town,2-1,2,1,2,2,3,1,H
1971-03-27,1970,Millwall,Charlton Athletic,2-0,2,0,2,2,2,2,H
1971-03-27,1970,Norwich City,Sunderland,3-0,3,0,2,2,3,3,H
1971-03-27,1970,Swindon Town,Blackburn Rovers,3-0,3,0,2,2,3,3,H
1971-03-27,1970,Watford,Queens Park Rangers,1-2,1,2,2,2,3,-1,A
1971-03-29,1970,Leyton Orient,Leicester City,0-1,0,1,2,2,1,-1,A
1971-03-30,1970,Luton Town,Millwall,1-1,1,1,2,2,2,0,D
1971-03-30,1970,Sheffield Wednesday,Portsmouth,3-1,3,1,2,2,4,2,H
1971-04-03,1970,Blackburn Rovers,Sheffield Wednesday,3-2,3,2,2,2,5,1,H
1971-04-03,1970,Cardiff City,Bristol City,1-0,1,0,2,2,1,1,H
1971-04-03,1970,Carlisle United,Leicester City,0-1,0,1,2,2,1,-1,A
1971-04-03,1970,Charlton Athletic,Leyton Orient,2-0,2,0,2,2,2,2,H
1971-04-03,1970,Hull City,Watford,1-0,1,0,2,2,1,1,H
1971-04-03,1970,Luton Town,Birmingham City,3-2,3,2,2,2,5,1,H
1971-04-03,1970,Oxford United,Middlesbrough,2-2,2,2,2,2,4,0,D
1971-04-03,1970,Portsmouth,Millwall,0-2,0,2,2,2,2,-2,A
1971-04-03,1970,Queens Park Rangers,Bolton Wanderers,4-0,4,0,2,2,4,4,H
1971-04-03,1970,Sheffield United,Norwich City,0-0,0,0,2,2,0,0,D
1971-04-03,1970,Sunderland,Swindon Town,5-2,5,2,2,2,7,3,H
1971-04-05,1970,Millwall,Carlisle United,2-1,2,1,2,2,3,1,H
1971-04-06,1970,Queens Park Rangers,Sheffield Wednesday,1-0,1,0,2,2,1,1,H
1971-04-07,1970,Cardiff City,Bolton Wanderers,1-0,1,0,2,2,1,1,H
1971-04-09,1970,Blackburn Rovers,Middlesbrough,1-1,1,1,2,2,2,0,D
1971-04-09,1970,Bristol City,Luton Town,3-2,3,2,2,2,5,1,H
1971-04-09,1970,Charlton Athletic,Norwich City,2-1,2,1,2,2,3,1,H
1971-04-09,1970,Oxford United,Birmingham City,1-0,1,0,2,2,1,1,H
1971-04-09,1970,Sunderland,Leyton Orient,1-0,1,0,2,2,1,1,H
1971-04-09,1970,Watford,Portsmouth,0-0,0,0,2,2,0,0,D
1971-04-10,1970,Birmingham City,Blackburn Rovers,1-0,1,0,2,2,1,1,H
1971-04-10,1970,Bolton Wanderers,Carlisle United,0-3,0,3,2,2,3,-3,A
1971-04-10,1970,Bristol City,Portsmouth,2-0,2,0,2,2,2,2,H
1971-04-10,1970,Leicester City,Sheffield United,0-0,0,0,2,2,0,0,D
1971-04-10,1970,Leyton Orient,Oxford United,0-0,0,0,2,2,0,0,D
1971-04-10,1970,Middlesbrough,Sunderland,2-2,2,2,2,2,4,0,D
1971-04-10,1970,Millwall,Luton Town,4-0,4,0,2,2,4,4,H
1971-04-10,1970,Norwich City,Queens Park Rangers,3-0,3,0,2,2,3,3,H
1971-04-10,1970,Sheffield Wednesday,Hull City,1-1,1,1,2,2,2,0,D
1971-04-10,1970,Swindon Town,Cardiff City,2-2,2,2,2,2,4,0,D
1971-04-10,1970,Watford,Charlton Athletic,1-1,1,1,2,2,2,0,D
1971-04-12,1970,Bolton Wanderers,Sunderland,1-3,1,3,2,2,4,-2,A
1971-04-12,1970,Hull City,Bristol City,1-0,1,0,2,2,1,1,H
1971-04-12,1970,Leyton Orient,Queens Park Rangers,0-1,0,1,2,2,1,-1,A
1971-04-12,1970,Luton Town,Leicester City,1-3,1,3,2,2,4,-2,A
1971-04-12,1970,Norwich City,Oxford United,1-1,1,1,2,2,2,0,D
1971-04-12,1970,Portsmouth,Swindon Town,0-2,0,2,2,2,2,-2,A
1971-04-12,1970,Sheffield Wednesday,Sheffield United,0-0,0,0,2,2,0,0,D
1971-04-13,1970,Birmingham City,Hull City,0-0,0,0,2,2,0,0,D
1971-04-13,1970,Carlisle United,Watford,2-1,2,1,2,2,3,1,H
1971-04-13,1970,Leicester City,Blackburn Rovers,1-1,1,1,2,2,2,0,D
1971-04-13,1970,Middlesbrough,Cardiff City,1-1,1,1,2,2,2,0,D
1971-04-13,1970,Sheffield United,Millwall,2-0,2,0,2,2,2,2,H
1971-04-13,1970,Swindon Town,Charlton Athletic,1-1,1,1,2,2,2,0,D
1971-04-17,1970,Blackburn Rovers,Millwall,0-2,0,2,2,2,2,-2,A
1971-04-17,1970,Cardiff City,Watford,0-1,0,1,2,2,1,-1,A
1971-04-17,1970,Carlisle United,Norwich City,4-2,4,2,2,2,6,2,H
1971-04-17,1970,Charlton Athletic,Bolton Wanderers,4-1,4,1,2,2,5,3,H
1971-04-17,1970,Hull City,Leyton Orient,5-2,5,2,2,2,7,3,H
1971-04-17,1970,Luton Town,Sheffield Wednesday,2-2,2,2,2,2,4,0,D
1971-04-17,1970,Oxford United,Bristol City,1-0,1,0,2,2,1,1,H
1971-04-17,1970,Portsmouth,Middlesbrough,1-1,1,1,2,2,2,0,D
1971-04-17,1970,Queens Park Rangers,Swindon Town,4-2,4,2,2,2,6,2,H
1971-04-17,1970,Sheffield United,Birmingham City,3-0,3,0,2,2,3,3,H
1971-04-17,1970,Sunderland,Leicester City,0-0,0,0,2,2,0,0,D
1971-04-20,1970,Charlton Athletic,Queens Park Rangers,0-3,0,3,2,2,3,-3,A
1971-04-24,1970,Birmingham City,Portsmouth,1-1,1,1,2,2,2,0,D
1971-04-24,1970,Bolton Wanderers,Blackburn Rovers,1-1,1,1,2,2,2,0,D
1971-04-24,1970,Bristol City,Queens Park Rangers,0-0,0,0,2,2,0,0,D
1971-04-24,1970,Leicester City,Charlton Athletic,1-0,1,0,2,2,1,1,H
1971-04-24,1970,Leyton Orient,Luton Town,1-2,1,2,2,2,3,-1,A
1971-04-24,1970,Middlesbrough,Sheffield United,1-1,1,1,2,2,2,0,D
1971-04-24,1970,Millwall,Hull City,4-0,4,0,2,2,4,4,H
1971-04-24,1970,Norwich City,Cardiff City,1-2,1,2,2,2,3,-1,A
1971-04-24,1970,Sheffield Wednesday,Sunderland,1-2,1,2,2,2,3,-1,A
1971-04-24,1970,Swindon Town,Carlisle United,0-0,0,0,2,2,0,0,D
1971-04-24,1970,Watford,Oxford United,2-1,2,1,2,2,3,1,H
1971-04-26,1970,Leyton Orient,Portsmouth,1-1,1,1,2,2,2,0,D
1971-04-27,1970,Bristol City,Leicester City,0-1,0,1,2,2,1,-1,A
1971-04-27,1970,Charlton Athletic,Sunderland,1-1,1,1,2,2,2,0,D
1971-04-27,1970,Middlesbrough,Birmingham City,0-0,0,0,2,2,0,0,D
1971-04-27,1970,Queens Park Rangers,Blackburn Rovers,2-0,2,0,2,2,2,2,H
1971-04-27,1970,Sheffield United,Cardiff City,5-1,5,1,2,2,6,4,H
1971-04-28,1970,Hull City,Carlisle United,1-2,1,2,2,2,3,-1,A
1971-04-28,1970,Oxford United,Luton Town,2-1,2,1,2,2,3,1,H
1971-04-28,1970,Watford,Swindon Town,1-2,1,2,2,2,3,-1,A
1971-05-01,1970,Blackburn Rovers,Bristol City,2-2,2,2,2,2,4,0,D
1971-05-01,1970,Cardiff City,Leyton Orient,1-0,1,0,2,2,1,1,H
1971-05-01,1970,Carlisle United,Sheffield Wednesday,3-0,3,0,2,2,3,3,H
1971-05-01,1970,Charlton Athletic,Birmingham City,1-1,1,1,2,2,2,0,D
1971-05-01,1970,Hull City,Norwich City,1-0,1,0,2,2,1,1,H
1971-05-01,1970,Luton Town,Swindon Town,1-1,1,1,2,2,2,0,D
1971-05-01,1970,Oxford United,Bolton Wanderers,1-1,1,1,2,2,2,0,D
1971-05-01,1970,Portsmouth,Leicester City,1-2,1,2,2,2,3,-1,A
1971-05-01,1970,Queens Park Rangers,Middlesbrough,1-1,1,1,2,2,2,0,D
1971-05-01,1970,Sheffield United,Watford,3-0,3,0,2,2,3,3,H
1971-05-01,1970,Sunderland,Millwall,0-1,0,1,2,2,1,-1,A
1971-05-04,1970,Luton Town,Cardiff City,3-0,3,0,2,2,3,3,H
1971-08-14,1971,Blackpool,Swindon Town,4-1,4,1,2,2,5,3,H
1971-08-14,1971,Bristol City,Millwall,3-3,3,3,2,2,6,0,D
1971-08-14,1971,Cardiff City,Burnley,2-2,2,2,2,2,4,0,D
1971-08-14,1971,Carlisle United,Preston North End,0-0,0,0,2,2,0,0,D
1971-08-14,1971,Charlton Athletic,Hull City,1-0,1,0,2,2,1,1,H
1971-08-14,1971,Fulham,Watford,3-0,3,0,2,2,3,3,H
1971-08-14,1971,Luton Town,Norwich City,1-1,1,1,2,2,2,0,D
1971-08-14,1971,Oxford United,Leyton Orient,1-1,1,1,2,2,2,0,D
1971-08-14,1971,Portsmouth,Middlesbrough,2-1,2,1,2,2,3,1,H
1971-08-14,1971,Queens Park Rangers,Sheffield Wednesday,3-0,3,0,2,2,3,3,H
1971-08-14,1971,Sunderland,Birmingham City,1-1,1,1,2,2,2,0,D
1971-08-16,1971,Blackpool,Cardiff City,3-0,3,0,2,2,3,3,H
1971-08-21,1971,Birmingham City,Carlisle United,3-2,3,2,2,2,5,1,H
1971-08-21,1971,Burnley,Luton Town,2-1,2,1,2,2,3,1,H
1971-08-21,1971,Hull City,Oxford United,1-0,1,0,2,2,1,1,H
1971-08-21,1971,Leyton Orient,Cardiff City,4-1,4,1,2,2,5,3,H
1971-08-21,1971,Middlesbrough,Queens Park Rangers,3-2,3,2,2,2,5,1,H
1971-08-21,1971,Millwall,Blackpool,1-0,1,0,2,2,1,1,H
1971-08-21,1971,Norwich City,Portsmouth,3-1,3,1,2,2,4,2,H
1971-08-21,1971,Preston North End,Fulham,2-0,2,0,2,2,2,2,H
1971-08-21,1971,Sheffield Wednesday,Bristol City,1-5,1,5,2,2,6,-4,A
1971-08-21,1971,Swindon Town,Charlton Athletic,2-1,2,1,2,2,3,1,H
1971-08-21,1971,Watford,Sunderland,1-1,1,1,2,2,2,0,D
1971-08-28,1971,Blackpool,Sheffield Wednesday,1-0,1,0,2,2,1,1,H
1971-08-28,1971,Bristol City,Middlesbrough,2-1,2,1,2,2,3,1,H
1971-08-28,1971,Cardiff City,Hull City,1-1,1,1,2,2,2,0,D
1971-08-28,1971,Carlisle United,Swindon Town,0-0,0,0,2,2,0,0,D
1971-08-28,1971,Charlton Athletic,Watford,2-0,2,0,2,2,2,2,H
1971-08-28,1971,Fulham,Norwich City,0-0,0,0,2,2,0,0,D
1971-08-28,1971,Luton Town,Preston North End,1-1,1,1,2,2,2,0,D
1971-08-28,1971,Oxford United,Burnley,2-1,2,1,2,2,3,1,H
1971-08-28,1971,Portsmouth,Birmingham City,1-0,1,0,2,2,1,1,H
1971-08-28,1971,Queens Park Rangers,Millwall,1-1,1,1,2,2,2,0,D
1971-08-28,1971,Sunderland,Leyton Orient,2-0,2,0,2,2,2,2,H
1971-08-30,1971,Millwall,Charlton Athletic,2-1,2,1,2,2,3,1,H
1971-08-30,1971,Preston North End,Burnley,1-3,1,3,2,2,4,-2,A
1971-08-31,1971,Bristol City,Cardiff City,2-0,2,0,2,2,2,2,H
1971-08-31,1971,Fulham,Queens Park Rangers,0-3,0,3,2,2,3,-3,A
1971-08-31,1971,Middlesbrough,Sheffield Wednesday,2-1,2,1,2,2,3,1,H
1971-09-01,1971,Hull City,Birmingham City,1-0,1,0,2,2,1,1,H
1971-09-01,1971,Norwich City,Leyton Orient,0-0,0,0,2,2,0,0,D
1971-09-01,1971,Oxford United,Luton Town,1-1,1,1,2,2,2,0,D
1971-09-01,1971,Portsmouth,Blackpool,1-3,1,3,2,2,4,-2,A
1971-09-01,1971,Sunderland,Carlisle United,0-3,0,3,2,2,3,-3,A
1971-09-01,1971,Watford,Swindon Town,0-0,0,0,2,2,0,0,D
1971-09-04,1971,Birmingham City,Charlton Athletic,4-1,4,1,2,2,5,3,H
1971-09-04,1971,Burnley,Bristol City,1-1,1,1,2,2,2,0,D
1971-09-04,1971,Hull City,Blackpool,1-0,1,0,2,2,1,1,H
1971-09-04,1971,Leyton Orient,Luton Town,0-0,0,0,2,2,0,0,D
1971-09-04,1971,Middlesbrough,Fulham,2-0,2,0,2,2,2,2,H
1971-09-04,1971,Millwall,Sunderland,1-1,1,1,2,2,2,0,D
1971-09-04,1971,Norwich City,Carlisle United,1-0,1,0,2,2,1,1,H
1971-09-04,1971,Preston North End,Oxford United,1-0,1,0,2,2,1,1,H
1971-09-04,1971,Sheffield Wednesday,Portsmouth,1-1,1,1,2,2,2,0,D
1971-09-04,1971,Swindon Town,Queens Park Rangers,0-0,0,0,2,2,0,0,D
1971-09-04,1971,Watford,Cardiff City,2-2,2,2,2,2,4,0,D
1971-09-11,1971,Blackpool,Norwich City,1-2,1,2,2,2,3,-1,A
1971-09-11,1971,Bristol City,Hull City,4-0,4,0,2,2,4,4,H
1971-09-11,1971,Cardiff City,Sheffield Wednesday,3-2,3,2,2,2,5,1,H
1971-09-11,1971,Carlisle United,Watford,2-0,2,0,2,2,2,2,H
1971-09-11,1971,Charlton Athletic,Middlesbrough,0-2,0,2,2,2,2,-2,A
1971-09-11,1971,Fulham,Burnley,0-2,0,2,2,2,2,-2,A
1971-09-11,1971,Luton Town,Birmingham City,0-0,0,0,2,2,0,0,D
1971-09-11,1971,Oxford United,Millwall,1-2,1,2,2,2,3,-1,A
1971-09-11,1971,Portsmouth,Leyton Orient,3-2,3,2,2,2,5,1,H
1971-09-11,1971,Queens Park Rangers,Preston North End,2-1,2,1,2,2,3,1,H
1971-09-11,1971,Sunderland,Swindon Town,1-0,1,0,2,2,1,1,H
1971-09-18,1971,Birmingham City,Bristol City,1-0,1,0,2,2,1,1,H
1971-09-18,1971,Burnley,Queens Park Rangers,1-0,1,0,2,2,1,1,H
1971-09-18,1971,Hull City,Portsmouth,1-3,1,3,2,2,4,-2,A
1971-09-18,1971,Leyton Orient,Carlisle United,2-1,2,1,2,2,3,1,H
1971-09-18,1971,Middlesbrough,Cardiff City,1-0,1,0,2,2,1,1,H
1971-09-18,1971,Millwall,Luton Town,2-2,2,2,2,2,4,0,D
1971-09-18,1971,Norwich City,Oxford United,3-2,3,2,2,2,5,1,H
1971-09-18,1971,Preston North End,Charlton Athletic,2-1,2,1,2,2,3,1,H
1971-09-18,1971,Sheffield Wednesday,Sunderland,3-0,3,0,2,2,3,3,H
1971-09-18,1971,Swindon Town,Fulham,4-0,4,0,2,2,4,4,H
1971-09-18,1971,Watford,Blackpool,1-0,1,0,2,2,1,1,H
1971-09-25,1971,Blackpool,Birmingham City,1-1,1,1,2,2,2,0,D
1971-09-25,1971,Bristol City,Norwich City,0-1,0,1,2,2,1,-1,A
1971-09-25,1971,Cardiff City,Swindon Town,0-1,0,1,2,2,1,-1,A
1971-09-25,1971,Carlisle United,Hull City,2-1,2,1,2,2,3,1,H
1971-09-25,1971,Charlton Athletic,Burnley,2-0,2,0,2,2,2,2,H
1971-09-25,1971,Fulham,Leyton Orient,2-1,2,1,2,2,3,1,H
1971-09-25,1971,Luton Town,Middlesbrough,3-2,3,2,2,2,5,1,H
1971-09-25,1971,Oxford United,Sheffield Wednesday,1-0,1,0,2,2,1,1,H
1971-09-25,1971,Portsmouth,Millwall,1-1,1,1,2,2,2,0,D
1971-09-25,1971,Queens Park Rangers,Watford,3-0,3,0,2,2,3,3,H
1971-09-25,1971,Sunderland,Preston North End,4-3,4,3,2,2,7,1,H
1971-09-27,1971,Millwall,Sheffield Wednesday,1-1,1,1,2,2,2,0,D
1971-09-28,1971,Birmingham City,Watford,4-1,4,1,2,2,5,3,H
1971-09-28,1971,Bristol City,Blackpool,4-0,4,0,2,2,4,4,H
1971-09-28,1971,Burnley,Leyton Orient,6-1,6,1,2,2,7,5,H
1971-09-28,1971,Carlisle United,Charlton Athletic,5-2,5,2,2,2,7,3,H
1971-09-28,1971,Luton Town,Fulham,2-0,2,0,2,2,2,2,H
1971-09-28,1971,Preston North End,Norwich City,0-2,0,2,2,2,2,-2,A
1971-09-29,1971,Hull City,Swindon Town,2-0,2,0,2,2,2,2,H
1971-09-29,1971,Oxford United,Queens Park Rangers,3-1,3,1,2,2,4,2,H
1971-09-29,1971,Sunderland,Middlesbrough,4-1,4,1,2,2,5,3,H
1971-10-02,1971,Birmingham City,Oxford United,0-0,0,0,2,2,0,0,D
1971-10-02,1971,Burnley,Sunderland,0-1,0,1,2,2,1,-1,A
1971-10-02,1971,Hull City,Luton Town,0-0,0,0,2,2,0,0,D
1971-10-02,1971,Leyton Orient,Charlton Athletic,3-2,3,2,2,2,5,1,H
1971-10-02,1971,Middlesbrough,Blackpool,1-0,1,0,2,2,1,1,H
1971-10-02,1971,Millwall,Carlisle United,2-1,2,1,2,2,3,1,H
1971-10-02,1971,Norwich City,Queens Park Rangers,0-0,0,0,2,2,0,0,D
1971-10-02,1971,Preston North End,Cardiff City,1-2,1,2,2,2,3,-1,A
1971-10-02,1971,Sheffield Wednesday,Fulham,4-0,4,0,2,2,4,4,H
1971-10-02,1971,Swindon Town,Bristol City,0-1,0,1,2,2,1,-1,A
1971-10-02,1971,Watford,Portsmouth,1-0,1,0,2,2,1,1,H
1971-10-09,1971,Blackpool,Leyton Orient,4-1,4,1,2,2,5,3,H
1971-10-09,1971,Bristol City,Watford,2-1,2,1,2,2,3,1,H
1971-10-09,1971,Cardiff City,Millwall,1-2,1,2,2,2,3,-1,A
1971-10-09,1971,Carlisle United,Burnley,0-3,0,3,2,2,3,-3,A
1971-10-09,1971,Charlton Athletic,Sheffield Wednesday,2-2,2,2,2,2,4,0,D
1971-10-09,1971,Fulham,Hull City,1-0,1,0,2,2,1,1,H
1971-10-09,1971,Luton Town,Swindon Town,0-0,0,0,2,2,0,0,D
1971-10-09,1971,Oxford United,Middlesbrough,0-0,0,0,2,2,0,0,D
1971-10-09,1971,Portsmouth,Preston North End,1-1,1,1,2,2,2,0,D
1971-10-09,1971,Queens Park Rangers,Birmingham City,1-0,1,0,2,2,1,1,H
1971-10-09,1971,Sunderland,Norwich City,1-1,1,1,2,2,2,0,D
1971-10-12,1971,Fulham,Oxford United,1-1,1,1,2,2,2,0,D
1971-10-13,1971,Norwich City,Burnley,3-0,3,0,2,2,3,3,H
1971-10-16,1971,Birmingham City,Sunderland,1-1,1,1,2,2,2,0,D
1971-10-16,1971,Burnley,Cardiff City,3-0,3,0,2,2,3,3,H
1971-10-16,1971,Hull City,Charlton Athletic,2-3,2,3,2,2,5,-1,A
1971-10-16,1971,Leyton Orient,Oxford United,1-1,1,1,2,2,2,0,D
1971-10-16,1971,Middlesbrough,Portsmouth,2-1,2,1,2,2,3,1,H
1971-10-16,1971,Millwall,Bristol City,3-1,3,1,2,2,4,2,H
1971-10-16,1971,Norwich City,Luton Town,3-1,3,1,2,2,4,2,H
1971-10-16,1971,Preston North End,Carlisle United,3-0,3,0,2,2,3,3,H
1971-10-16,1971,Sheffield Wednesday,Queens Park Rangers,0-0,0,0,2,2,0,0,D
1971-10-16,1971,Swindon Town,Blackpool,1-0,1,0,2,2,1,1,H
1971-10-16,1971,Watford,Fulham,1-2,1,2,2,2,3,-1,A
1971-10-18,1971,Leyton Orient,Preston North End,3-2,3,2,2,2,5,1,H
1971-10-19,1971,Charlton Athletic,Sunderland,2-2,2,2,2,2,4,0,D
1971-10-19,1971,Middlesbrough,Millwall,1-0,1,0,2,2,1,1,H
1971-10-19,1971,Queens Park Rangers,Luton Town,1-0,1,0,2,2,1,1,H
1971-10-19,1971,Swindon Town,Birmingham City,1-1,1,1,2,2,2,0,D
1971-10-20,1971,Portsmouth,Bristol City,1-1,1,1,2,2,2,0,D
1971-10-20,1971,Sheffield Wednesday,Carlisle United,2-1,2,1,2,2,3,1,H
1971-10-20,1971,Watford,Hull City,1-2,1,2,2,2,3,-1,A
1971-10-23,1971,Birmingham City,Preston North End,2-2,2,2,2,2,4,0,D
1971-10-23,1971,Blackpool,Queens Park Rangers,1-1,1,1,2,2,2,0,D
1971-10-23,1971,Bristol City,Leyton Orient,5-3,5,3,2,2,8,2,H
1971-10-23,1971,Cardiff City,Charlton Athletic,6-1,6,1,2,2,7,5,H
1971-10-23,1971,Hull City,Burnley,1-2,1,2,2,2,3,-1,A
1971-10-23,1971,Luton Town,Carlisle United,0-2,0,2,2,2,2,-2,A
1971-10-23,1971,Middlesbrough,Watford,2-1,2,1,2,2,3,1,H
1971-10-23,1971,Millwall,Norwich City,2-1,2,1,2,2,3,1,H
1971-10-23,1971,Oxford United,Sunderland,2-0,2,0,2,2,2,2,H
1971-10-23,1971,Portsmouth,Fulham,6-3,6,3,2,2,9,3,H
1971-10-23,1971,Sheffield Wednesday,Swindon Town,1-0,1,0,2,2,1,1,H
1971-10-30,1971,Burnley,Birmingham City,1-1,1,1,2,2,2,0,D
1971-10-30,1971,Carlisle United,Oxford United,2-1,2,1,2,2,3,1,H
1971-10-30,1971,Charlton Athletic,Bristol City,2-0,2,0,2,2,2,2,H
1971-10-30,1971,Fulham,Blackpool,2-1,2,1,2,2,3,1,H
1971-10-30,1971,Leyton Orient,Millwall,2-2,2,2,2,2,4,0,D
1971-10-30,1971,Norwich City,Cardiff City,2-1,2,1,2,2,3,1,H
1971-10-30,1971,Preston North End,Hull City,3-1,3,1,2,2,4,2,H
1971-10-30,1971,Queens Park Rangers,Portsmouth,1-1,1,1,2,2,2,0,D
1971-10-30,1971,Sunderland,Luton Town,2-2,2,2,2,2,4,0,D
1971-10-30,1971,Swindon Town,Middlesbrough,0-1,0,1,2,2,1,-1,A
1971-10-30,1971,Watford,Sheffield Wednesday,1-1,1,1,2,2,2,0,D
1971-11-06,1971,Birmingham City,Leyton Orient,2-0,2,0,2,2,2,2,H
1971-11-06,1971,Blackpool,Carlisle United,2-0,2,0,2,2,2,2,H
1971-11-06,1971,Bristol City,Fulham,1-2,1,2,2,2,3,-1,A
1971-11-06,1971,Cardiff City,Queens Park Rangers,0-0,0,0,2,2,0,0,D
1971-11-06,1971,Hull City,Norwich City,1-2,1,2,2,2,3,-1,A
1971-11-06,1971,Luton Town,Charlton Athletic,1-2,1,2,2,2,3,-1,A
1971-11-06,1971,Middlesbrough,Preston North End,0-1,0,1,2,2,1,-1,A
1971-11-06,1971,Millwall,Watford,3-2,3,2,2,2,5,1,H
1971-11-06,1971,Oxford United,Swindon Town,1-1,1,1,2,2,2,0,D
1971-11-06,1971,Portsmouth,Sunderland,2-2,2,2,2,2,4,0,D
1971-11-06,1971,Sheffield Wednesday,Burnley,2-1,2,1,2,2,3,1,H
1971-11-13,1971,Burnley,Middlesbrough,5-2,5,2,2,2,7,3,H
1971-11-13,1971,Carlisle United,Portsmouth,1-0,1,0,2,2,1,1,H
1971-11-13,1971,Charlton Athletic,Oxford United,3-0,3,0,2,2,3,3,H
1971-11-13,1971,Fulham,Cardiff City,4-3,4,3,2,2,7,1,H
1971-11-13,1971,Leyton Orient,Hull City,1-0,1,0,2,2,1,1,H
1971-11-13,1971,Norwich City,Birmingham City,2-2,2,2,2,2,4,0,D
1971-11-13,1971,Preston North End,Sheffield Wednesday,1-0,1,0,2,2,1,1,H
1971-11-13,1971,Queens Park Rangers,Bristol City,3-0,3,0,2,2,3,3,H
1971-11-13,1971,Sunderland,Blackpool,0-0,0,0,2,2,0,0,D
1971-11-13,1971,Swindon Town,Millwall,0-2,0,2,2,2,2,-2,A
1971-11-13,1971,Watford,Luton Town,2-1,2,1,2,2,3,1,H
1971-11-19,1971,Bristol City,Carlisle United,1-4,1,4,2,2,5,-3,A
1971-11-20,1971,Blackpool,Luton Town,0-1,0,1,2,2,1,-1,A
1971-11-20,1971,Cardiff City,Sunderland,1-2,1,2,2,2,3,-1,A
1971-11-20,1971,Fulham,Charlton Athletic,1-0,1,0,2,2,1,1,H
1971-11-20,1971,Middlesbrough,Leyton Orient,1-0,1,0,2,2,1,1,H
1971-11-20,1971,Millwall,Birmingham City,3-0,3,0,2,2,3,3,H
1971-11-20,1971,Portsmouth,Oxford United,2-0,2,0,2,2,2,2,H
1971-11-20,1971,Queens Park Rangers,Hull City,2-1,2,1,2,2,3,1,H
1971-11-20,1971,Sheffield Wednesday,Norwich City,1-1,1,1,2,2,2,0,D
1971-11-20,1971,Swindon Town,Preston North End,1-1,1,1,2,2,2,0,D
1971-11-20,1971,Watford,Burnley,2-1,2,1,2,2,3,1,H
1971-11-27,1971,Birmingham City,Fulham,3-1,3,1,2,2,4,2,H
1971-11-27,1971,Burnley,Swindon Town,1-2,1,2,2,2,3,-1,A
1971-11-27,1971,Carlisle United,Cardiff City,2-1,2,1,2,2,3,1,H
1971-11-27,1971,Charlton Athletic,Queens Park Rangers,2-1,2,1,2,2,3,1,H
1971-11-27,1971,Hull City,Millwall,0-0,0,0,2,2,0,0,D
1971-11-27,1971,Leyton Orient,Sheffield Wednesday,0-3,0,3,2,2,3,-3,A
1971-11-27,1971,Luton Town,Portsmouth,3-2,3,2,2,2,5,1,H
1971-11-27,1971,Norwich City,Middlesbrough,2-0,2,0,2,2,2,2,H
1971-11-27,1971,Oxford United,Blackpool,3-1,3,1,2,2,4,2,H
1971-11-27,1971,Preston North End,Watford,2-0,2,0,2,2,2,2,H
1971-11-27,1971,Sunderland,Bristol City,1-1,1,1,2,2,2,0,D
1971-12-01,1971,Cardiff City,Portsmouth,3-2,3,2,2,2,5,1,H
1971-12-04,1971,Blackpool,Preston North End,1-1,1,1,2,2,2,0,D
1971-12-04,1971,Bristol City,Luton Town,0-0,0,0,2,2,0,0,D
1971-12-04,1971,Fulham,Carlisle United,0-1,0,1,2,2,1,-1,A
1971-12-04,1971,Middlesbrough,Birmingham City,0-0,0,0,2,2,0,0,D
1971-12-04,1971,Millwall,Burnley,1-1,1,1,2,2,2,0,D
1971-12-04,1971,Portsmouth,Charlton Athletic,0-0,0,0,2,2,0,0,D
1971-12-04,1971,Queens Park Rangers,Sunderland,2-1,2,1,2,2,3,1,H
1971-12-04,1971,Sheffield Wednesday,Hull City,2-1,2,1,2,2,3,1,H
1971-12-04,1971,Swindon Town,Norwich City,0-1,0,1,2,2,1,-1,A
1971-12-04,1971,Watford,Leyton Orient,0-1,0,1,2,2,1,-1,A
1971-12-11,1971,Birmingham City,Sheffield Wednesday,0-0,0,0,2,2,0,0,D
1971-12-11,1971,Burnley,Portsmouth,1-3,1,3,2,2,4,-2,A
1971-12-11,1971,Carlisle United,Queens Park Rangers,1-4,1,4,2,2,5,-3,A
1971-12-11,1971,Charlton Athletic,Blackpool,2-3,2,3,2,2,5,-1,A
1971-12-11,1971,Hull City,Middlesbrough,4-3,4,3,2,2,7,1,H
1971-12-11,1971,Leyton Orient,Swindon Town,0-1,0,1,2,2,1,-1,A
1971-12-11,1971,Luton Town,Cardiff City,2-2,2,2,2,2,4,0,D
1971-12-11,1971,Norwich City,Watford,1-1,1,1,2,2,2,0,D
1971-12-11,1971,Oxford United,Bristol City,0-0,0,0,2,2,0,0,D
1971-12-11,1971,Preston North End,Millwall,4-0,4,0,2,2,4,4,H
1971-12-11,1971,Sunderland,Fulham,2-1,2,1,2,2,3,1,H
1971-12-18,1971,Blackpool,Hull City,1-1,1,1,2,2,2,0,D
1971-12-18,1971,Bristol City,Burnley,0-2,0,2,2,2,2,-2,A
1971-12-18,1971,Cardiff City,Watford,2-0,2,0,2,2,2,2,H
1971-12-18,1971,Carlisle United,Norwich City,3-0,3,0,2,2,3,3,H
1971-12-18,1971,Charlton Athletic,Birmingham City,1-1,1,1,2,2,2,0,D
1971-12-18,1971,Fulham,Middlesbrough,2-2,2,2,2,2,4,0,D
1971-12-18,1971,Luton Town,Leyton Orient,2-0,2,0,2,2,2,2,H
1971-12-18,1971,Oxford United,Preston North End,2-0,2,0,2,2,2,2,H
1971-12-18,1971,Portsmouth,Sheffield Wednesday,1-2,1,2,2,2,3,-1,A
1971-12-18,1971,Queens Park Rangers,Swindon Town,3-0,3,0,2,2,3,3,H
1971-12-18,1971,Sunderland,Millwall,3-3,3,3,2,2,6,0,D
1971-12-27,1971,Birmingham City,Cardiff City,3-0,3,0,2,2,3,3,H
1971-12-27,1971,Burnley,Blackpool,2-1,2,1,2,2,3,1,H
1971-12-27,1971,Hull City,Sunderland,2-3,2,3,2,2,5,-1,A
1971-12-27,1971,Leyton Orient,Queens Park Rangers,2-0,2,0,2,2,2,2,H
1971-12-27,1971,Middlesbrough,Carlisle United,2-2,2,2,2,2,4,0,D
1971-12-27,1971,Millwall,Fulham,4-1,4,1,2,2,5,3,H
1971-12-27,1971,Norwich City,Charlton Athletic,3-0,3,0,2,2,3,3,H
1971-12-27,1971,Preston North End,Bristol City,1-0,1,0,2,2,1,1,H
1971-12-27,1971,Sheffield Wednesday,Luton Town,2-2,2,2,2,2,4,0,D
1971-12-27,1971,Swindon Town,Portsmouth,3-1,3,1,2,2,4,2,H
1971-12-27,1971,Watford,Oxford United,0-1,0,1,2,2,1,-1,A
1972-01-01,1971,Blackpool,Watford,5-0,5,0,2,2,5,5,H
1972-01-01,1971,Bristol City,Birmingham City,1-0,1,0,2,2,1,1,H
1972-01-01,1971,Cardiff City,Middlesbrough,1-0,1,0,2,2,1,1,H
1972-01-01,1971,Carlisle United,Leyton Orient,2-0,2,0,2,2,2,2,H
1972-01-01,1971,Charlton Athletic,Preston North End,2-1,2,1,2,2,3,1,H
1972-01-01,1971,Fulham,Swindon Town,2-4,2,4,2,2,6,-2,A
1972-01-01,1971,Luton Town,Millwall,2-1,2,1,2,2,3,1,H
1972-01-01,1971,Oxford United,Norwich City,0-2,0,2,2,2,2,-2,A
1972-01-01,1971,Portsmouth,Hull City,0-0,0,0,2,2,0,0,D
1972-01-01,1971,Queens Park Rangers,Burnley,3-1,3,1,2,2,4,2,H
1972-01-01,1971,Sunderland,Sheffield Wednesday,2-0,2,0,2,2,2,2,H
1972-01-08,1971,Birmingham City,Portsmouth,6-3,6,3,2,2,9,3,H
1972-01-08,1971,Burnley,Oxford United,1-1,1,1,2,2,2,0,D
1972-01-08,1971,Hull City,Cardiff City,0-0,0,0,2,2,0,0,D
1972-01-08,1971,Leyton Orient,Sunderland,5-0,5,0,2,2,5,5,H
1972-01-08,1971,Middlesbrough,Bristol City,1-0,1,0,2,2,1,1,H
1972-01-08,1971,Millwall,Queens Park Rangers,0-0,0,0,2,2,0,0,D
1972-01-08,1971,Norwich City,Fulham,2-1,2,1,2,2,3,1,H
1972-01-08,1971,Preston North End,Luton Town,0-1,0,1,2,2,1,-1,A
1972-01-08,1971,Sheffield Wednesday,Blackpool,1-2,1,2,2,2,3,-1,A
1972-01-08,1971,Swindon Town,Carlisle United,0-0,0,0,2,2,0,0,D
1972-01-08,1971,Watford,Charlton Athletic,0-3,0,3,2,2,3,-3,A
1972-01-22,1971,Blackpool,Bristol City,1-0,1,0,2,2,1,1,H
1972-01-22,1971,Charlton Athletic,Carlisle United,1-1,1,1,2,2,2,0,D
1972-01-22,1971,Fulham,Luton Town,3-1,3,1,2,2,4,2,H
1972-01-22,1971,Leyton Orient,Burnley,1-0,1,0,2,2,1,1,H
1972-01-22,1971,Middlesbrough,Sunderland,2-0,2,0,2,2,2,2,H
1972-01-22,1971,Norwich City,Preston North End,1-1,1,1,2,2,2,0,D
1972-01-22,1971,Portsmouth,Cardiff City,2-0,2,0,2,2,2,2,H
1972-01-22,1971,Queens Park Rangers,Oxford United,4-2,4,2,2,2,6,2,H
1972-01-22,1971,Sheffield Wednesday,Millwall,1-1,1,1,2,2,2,0,D
1972-01-22,1971,Swindon Town,Hull City,2-1,2,1,2,2,3,1,H
1972-01-22,1971,Watford,Birmingham City,0-1,0,1,2,2,1,-1,A
1972-01-29,1971,Birmingham City,Swindon Town,4-1,4,1,2,2,5,3,H
1972-01-29,1971,Bristol City,Portsmouth,1-1,1,1,2,2,2,0,D
1972-01-29,1971,Burnley,Norwich City,1-0,1,0,2,2,1,1,H
1972-01-29,1971,Cardiff City,Blackpool,3-4,3,4,2,2,7,-1,A
1972-01-29,1971,Carlisle United,Sheffield Wednesday,2-2,2,2,2,2,4,0,D
1972-01-29,1971,Hull City,Watford,4-0,4,0,2,2,4,4,H
1972-01-29,1971,Luton Town,Queens Park Rangers,1-1,1,1,2,2,2,0,D
1972-01-29,1971,Millwall,Middlesbrough,1-0,1,0,2,2,1,1,H
1972-01-29,1971,Oxford United,Fulham,1-0,1,0,2,2,1,1,H
1972-01-29,1971,Preston North End,Leyton Orient,1-1,1,1,2,2,2,0,D
1972-01-29,1971,Sunderland,Charlton Athletic,3-0,3,0,2,2,3,3,H
1972-02-05,1971,Luton Town,Oxford United,1-2,1,2,2,2,3,-1,A
1972-02-12,1971,Burnley,Hull City,0-2,0,2,2,2,2,-2,A
1972-02-12,1971,Carlisle United,Luton Town,0-0,0,0,2,2,0,0,D
1972-02-12,1971,Charlton Athletic,Cardiff City,2-2,2,2,2,2,4,0,D
1972-02-12,1971,Fulham,Portsmouth,1-1,1,1,2,2,2,0,D
1972-02-12,1971,Leyton Orient,Bristol City,2-0,2,0,2,2,2,2,H
1972-02-12,1971,Norwich City,Millwall,2-2,2,2,2,2,4,0,D
1972-02-12,1971,Preston North End,Birmingham City,0-0,0,0,2,2,0,0,D
1972-02-12,1971,Queens Park Rangers,Blackpool,0-1,0,1,2,2,1,-1,A
1972-02-12,1971,Sunderland,Oxford United,3-0,3,0,2,2,3,3,H
1972-02-12,1971,Swindon Town,Sheffield Wednesday,1-0,1,0,2,2,1,1,H
1972-02-12,1971,Watford,Middlesbrough,0-1,0,1,2,2,1,-1,A
1972-02-19,1971,Birmingham City,Burnley,2-0,2,0,2,2,2,2,H
1972-02-19,1971,Blackpool,Fulham,2-1,2,1,2,2,3,1,H
1972-02-19,1971,Bristol City,Charlton Athletic,2-0,2,0,2,2,2,2,H
1972-02-19,1971,Cardiff City,Norwich City,0-0,0,0,2,2,0,0,D
1972-02-19,1971,Hull City,Preston North End,3-2,3,2,2,2,5,1,H
1972-02-19,1971,Luton Town,Sunderland,1-2,1,2,2,2,3,-1,A
1972-02-19,1971,Middlesbrough,Swindon Town,2-0,2,0,2,2,2,2,H
1972-02-19,1971,Millwall,Leyton Orient,2-1,2,1,2,2,3,1,H
1972-02-19,1971,Oxford United,Carlisle United,3-1,3,1,2,2,4,2,H
1972-02-19,1971,Portsmouth,Queens Park Rangers,1-0,1,0,2,2,1,1,H
1972-02-19,1971,Sheffield Wednesday,Watford,2-1,2,1,2,2,3,1,H
1972-02-26,1971,Burnley,Sheffield Wednesday,5-3,5,3,2,2,8,2,H
1972-02-26,1971,Carlisle United,Blackpool,2-0,2,0,2,2,2,2,H
1972-02-26,1971,Charlton Athletic,Luton Town,2-0,2,0,2,2,2,2,H
1972-02-26,1971,Fulham,Bristol City,2-0,2,0,2,2,2,2,H
1972-02-26,1971,Swindon Town,Oxford United,4-0,4,0,2,2,4,4,H
1972-02-26,1971,Watford,Millwall,0-1,0,1,2,2,1,-1,A
1972-03-01,1971,Sunderland,Portsmouth,3-2,3,2,2,2,5,1,H
1972-03-04,1971,Birmingham City,Norwich City,4-0,4,0,2,2,4,4,H
1972-03-04,1971,Blackpool,Sunderland,1-1,1,1,2,2,2,0,D
1972-03-04,1971,Bristol City,Queens Park Rangers,2-0,2,0,2,2,2,2,H
1972-03-04,1971,Cardiff City,Fulham,1-0,1,0,2,2,1,1,H
1972-03-04,1971,Hull City,Leyton Orient,1-1,1,1,2,2,2,0,D
1972-03-04,1971,Luton Town,Watford,0-0,0,0,2,2,0,0,D
1972-03-04,1971,Middlesbrough,Burnley,1-0,1,0,2,2,1,1,H
1972-03-04,1971,Millwall,Swindon Town,2-2,2,2,2,2,4,0,D
1972-03-04,1971,Oxford United,Charlton Athletic,2-1,2,1,2,2,3,1,H
1972-03-04,1971,Portsmouth,Carlisle United,1-0,1,0,2,2,1,1,H
1972-03-04,1971,Sheffield Wednesday,Preston North End,1-0,1,0,2,2,1,1,H
1972-03-11,1971,Birmingham City,Queens Park Rangers,0-0,0,0,2,2,0,0,D
1972-03-11,1971,Burnley,Carlisle United,3-1,3,1,2,2,4,2,H
1972-03-11,1971,Hull City,Fulham,4-0,4,0,2,2,4,4,H
1972-03-11,1971,Leyton Orient,Blackpool,0-1,0,1,2,2,1,-1,A
1972-03-11,1971,Middlesbrough,Oxford United,2-1,2,1,2,2,3,1,H
1972-03-11,1971,Millwall,Cardiff City,1-1,1,1,2,2,2,0,D
1972-03-11,1971,Norwich City,Sunderland,1-1,1,1,2,2,2,0,D
1972-03-11,1971,Preston North End,Portsmouth,4-0,4,0,2,2,4,4,H
1972-03-11,1971,Watford,Bristol City,0-2,0,2,2,2,2,-2,A
1972-03-14,1971,Carlisle United,Middlesbrough,3-0,3,0,2,2,3,3,H
1972-03-15,1971,Norwich City,Hull City,2-0,2,0,2,2,2,2,H
1972-03-18,1971,Blackpool,Millwall,0-0,0,0,2,2,0,0,D
1972-03-18,1971,Bristol City,Sheffield Wednesday,1-0,1,0,2,2,1,1,H
1972-03-18,1971,Charlton Athletic,Swindon Town,3-1,3,1,2,2,4,2,H
1972-03-18,1971,Fulham,Preston North End,0-0,0,0,2,2,0,0,D
1972-03-18,1971,Luton Town,Burnley,1-0,1,0,2,2,1,1,H
1972-03-18,1971,Oxford United,Hull City,2-2,2,2,2,2,4,0,D
1972-03-18,1971,Portsmouth,Norwich City,2-1,2,1,2,2,3,1,H
1972-03-18,1971,Queens Park Rangers,Middlesbrough,1-0,1,0,2,2,1,1,H
1972-03-21,1971,Cardiff City,Oxford United,1-1,1,1,2,2,2,0,D
1972-03-21,1971,Carlisle United,Birmingham City,2-2,2,2,2,2,4,0,D
1972-03-24,1971,Leyton Orient,Portsmouth,2-1,2,1,2,2,3,1,H
1972-03-25,1971,Birmingham City,Luton Town,1-0,1,0,2,2,1,1,H
1972-03-25,1971,Burnley,Fulham,1-1,1,1,2,2,2,0,D
1972-03-25,1971,Hull City,Bristol City,1-1,1,1,2,2,2,0,D
1972-03-25,1971,Middlesbrough,Charlton Athletic,2-2,2,2,2,2,4,0,D
1972-03-25,1971,Millwall,Oxford United,2-0,2,0,2,2,2,2,H
1972-03-25,1971,Norwich City,Blackpool,5-1,5,1,2,2,6,4,H
1972-03-25,1971,Preston North End,Queens Park Rangers,1-1,1,1,2,2,2,0,D
1972-03-25,1971,Sheffield Wednesday,Cardiff City,2-2,2,2,2,2,4,0,D
1972-03-25,1971,Swindon Town,Sunderland,1-1,1,1,2,2,2,0,D
1972-03-25,1971,Watford,Carlisle United,1-2,1,2,2,2,3,-1,A
1972-03-28,1971,Fulham,Sheffield Wednesday,4-0,4,0,2,2,4,4,H
1972-03-29,1971,Cardiff City,Preston North End,5-2,5,2,2,2,7,3,H
1972-03-31,1971,Bristol City,Swindon Town,1-0,1,0,2,2,1,1,H
1972-03-31,1971,Charlton Athletic,Leyton Orient,1-2,1,2,2,2,3,-1,A
1972-03-31,1971,Middlesbrough,Luton Town,0-0,0,0,2,2,0,0,D
1972-03-31,1971,Millwall,Portsmouth,1-0,1,0,2,2,1,1,H
1972-03-31,1971,Oxford United,Birmingham City,0-1,0,1,2,2,1,-1,A
1972-03-31,1971,Watford,Queens Park Rangers,0-2,0,2,2,2,2,-2,A
1972-04-01,1971,Blackpool,Burnley,4-2,4,2,2,2,6,2,H
1972-04-01,1971,Bristol City,Preston North End,4-1,4,1,2,2,5,3,H
1972-04-01,1971,Cardiff City,Birmingham City,0-0,0,0,2,2,0,0,D
1972-04-01,1971,Charlton Athletic,Norwich City,0-2,0,2,2,2,2,-2,A
1972-04-01,1971,Fulham,Millwall,1-0,1,0,2,2,1,1,H
1972-04-01,1971,Luton Town,Sheffield Wednesday,3-1,3,1,2,2,4,2,H
1972-04-01,1971,Oxford United,Watford,0-0,0,0,2,2,0,0,D
1972-04-01,1971,Portsmouth,Swindon Town,1-2,1,2,2,2,3,-1,A
1972-04-01,1971,Queens Park Rangers,Leyton Orient,1-0,1,0,2,2,1,1,H
1972-04-01,1971,Sunderland,Hull City,0-1,0,1,2,2,1,-1,A
1972-04-03,1971,Blackpool,Middlesbrough,3-1,3,1,2,2,4,2,H
1972-04-03,1971,Hull City,Carlisle United,2-0,2,0,2,2,2,2,H
1972-04-03,1971,Leyton Orient,Fulham,1-0,1,0,2,2,1,1,H
1972-04-03,1971,Portsmouth,Watford,2-2,2,2,2,2,4,0,D
1972-04-03,1971,Queens Park Rangers,Norwich City,0-0,0,0,2,2,0,0,D
1972-04-03,1971,Sheffield Wednesday,Oxford United,0-0,0,0,2,2,0,0,D
1972-04-03,1971,Sunderland,Burnley,4-3,4,3,2,2,7,1,H
1972-04-04,1971,Birmingham City,Blackpool,2-1,2,1,2,2,3,1,H
1972-04-04,1971,Burnley,Charlton Athletic,3-1,3,1,2,2,4,2,H
1972-04-04,1971,Carlisle United,Millwall,3-3,3,3,2,2,6,0,D
1972-04-04,1971,Luton Town,Hull City,0-1,0,1,2,2,1,-1,A
1972-04-04,1971,Norwich City,Bristol City,2-2,2,2,2,2,4,0,D
1972-04-04,1971,Preston North End,Sunderland,1-3,1,3,2,2,4,-2,A
1972-04-04,1971,Swindon Town,Cardiff City,3-1,3,1,2,2,4,2,H
1972-04-08,1971,Birmingham City,Millwall,1-0,1,0,2,2,1,1,H
1972-04-08,1971,Burnley,Watford,3-0,3,0,2,2,3,3,H
1972-04-08,1971,Carlisle United,Bristol City,2-0,2,0,2,2,2,2,H
1972-04-08,1971,Charlton Athletic,Fulham,2-2,2,2,2,2,4,0,D
1972-04-08,1971,Hull City,Queens Park Rangers,1-1,1,1,2,2,2,0,D
1972-04-08,1971,Leyton Orient,Middlesbrough,1-1,1,1,2,2,2,0,D
1972-04-08,1971,Luton Town,Blackpool,1-4,1,4,2,2,5,-3,A
1972-04-08,1971,Norwich City,Sheffield Wednesday,1-0,1,0,2,2,1,1,H
1972-04-08,1971,Oxford United,Portsmouth,2-2,2,2,2,2,4,0,D
1972-04-08,1971,Sunderland,Cardiff City,1-1,1,1,2,2,2,0,D
1972-04-10,1971,Sheffield Wednesday,Charlton Athletic,2-1,2,1,2,2,3,1,H
1972-04-12,1971,Cardiff City,Leyton Orient,1-0,1,0,2,2,1,1,H
1972-04-15,1971,Blackpool,Oxford United,2-0,2,0,2,2,2,2,H
1972-04-15,1971,Bristol City,Sunderland,3-1,3,1,2,2,4,2,H
1972-04-15,1971,Cardiff City,Carlisle United,3-1,3,1,2,2,4,2,H
1972-04-15,1971,Middlesbrough,Norwich City,1-0,1,0,2,2,1,1,H
1972-04-15,1971,Millwall,Hull City,2-1,2,1,2,2,3,1,H
1972-04-15,1971,Portsmouth,Luton Town,0-3,0,3,2,2,3,-3,A
1972-04-15,1971,Queens Park Rangers,Charlton Athletic,2-0,2,0,2,2,2,2,H
1972-04-15,1971,Swindon Town,Burnley,0-1,0,1,2,2,1,-1,A
1972-04-15,1971,Watford,Preston North End,1-0,1,0,2,2,1,1,H
1972-04-17,1971,Preston North End,Middlesbrough,1-0,1,0,2,2,1,1,H
1972-04-17,1971,Sheffield Wednesday,Leyton Orient,3-1,3,1,2,2,4,2,H
1972-04-17,1971,Sunderland,Watford,5-0,5,0,2,2,5,5,H
1972-04-18,1971,Fulham,Birmingham City,0-0,0,0,2,2,0,0,D
1972-04-18,1971,Swindon Town,Luton Town,2-1,2,1,2,2,3,1,H
1972-04-22,1971,Birmingham City,Middlesbrough,1-1,1,1,2,2,2,0,D
1972-04-22,1971,Burnley,Millwall,2-0,2,0,2,2,2,2,H
1972-04-22,1971,Carlisle United,Fulham,3-1,3,1,2,2,4,2,H
1972-04-22,1971,Charlton Athletic,Portsmouth,1-1,1,1,2,2,2,0,D
1972-04-22,1971,Hull City,Sheffield Wednesday,1-0,1,0,2,2,1,1,H
1972-04-22,1971,Leyton Orient,Watford,1-0,1,0,2,2,1,1,H
1972-04-22,1971,Luton Town,Bristol City,0-0,0,0,2,2,0,0,D
1972-04-22,1971,Norwich City,Swindon Town,1-0,1,0,2,2,1,1,H
1972-04-22,1971,Oxford United,Cardiff City,1-0,1,0,2,2,1,1,H
1972-04-22,1971,Preston North End,Blackpool,1-4,1,4,2,2,5,-3,A
1972-04-22,1971,Sunderland,Queens Park Rangers,0-1,0,1,2,2,1,-1,A
1972-04-24,1971,Blackpool,Portsmouth,1-2,1,2,2,2,3,-1,A
1972-04-24,1971,Leyton Orient,Norwich City,1-2,1,2,2,2,3,-1,A
1972-04-25,1971,Birmingham City,Hull City,2-0,2,0,2,2,2,2,H
1972-04-25,1971,Burnley,Preston North End,1-0,1,0,2,2,1,1,H
1972-04-25,1971,Carlisle United,Sunderland,1-2,1,2,2,2,3,-1,A
1972-04-25,1971,Charlton Athletic,Millwall,0-2,0,2,2,2,2,-2,A
1972-04-25,1971,Queens Park Rangers,Fulham,0-0,0,0,2,2,0,0,D
1972-04-25,1971,Swindon Town,Watford,2-0,2,0,2,2,2,2,H
1972-04-26,1971,Cardiff City,Bristol City,2-3,2,3,2,2,5,-1,A
1972-04-26,1971,Sheffield Wednesday,Middlesbrough,1-0,1,0,2,2,1,1,H
1972-04-29,1971,Blackpool,Charlton Athletic,5-0,5,0,2,2,5,5,H
1972-04-29,1971,Bristol City,Oxford United,4-2,4,2,2,2,6,2,H
1972-04-29,1971,Cardiff City,Luton Town,1-1,1,1,2,2,2,0,D
1972-04-29,1971,Fulham,Sunderland,0-0,0,0,2,2,0,0,D
1972-04-29,1971,Middlesbrough,Hull City,3-0,3,0,2,2,3,3,H
1972-04-29,1971,Millwall,Preston North End,2-0,2,0,2,2,2,2,H
1972-04-29,1971,Portsmouth,Burnley,1-2,1,2,2,2,3,-1,A
1972-04-29,1971,Queens Park Rangers,Carlisle United,3-0,3,0,2,2,3,3,H
1972-04-29,1971,Sheffield Wednesday,Birmingham City,1-2,1,2,2,2,3,-1,A
1972-04-29,1971,Swindon Town,Leyton Orient,2-2,2,2,2,2,4,0,D
1972-04-29,1971,Watford,Norwich City,1-1,1,1,2,2,2,0,D
1972-05-01,1971,Preston North End,Swindon Town,2-2,2,2,2,2,4,0,D
1972-05-02,1971,Leyton Orient,Birmingham City,0-1,0,1,2,2,1,-1,A
1972-05-02,1971,Queens Park Rangers,Cardiff City,3-0,3,0,2,2,3,3,H
1972-08-12,1972,Brighton & Hove Albion,Bristol City,1-1,1,1,2,2,2,0,D
1972-08-12,1972,Burnley,Carlisle United,2-2,2,2,2,2,4,0,D
1972-08-12,1972,Cardiff City,Luton Town,2-1,2,1,2,2,3,1,H
1972-08-12,1972,Huddersfield Town,Blackpool,1-0,1,0,2,2,1,1,H
1972-08-12,1972,Leyton Orient,Oxford United,1-1,1,1,2,2,2,0,D
1972-08-12,1972,Middlesbrough,Sunderland,2-1,2,1,2,2,3,1,H
1972-08-12,1972,Millwall,Hull City,2-0,2,0,2,2,2,2,H
1972-08-12,1972,Nottingham Forest,Portsmouth,0-0,0,0,2,2,0,0,D
1972-08-12,1972,Preston North End,Aston Villa,0-1,0,1,2,2,1,-1,A
1972-08-12,1972,Sheffield Wednesday,Fulham,3-0,3,0,2,2,3,3,H
1972-08-12,1972,Swindon Town,Queens Park Rangers,2-2,2,2,2,2,4,0,D
1972-08-16,1972,Sheffield Wednesday,Swindon Town,2-1,2,1,2,2,3,1,H
1972-08-19,1972,Aston Villa,Huddersfield Town,2-0,2,0,2,2,2,2,H
1972-08-19,1972,Blackpool,Brighton & Hove Albion,6-2,6,2,2,2,8,4,H
1972-08-19,1972,Bristol City,Millwall,2-2,2,2,2,2,4,0,D
1972-08-19,1972,Carlisle United,Swindon Town,3-0,3,0,2,2,3,3,H
1972-08-19,1972,Fulham,Burnley,1-1,1,1,2,2,2,0,D
1972-08-19,1972,Hull City,Nottingham Forest,0-0,0,0,2,2,0,0,D
1972-08-19,1972,Luton Town,Preston North End,1-0,1,0,2,2,1,1,H
1972-08-19,1972,Oxford United,Middlesbrough,4-0,4,0,2,2,4,4,H
1972-08-19,1972,Portsmouth,Cardiff City,3-1,3,1,2,2,4,2,H
1972-08-19,1972,Queens Park Rangers,Sheffield Wednesday,4-2,4,2,2,2,6,2,H
1972-08-19,1972,Sunderland,Leyton Orient,1-0,1,0,2,2,1,1,H
1972-08-26,1972,Brighton & Hove Albion,Sunderland,2-2,2,2,2,2,4,0,D
1972-08-26,1972,Burnley,Aston Villa,4-1,4,1,2,2,5,3,H
1972-08-26,1972,Cardiff City,Blackpool,1-2,1,2,2,2,3,-1,A
1972-08-26,1972,Leyton Orient,Luton Town,0-1,0,1,2,2,1,-1,A
1972-08-26,1972,Middlesbrough,Fulham,1-2,1,2,2,2,3,-1,A
1972-08-26,1972,Millwall,Portsmouth,0-2,0,2,2,2,2,-2,A
1972-08-26,1972,Nottingham Forest,Oxford United,2-1,2,1,2,2,3,1,H
1972-08-26,1972,Preston North End,Queens Park Rangers,1-1,1,1,2,2,2,0,D
1972-08-26,1972,Sheffield Wednesday,Hull City,4-2,4,2,2,2,6,2,H
1972-08-26,1972,Swindon Town,Bristol City,2-1,2,1,2,2,3,1,H
1972-08-28,1972,Blackpool,Sunderland,0-0,0,0,2,2,0,0,D
1972-08-28,1972,Huddersfield Town,Carlisle United,1-1,1,1,2,2,2,0,D
1972-08-28,1972,Leyton Orient,Middlesbrough,2-0,2,0,2,2,2,2,H
1972-08-29,1972,Aston Villa,Carlisle United,1-0,1,0,2,2,1,1,H
1972-08-29,1972,Burnley,Preston North End,2-0,2,0,2,2,2,2,H
1972-08-29,1972,Hull City,Bristol City,2-0,2,0,2,2,2,2,H
1972-08-29,1972,Nottingham Forest,Brighton & Hove Albion,1-0,1,0,2,2,1,1,H
1972-08-29,1972,Swindon Town,Sheffield Wednesday,1-0,1,0,2,2,1,1,H
1972-08-30,1972,Cardiff City,Millwall,1-0,1,0,2,2,1,1,H
1972-08-30,1972,Luton Town,Oxford United,0-1,0,1,2,2,1,-1,A
1972-08-30,1972,Portsmouth,Huddersfield Town,1-2,1,2,2,2,3,-1,A
1972-09-02,1972,Aston Villa,Brighton & Hove Albion,1-1,1,1,2,2,2,0,D
1972-09-02,1972,Blackpool,Millwall,2-1,2,1,2,2,3,1,H
1972-09-02,1972,Bristol City,Sheffield Wednesday,1-2,1,2,2,2,3,-1,A
1972-09-02,1972,Carlisle United,Nottingham Forest,1-2,1,2,2,2,3,-1,A
1972-09-02,1972,Fulham,Preston North End,1-3,1,3,2,2,4,-2,A
1972-09-02,1972,Hull City,Leyton Orient,2-0,2,0,2,2,2,2,H
1972-09-02,1972,Luton Town,Huddersfield Town,4-1,4,1,2,2,5,3,H
1972-09-02,1972,Oxford United,Cardiff City,2-1,2,1,2,2,3,1,H
1972-09-02,1972,Portsmouth,Burnley,0-2,0,2,2,2,2,-2,A
1972-09-02,1972,Queens Park Rangers,Middlesbrough,2-2,2,2,2,2,4,0,D
1972-09-02,1972,Sunderland,Swindon Town,3-2,3,2,2,2,5,1,H
1972-09-09,1972,Brighton & Hove Albion,Fulham,2-1,2,1,2,2,3,1,H
1972-09-09,1972,Burnley,Queens Park Rangers,1-1,1,1,2,2,2,0,D
1972-09-09,1972,Cardiff City,Aston Villa,0-2,0,2,2,2,2,-2,A
1972-09-09,1972,Huddersfield Town,Oxford United,2-0,2,0,2,2,2,2,H
1972-09-09,1972,Leyton Orient,Bristol City,0-2,0,2,2,2,2,-2,A
1972-09-09,1972,Middlesbrough,Carlisle United,1-0,1,0,2,2,1,1,H
1972-09-09,1972,Millwall,Sunderland,0-1,0,1,2,2,1,-1,A
1972-09-09,1972,Nottingham Forest,Luton Town,0-1,0,1,2,2,1,-1,A
1972-09-09,1972,Preston North End,Hull City,1-0,1,0,2,2,1,1,H
1972-09-09,1972,Sheffield Wednesday,Portsmouth,2-1,2,1,2,2,3,1,H
1972-09-09,1972,Swindon Town,Blackpool,0-0,0,0,2,2,0,0,D
1972-09-16,1972,Aston Villa,Swindon Town,2-1,2,1,2,2,3,1,H
1972-09-16,1972,Blackpool,Leyton Orient,1-1,1,1,2,2,2,0,D
1972-09-16,1972,Bristol City,Middlesbrough,1-1,1,1,2,2,2,0,D
1972-09-16,1972,Carlisle United,Cardiff City,4-0,4,0,2,2,4,4,H
1972-09-16,1972,Fulham,Huddersfield Town,1-1,1,1,2,2,2,0,D
1972-09-16,1972,Hull City,Burnley,1-1,1,1,2,2,2,0,D
1972-09-16,1972,Luton Town,Brighton & Hove Albion,2-1,2,1,2,2,3,1,H
1972-09-16,1972,Oxford United,Millwall,2-1,2,1,2,2,3,1,H
1972-09-16,1972,Portsmouth,Preston North End,0-1,0,1,2,2,1,-1,A
1972-09-16,1972,Queens Park Rangers,Nottingham Forest,3-0,3,0,2,2,3,3,H
1972-09-16,1972,Sunderland,Sheffield Wednesday,1-1,1,1,2,2,2,0,D
1972-09-18,1972,Leyton Orient,Burnley,1-1,1,1,2,2,2,0,D
1972-09-19,1972,Huddersfield Town,Swindon Town,1-1,1,1,2,2,2,0,D
1972-09-19,1972,Middlesbrough,Preston North End,0-0,0,0,2,2,0,0,D
1972-09-19,1972,Nottingham Forest,Cardiff City,2-1,2,1,2,2,3,1,H
1972-09-19,1972,Queens Park Rangers,Bristol City,1-1,1,1,2,2,2,0,D
1972-09-20,1972,Brighton & Hove Albion,Millwall,1-3,1,3,2,2,4,-2,A
1972-09-20,1972,Fulham,Hull City,2-0,2,0,2,2,2,2,H
1972-09-20,1972,Oxford United,Sheffield Wednesday,1-0,1,0,2,2,1,1,H
1972-09-23,1972,Brighton & Hove Albion,Oxford United,2-2,2,2,2,2,4,0,D
1972-09-23,1972,Burnley,Blackpool,4-3,4,3,2,2,7,1,H
1972-09-23,1972,Cardiff City,Bristol City,1-3,1,3,2,2,4,-2,A
1972-09-23,1972,Huddersfield Town,Sunderland,1-1,1,1,2,2,2,0,D
1972-09-23,1972,Leyton Orient,Queens Park Rangers,2-2,2,2,2,2,4,0,D
1972-09-23,1972,Middlesbrough,Hull City,1-0,1,0,2,2,1,1,H
1972-09-23,1972,Millwall,Fulham,1-3,1,3,2,2,4,-2,A
1972-09-23,1972,Nottingham Forest,Aston Villa,1-1,1,1,2,2,2,0,D
1972-09-23,1972,Preston North End,Carlisle United,1-0,1,0,2,2,1,1,H
1972-09-23,1972,Sheffield Wednesday,Luton Town,4-0,4,0,2,2,4,4,H
1972-09-23,1972,Swindon Town,Portsmouth,1-1,1,1,2,2,2,0,D
1972-09-25,1972,Millwall,Nottingham Forest,2-1,2,1,2,2,3,1,H
1972-09-25,1972,Preston North End,Leyton Orient,0-0,0,0,2,2,0,0,D
1972-09-26,1972,Bristol City,Fulham,1-1,1,1,2,2,2,0,D
1972-09-26,1972,Burnley,Middlesbrough,0-0,0,0,2,2,0,0,D
1972-09-26,1972,Carlisle United,Blackpool,2-3,2,3,2,2,5,-1,A
1972-09-26,1972,Hull City,Queens Park Rangers,4-1,4,1,2,2,5,3,H
1972-09-26,1972,Swindon Town,Luton Town,0-2,0,2,2,2,2,-2,A
1972-09-27,1972,Aston Villa,Sunderland,2-0,2,0,2,2,2,2,H
1972-09-27,1972,Cardiff City,Brighton & Hove Albion,1-1,1,1,2,2,2,0,D
1972-09-27,1972,Portsmouth,Oxford United,1-0,1,0,2,2,1,1,H
1972-09-27,1972,Sheffield Wednesday,Huddersfield Town,3-2,3,2,2,2,5,1,H
1972-09-30,1972,Aston Villa,Millwall,1-0,1,0,2,2,1,1,H
1972-09-30,1972,Blackpool,Middlesbrough,0-1,0,1,2,2,1,-1,A
1972-09-30,1972,Bristol City,Huddersfield Town,0-0,0,0,2,2,0,0,D
1972-09-30,1972,Carlisle United,Sheffield Wednesday,1-1,1,1,2,2,2,0,D
1972-09-30,1972,Fulham,Leyton Orient,1-1,1,1,2,2,2,0,D
1972-09-30,1972,Hull City,Swindon Town,3-2,3,2,2,2,5,1,H
1972-09-30,1972,Luton Town,Burnley,2-2,2,2,2,2,4,0,D
1972-09-30,1972,Oxford United,Preston North End,0-2,0,2,2,2,2,-2,A
1972-09-30,1972,Portsmouth,Brighton & Hove Albion,2-0,2,0,2,2,2,2,H
1972-09-30,1972,Queens Park Rangers,Cardiff City,3-0,3,0,2,2,3,3,H
1972-09-30,1972,Sunderland,Nottingham Forest,4-1,4,1,2,2,5,3,H
1972-10-07,1972,Brighton & Hove Albion,Hull City,1-1,1,1,2,2,2,0,D
1972-10-07,1972,Burnley,Swindon Town,2-1,2,1,2,2,3,1,H
1972-10-07,1972,Fulham,Aston Villa,2-0,2,0,2,2,2,2,H
1972-10-07,1972,Leyton Orient,Cardiff City,0-0,0,0,2,2,0,0,D
1972-10-07,1972,Luton Town,Blackpool,2-2,2,2,2,2,4,0,D
1972-10-07,1972,Middlesbrough,Millwall,1-0,1,0,2,2,1,1,H
1972-10-07,1972,Nottingham Forest,Huddersfield Town,1-1,1,1,2,2,2,0,D
1972-10-07,1972,Oxford United,Sunderland,5-1,5,1,2,2,6,4,H
1972-10-07,1972,Portsmouth,Bristol City,0-3,0,3,2,2,3,-3,A
1972-10-07,1972,Preston North End,Sheffield Wednesday,1-1,1,1,2,2,2,0,D
1972-10-07,1972,Queens Park Rangers,Carlisle United,4-0,4,0,2,2,4,4,H
1972-10-14,1972,Aston Villa,Queens Park Rangers,0-1,0,1,2,2,1,-1,A
1972-10-14,1972,Blackpool,Oxford United,2-1,2,1,2,2,3,1,H
1972-10-14,1972,Bristol City,Nottingham Forest,1-1,1,1,2,2,2,0,D
1972-10-14,1972,Cardiff City,Middlesbrough,2-0,2,0,2,2,2,2,H
1972-10-14,1972,Carlisle United,Fulham,2-1,2,1,2,2,3,1,H
1972-10-14,1972,Huddersfield Town,Brighton & Hove Albion,0-2,0,2,2,2,2,-2,A
1972-10-14,1972,Hull City,Portsmouth,5-1,5,1,2,2,6,4,H
1972-10-14,1972,Millwall,Leyton Orient,2-0,2,0,2,2,2,2,H
1972-10-14,1972,Sheffield Wednesday,Burnley,0-1,0,1,2,2,1,-1,A
1972-10-14,1972,Sunderland,Luton Town,0-2,0,2,2,2,2,-2,A
1972-10-14,1972,Swindon Town,Preston North End,3-2,3,2,2,2,5,1,H
1972-10-17,1972,Blackpool,Aston Villa,1-1,1,1,2,2,2,0,D
1972-10-17,1972,Fulham,Queens Park Rangers,0-2,0,2,2,2,2,-2,A
1972-10-18,1972,Luton Town,Portsmouth,2-2,2,2,2,2,4,0,D
1972-10-21,1972,Brighton & Hove Albion,Sheffield Wednesday,3-3,3,3,2,2,6,0,D
1972-10-21,1972,Burnley,Cardiff City,3-0,3,0,2,2,3,3,H
1972-10-21,1972,Fulham,Blackpool,2-0,2,0,2,2,2,2,H
1972-10-21,1972,Leyton Orient,Carlisle United,2-1,2,1,2,2,3,1,H
1972-10-21,1972,Luton Town,Hull City,1-2,1,2,2,2,3,-1,A
1972-10-21,1972,Middlesbrough,Huddersfield Town,2-1,2,1,2,2,3,1,H
1972-10-21,1972,Nottingham Forest,Swindon Town,2-2,2,2,2,2,4,0,D
1972-10-21,1972,Oxford United,Bristol City,0-2,0,2,2,2,2,-2,A
1972-10-21,1972,Portsmouth,Aston Villa,0-1,0,1,2,2,1,-1,A
1972-10-21,1972,Preston North End,Millwall,1-0,1,0,2,2,1,1,H
1972-10-21,1972,Queens Park Rangers,Sunderland,3-2,3,2,2,2,5,1,H
1972-10-27,1972,Hull City,Oxford United,0-1,0,1,2,2,1,-1,A
1972-10-28,1972,Aston Villa,Middlesbrough,1-1,1,1,2,2,2,0,D
1972-10-28,1972,Blackpool,Queens Park Rangers,2-0,2,0,2,2,2,2,H
1972-10-28,1972,Bristol City,Luton Town,0-1,0,1,2,2,1,-1,A
1972-10-28,1972,Cardiff City,Preston North End,3-0,3,0,2,2,3,3,H
1972-10-28,1972,Carlisle United,Portsmouth,1-0,1,0,2,2,1,1,H
1972-10-28,1972,Huddersfield Town,Leyton Orient,1-1,1,1,2,2,2,0,D
1972-10-28,1972,Millwall,Burnley,1-1,1,1,2,2,2,0,D
1972-10-28,1972,Sheffield Wednesday,Nottingham Forest,1-2,1,2,2,2,3,-1,A
1972-10-28,1972,Sunderland,Fulham,0-0,0,0,2,2,0,0,D
1972-10-28,1972,Swindon Town,Brighton & Hove Albion,2-2,2,2,2,2,4,0,D
1972-11-03,1972,Leyton Orient,Preston North End,1-2,1,2,2,2,3,-1,A
1972-11-04,1972,Blackpool,Carlisle United,0-0,0,0,2,2,0,0,D
1972-11-04,1972,Brighton & Hove Albion,Cardiff City,2-2,2,2,2,2,4,0,D
1972-11-04,1972,Fulham,Bristol City,5-1,5,1,2,2,6,4,H
1972-11-04,1972,Huddersfield Town,Sheffield Wednesday,1-0,1,0,2,2,1,1,H
1972-11-04,1972,Luton Town,Swindon Town,0-1,0,1,2,2,1,-1,A
1972-11-04,1972,Middlesbrough,Burnley,3-3,3,3,2,2,6,0,D
1972-11-04,1972,Nottingham Forest,Millwall,3-2,3,2,2,2,5,1,H
1972-11-04,1972,Oxford United,Portsmouth,1-3,1,3,2,2,4,-2,A
1972-11-04,1972,Queens Park Rangers,Hull City,1-1,1,1,2,2,2,0,D
1972-11-04,1972,Sunderland,Aston Villa,2-2,2,2,2,2,4,0,D
1972-11-11,1972,Aston Villa,Blackpool,0-0,0,0,2,2,0,0,D
1972-11-11,1972,Bristol City,Queens Park Rangers,1-2,1,2,2,2,3,-1,A
1972-11-11,1972,Burnley,Leyton Orient,1-2,1,2,2,2,3,-1,A
1972-11-11,1972,Cardiff City,Nottingham Forest,2-1,2,1,2,2,3,1,H
1972-11-11,1972,Carlisle United,Sunderland,4-3,4,3,2,2,7,1,H
1972-11-11,1972,Hull City,Fulham,2-2,2,2,2,2,4,0,D
1972-11-11,1972,Millwall,Brighton & Hove Albion,3-0,3,0,2,2,3,3,H
1972-11-11,1972,Portsmouth,Luton Town,2-2,2,2,2,2,4,0,D
1972-11-11,1972,Preston North End,Middlesbrough,0-1,0,1,2,2,1,-1,A
1972-11-11,1972,Sheffield Wednesday,Oxford United,0-1,0,1,2,2,1,-1,A
1972-11-11,1972,Swindon Town,Huddersfield Town,1-1,1,1,2,2,2,0,D
1972-11-14,1972,Huddersfield Town,Bristol City,0-1,0,1,2,2,1,-1,A
1972-11-18,1972,Aston Villa,Luton Town,0-2,0,2,2,2,2,-2,A
1972-11-18,1972,Blackpool,Bristol City,3-0,3,0,2,2,3,3,H
1972-11-18,1972,Brighton & Hove Albion,Burnley,0-1,0,1,2,2,1,-1,A
1972-11-18,1972,Carlisle United,Oxford United,2-1,2,1,2,2,3,1,H
1972-11-18,1972,Fulham,Portsmouth,0-0,0,0,2,2,0,0,D
1972-11-18,1972,Huddersfield Town,Cardiff City,2-1,2,1,2,2,3,1,H
1972-11-18,1972,Nottingham Forest,Preston North End,0-1,0,1,2,2,1,-1,A
1972-11-18,1972,Queens Park Rangers,Millwall,1-3,1,3,2,2,4,-2,A
1972-11-18,1972,Sheffield Wednesday,Middlesbrough,2-1,2,1,2,2,3,1,H
1972-11-18,1972,Sunderland,Hull City,1-1,1,1,2,2,2,0,D
1972-11-18,1972,Swindon Town,Leyton Orient,3-1,3,1,2,2,4,2,H
1972-11-25,1972,Bristol City,Sunderland,1-0,1,0,2,2,1,1,H
1972-11-25,1972,Burnley,Nottingham Forest,1-0,1,0,2,2,1,1,H
1972-11-25,1972,Cardiff City,Fulham,3-1,3,1,2,2,4,2,H
1972-11-25,1972,Hull City,Blackpool,1-2,1,2,2,2,3,-1,A
1972-11-25,1972,Leyton Orient,Sheffield Wednesday,3-2,3,2,2,2,5,1,H
1972-11-25,1972,Luton Town,Carlisle United,0-1,0,1,2,2,1,-1,A
1972-11-25,1972,Middlesbrough,Swindon Town,0-2,0,2,2,2,2,-2,A
1972-11-25,1972,Millwall,Huddersfield Town,1-0,1,0,2,2,1,1,H
1972-11-25,1972,Oxford United,Aston Villa,2-0,2,0,2,2,2,2,H
1972-11-25,1972,Portsmouth,Queens Park Rangers,0-1,0,1,2,2,1,-1,A
1972-11-25,1972,Preston North End,Brighton & Hove Albion,4-0,4,0,2,2,4,4,H
1972-12-02,1972,Aston Villa,Hull City,2-0,2,0,2,2,2,2,H
1972-12-02,1972,Blackpool,Portsmouth,3-1,3,1,2,2,4,2,H
1972-12-02,1972,Brighton & Hove Albion,Middlesbrough,0-2,0,2,2,2,2,-2,A
1972-12-02,1972,Carlisle United,Bristol City,1-2,1,2,2,2,3,-1,A
1972-12-02,1972,Huddersfield Town,Preston North End,0-0,0,0,2,2,0,0,D
1972-12-02,1972,Nottingham Forest,Leyton Orient,2-1,2,1,2,2,3,1,H
1972-12-02,1972,Queens Park Rangers,Oxford United,0-0,0,0,2,2,0,0,D
1972-12-02,1972,Sheffield Wednesday,Millwall,2-2,2,2,2,2,4,0,D
1972-12-02,1972,Sunderland,Burnley,0-1,0,1,2,2,1,-1,A
1972-12-09,1972,Cardiff City,Sheffield Wednesday,4-1,4,1,2,2,5,3,H
1972-12-09,1972,Hull City,Carlisle United,1-1,1,1,2,2,2,0,D
1972-12-09,1972,Leyton Orient,Brighton & Hove Albion,1-0,1,0,2,2,1,1,H
1972-12-09,1972,Luton Town,Queens Park Rangers,2-2,2,2,2,2,4,0,D
1972-12-09,1972,Middlesbrough,Nottingham Forest,0-0,0,0,2,2,0,0,D
1972-12-09,1972,Millwall,Swindon Town,1-1,1,1,2,2,2,0,D
1972-12-09,1972,Oxford United,Fulham,0-0,0,0,2,2,0,0,D
1972-12-09,1972,Portsmouth,Sunderland,2-3,2,3,2,2,5,-1,A
1972-12-09,1972,Preston North End,Blackpool,0-3,0,3,2,2,3,-3,A
1972-12-16,1972,Aston Villa,Leyton Orient,1-0,1,0,2,2,1,1,H
1972-12-16,1972,Blackpool,Sheffield Wednesday,1-2,1,2,2,2,3,-1,A
1972-12-16,1972,Bristol City,Burnley,0-1,0,1,2,2,1,-1,A
1972-12-16,1972,Carlisle United,Brighton & Hove Albion,5-1,5,1,2,2,6,4,H
1972-12-16,1972,Fulham,Nottingham Forest,3-1,3,1,2,2,4,2,H
1972-12-16,1972,Hull City,Cardiff City,1-1,1,1,2,2,2,0,D
1972-12-16,1972,Luton Town,Millwall,2-2,2,2,2,2,4,0,D
1972-12-16,1972,Oxford United,Swindon Town,1-0,1,0,2,2,1,1,H
1972-12-16,1972,Portsmouth,Middlesbrough,0-0,0,0,2,2,0,0,D
1972-12-16,1972,Sunderland,Preston North End,0-0,0,0,2,2,0,0,D
1972-12-23,1972,Brighton & Hove Albion,Queens Park Rangers,1-2,1,2,2,2,3,-1,A
1972-12-23,1972,Burnley,Oxford United,1-1,1,1,2,2,2,0,D
1972-12-23,1972,Huddersfield Town,Hull City,1-3,1,3,2,2,4,-2,A
1972-12-23,1972,Leyton Orient,Portsmouth,0-1,0,1,2,2,1,-1,A
1972-12-23,1972,Middlesbrough,Luton Town,0-1,0,1,2,2,1,-1,A
1972-12-23,1972,Millwall,Carlisle United,1-0,1,0,2,2,1,1,H
1972-12-23,1972,Nottingham Forest,Blackpool,4-0,4,0,2,2,4,4,H
1972-12-23,1972,Preston North End,Bristol City,3-3,3,3,2,2,6,0,D
1972-12-23,1972,Sheffield Wednesday,Aston Villa,2-2,2,2,2,2,4,0,D
1972-12-23,1972,Swindon Town,Fulham,2-2,2,2,2,2,4,0,D
1972-12-26,1972,Aston Villa,Nottingham Forest,2-2,2,2,2,2,4,0,D
1972-12-26,1972,Blackpool,Burnley,1-2,1,2,2,2,3,-1,A
1972-12-26,1972,Bristol City,Cardiff City,1-0,1,0,2,2,1,1,H
1972-12-26,1972,Carlisle United,Preston North End,6-1,6,1,2,2,7,5,H
1972-12-26,1972,Fulham,Millwall,1-0,1,0,2,2,1,1,H
1972-12-26,1972,Hull City,Middlesbrough,3-1,3,1,2,2,4,2,H
1972-12-26,1972,Luton Town,Sheffield Wednesday,0-0,0,0,2,2,0,0,D
1972-12-26,1972,Oxford United,Brighton & Hove Albion,3-0,3,0,2,2,3,3,H
1972-12-26,1972,Portsmouth,Swindon Town,1-1,1,1,2,2,2,0,D
1972-12-26,1972,Queens Park Rangers,Leyton Orient,3-1,3,1,2,2,4,2,H
1972-12-29,1972,Cardiff City,Portsmouth,0-2,0,2,2,2,2,-2,A
1972-12-30,1972,Brighton & Hove Albion,Blackpool,1-2,1,2,2,2,3,-1,A
1972-12-30,1972,Burnley,Fulham,2-2,2,2,2,2,4,0,D
1972-12-30,1972,Huddersfield Town,Aston Villa,1-1,1,1,2,2,2,0,D
1972-12-30,1972,Middlesbrough,Oxford United,1-0,1,0,2,2,1,1,H
1972-12-30,1972,Millwall,Bristol City,3-0,3,0,2,2,3,3,H
1972-12-30,1972,Preston North End,Luton Town,2-0,2,0,2,2,2,2,H
1972-12-30,1972,Sheffield Wednesday,Queens Park Rangers,3-1,3,1,2,2,4,2,H
1973-01-06,1972,Aston Villa,Burnley,0-3,0,3,2,2,3,-3,A
1973-01-06,1972,Bristol City,Swindon Town,3-0,3,0,2,2,3,3,H
1973-01-06,1972,Carlisle United,Huddersfield Town,0-0,0,0,2,2,0,0,D
1973-01-06,1972,Fulham,Middlesbrough,2-1,2,1,2,2,3,1,H
1973-01-06,1972,Hull City,Sheffield Wednesday,1-1,1,1,2,2,2,0,D
1973-01-06,1972,Luton Town,Leyton Orient,1-1,1,1,2,2,2,0,D
1973-01-06,1972,Oxford United,Nottingham Forest,1-0,1,0,2,2,1,1,H
1973-01-06,1972,Portsmouth,Millwall,1-1,1,1,2,2,2,0,D
1973-01-06,1972,Queens Park Rangers,Preston North End,3-0,3,0,2,2,3,3,H
1973-01-06,1972,Sunderland,Brighton & Hove Albion,4-0,4,0,2,2,4,4,H
1973-01-19,1972,Cardiff City,Oxford United,2-0,2,0,2,2,2,2,H
1973-01-20,1972,Brighton & Hove Albion,Aston Villa,1-3,1,3,2,2,4,-2,A
1973-01-20,1972,Huddersfield Town,Luton Town,1-2,1,2,2,2,3,-1,A
1973-01-20,1972,Leyton Orient,Hull City,0-0,0,0,2,2,0,0,D
1973-01-20,1972,Middlesbrough,Queens Park Rangers,0-0,0,0,2,2,0,0,D
1973-01-20,1972,Millwall,Blackpool,1-1,1,1,2,2,2,0,D
1973-01-20,1972,Nottingham Forest,Carlisle United,2-1,2,1,2,2,3,1,H
1973-01-20,1972,Preston North End,Fulham,0-3,0,3,2,2,3,-3,A
1973-01-20,1972,Swindon Town,Sunderland,1-1,1,1,2,2,2,0,D
1973-01-27,1972,Aston Villa,Cardiff City,2-0,2,0,2,2,2,2,H
1973-01-27,1972,Blackpool,Swindon Town,2-0,2,0,2,2,2,2,H
1973-01-27,1972,Bristol City,Leyton Orient,2-2,2,2,2,2,4,0,D
1973-01-27,1972,Carlisle United,Middlesbrough,1-1,1,1,2,2,2,0,D
1973-01-27,1972,Fulham,Brighton & Hove Albion,5-1,5,1,2,2,6,4,H
1973-01-27,1972,Hull City,Preston North End,6-2,6,2,2,2,8,4,H
1973-01-27,1972,Luton Town,Nottingham Forest,1-0,1,0,2,2,1,1,H
1973-01-27,1972,Oxford United,Huddersfield Town,2-0,2,0,2,2,2,2,H
1973-01-27,1972,Portsmouth,Sheffield Wednesday,1-0,1,0,2,2,1,1,H
1973-01-27,1972,Queens Park Rangers,Burnley,2-0,2,0,2,2,2,2,H
1973-01-27,1972,Sunderland,Millwall,2-0,2,0,2,2,2,2,H
1973-02-02,1972,Middlesbrough,Blackpool,2-0,2,0,2,2,2,2,H
1973-02-03,1972,Burnley,Huddersfield Town,2-1,2,1,2,2,3,1,H
1973-02-06,1972,Queens Park Rangers,Huddersfield Town,3-1,3,1,2,2,4,2,H
1973-02-10,1972,Brighton & Hove Albion,Luton Town,2-0,2,0,2,2,2,2,H
1973-02-10,1972,Burnley,Hull City,4-1,4,1,2,2,5,3,H
1973-02-10,1972,Cardiff City,Carlisle United,1-0,1,0,2,2,1,1,H
1973-02-10,1972,Huddersfield Town,Fulham,1-0,1,0,2,2,1,1,H
1973-02-10,1972,Leyton Orient,Blackpool,2-0,2,0,2,2,2,2,H
1973-02-10,1972,Middlesbrough,Bristol City,2-1,2,1,2,2,3,1,H
1973-02-10,1972,Millwall,Oxford United,3-1,3,1,2,2,4,2,H
1973-02-10,1972,Nottingham Forest,Queens Park Rangers,0-0,0,0,2,2,0,0,D
1973-02-10,1972,Preston North End,Portsmouth,0-5,0,5,2,2,5,-5,A
1973-02-10,1972,Sheffield Wednesday,Sunderland,1-0,1,0,2,2,1,1,H
1973-02-10,1972,Swindon Town,Aston Villa,1-3,1,3,2,2,4,-2,A
1973-02-17,1972,Aston Villa,Preston North End,1-1,1,1,2,2,2,0,D
1973-02-17,1972,Blackpool,Huddersfield Town,1-1,1,1,2,2,2,0,D
1973-02-17,1972,Bristol City,Brighton & Hove Albion,3-1,3,1,2,2,4,2,H
1973-02-17,1972,Carlisle United,Burnley,1-1,1,1,2,2,2,0,D
1973-02-17,1972,Fulham,Sheffield Wednesday,1-0,1,0,2,2,1,1,H
1973-02-17,1972,Hull City,Millwall,0-2,0,2,2,2,2,-2,A
1973-02-17,1972,Luton Town,Cardiff City,1-1,1,1,2,2,2,0,D
1973-02-17,1972,Oxford United,Leyton Orient,2-1,2,1,2,2,3,1,H
1973-02-17,1972,Portsmouth,Nottingham Forest,2-0,2,0,2,2,2,2,H
1973-02-17,1972,Queens Park Rangers,Swindon Town,5-0,5,0,2,2,5,5,H
1973-02-17,1972,Sunderland,Middlesbrough,4-0,4,0,2,2,4,4,H
1973-02-24,1972,Burnley,Bristol City,1-1,1,1,2,2,2,0,D
1973-02-24,1972,Leyton Orient,Aston Villa,4-0,4,0,2,2,4,4,H
1973-02-24,1972,Middlesbrough,Portsmouth,3-0,3,0,2,2,3,3,H
1973-02-24,1972,Nottingham Forest,Fulham,2-1,2,1,2,2,3,1,H
1973-02-24,1972,Swindon Town,Oxford United,1-3,1,3,2,2,4,-2,A
1973-02-26,1972,Millwall,Luton Town,3-2,3,2,2,2,5,1,H
1973-02-27,1972,Swindon Town,Cardiff City,3-0,3,0,2,2,3,3,H
1973-02-28,1972,Sheffield Wednesday,Blackpool,2-0,2,0,2,2,2,2,H
1973-03-02,1972,Hull City,Brighton & Hove Albion,2-0,2,0,2,2,2,2,H
1973-03-02,1972,Millwall,Middlesbrough,1-0,1,0,2,2,1,1,H
1973-03-02,1972,Swindon Town,Burnley,0-1,0,1,2,2,1,-1,A
1973-03-03,1972,Aston Villa,Fulham,2-3,2,3,2,2,5,-1,A
1973-03-03,1972,Blackpool,Luton Town,1-1,1,1,2,2,2,0,D
1973-03-03,1972,Bristol City,Portsmouth,3-1,3,1,2,2,4,2,H
1973-03-03,1972,Cardiff City,Leyton Orient,3-1,3,1,2,2,4,2,H
1973-03-03,1972,Carlisle United,Queens Park Rangers,1-3,1,3,2,2,4,-2,A
1973-03-03,1972,Huddersfield Town,Nottingham Forest,1-1,1,1,2,2,2,0,D
1973-03-03,1972,Sheffield Wednesday,Preston North End,2-1,2,1,2,2,3,1,H
1973-03-03,1972,Sunderland,Oxford United,1-0,1,0,2,2,1,1,H
1973-03-06,1972,Huddersfield Town,Queens Park Rangers,2-2,2,2,2,2,4,0,D
1973-03-07,1972,Blackpool,Cardiff City,1-0,1,0,2,2,1,1,H
1973-03-10,1972,Brighton & Hove Albion,Huddersfield Town,2-1,2,1,2,2,3,1,H
1973-03-10,1972,Burnley,Sheffield Wednesday,0-1,0,1,2,2,1,-1,A
1973-03-10,1972,Fulham,Carlisle United,1-0,1,0,2,2,1,1,H
1973-03-10,1972,Leyton Orient,Millwall,3-1,3,1,2,2,4,2,H
1973-03-10,1972,Luton Town,Sunderland,1-0,1,0,2,2,1,1,H
1973-03-10,1972,Middlesbrough,Cardiff City,2-0,2,0,2,2,2,2,H
1973-03-10,1972,Nottingham Forest,Bristol City,1-0,1,0,2,2,1,1,H
1973-03-10,1972,Oxford United,Blackpool,0-1,0,1,2,2,1,-1,A
1973-03-10,1972,Portsmouth,Hull City,2-2,2,2,2,2,4,0,D
1973-03-10,1972,Preston North End,Swindon Town,1-1,1,1,2,2,2,0,D
1973-03-10,1972,Queens Park Rangers,Aston Villa,1-0,1,0,2,2,1,1,H
1973-03-12,1972,Swindon Town,Carlisle United,2-0,2,0,2,2,2,2,H
1973-03-13,1972,Nottingham Forest,Hull City,1-2,1,2,2,2,3,-1,A
1973-03-14,1972,Sheffield Wednesday,Bristol City,3-2,3,2,2,2,5,1,H
1973-03-17,1972,Aston Villa,Portsmouth,2-0,2,0,2,2,2,2,H
1973-03-17,1972,Blackpool,Fulham,2-0,2,0,2,2,2,2,H
1973-03-17,1972,Bristol City,Oxford United,0-0,0,0,2,2,0,0,D
1973-03-17,1972,Cardiff City,Burnley,0-1,0,1,2,2,1,-1,A
1973-03-17,1972,Carlisle United,Leyton Orient,1-0,1,0,2,2,1,1,H
1973-03-17,1972,Huddersfield Town,Middlesbrough,1-1,1,1,2,2,2,0,D
1973-03-17,1972,Millwall,Preston North End,4-1,4,1,2,2,5,3,H
1973-03-17,1972,Sheffield Wednesday,Brighton & Hove Albion,1-1,1,1,2,2,2,0,D
1973-03-17,1972,Swindon Town,Nottingham Forest,0-0,0,0,2,2,0,0,D
1973-03-19,1972,Preston North End,Sunderland,1-3,1,3,2,2,4,-2,A
1973-03-20,1972,Burnley,Portsmouth,4-0,4,0,2,2,4,4,H
1973-03-21,1972,Brighton & Hove Albion,Carlisle United,1-0,1,0,2,2,1,1,H
1973-03-23,1972,Oxford United,Hull City,5-2,5,2,2,2,7,3,H
1973-03-24,1972,Brighton & Hove Albion,Swindon Town,3-1,3,1,2,2,4,2,H
1973-03-24,1972,Burnley,Millwall,2-1,2,1,2,2,3,1,H
1973-03-24,1972,Fulham,Sunderland,1-2,1,2,2,2,3,-1,A
1973-03-24,1972,Leyton Orient,Huddersfield Town,3-1,3,1,2,2,4,2,H
1973-03-24,1972,Luton Town,Bristol City,1-3,1,3,2,2,4,-2,A
1973-03-24,1972,Middlesbrough,Aston Villa,1-1,1,1,2,2,2,0,D
1973-03-24,1972,Nottingham Forest,Sheffield Wednesday,3-0,3,0,2,2,3,3,H
1973-03-24,1972,Portsmouth,Carlisle United,0-0,0,0,2,2,0,0,D
1973-03-24,1972,Preston North End,Cardiff City,0-0,0,0,2,2,0,0,D
1973-03-24,1972,Queens Park Rangers,Blackpool,4-0,4,0,2,2,4,4,H
1973-03-27,1972,Bristol City,Aston Villa,3-0,3,0,2,2,3,3,H
1973-03-27,1972,Fulham,Luton Town,0-1,0,1,2,2,1,-1,A
1973-03-27,1972,Sunderland,Carlisle United,2-1,2,1,2,2,3,1,H
1973-03-31,1972,Aston Villa,Oxford United,2-1,2,1,2,2,3,1,H
1973-03-31,1972,Blackpool,Hull City,4-3,4,3,2,2,7,1,H
1973-03-31,1972,Brighton & Hove Albion,Preston North End,2-0,2,0,2,2,2,2,H
1973-03-31,1972,Carlisle United,Luton Town,2-0,2,0,2,2,2,2,H
1973-03-31,1972,Fulham,Cardiff City,1-1,1,1,2,2,2,0,D
1973-03-31,1972,Huddersfield Town,Millwall,1-0,1,0,2,2,1,1,H
1973-03-31,1972,Nottingham Forest,Burnley,3-0,3,0,2,2,3,3,H
1973-03-31,1972,Queens Park Rangers,Portsmouth,5-0,5,0,2,2,5,5,H
1973-03-31,1972,Sheffield Wednesday,Leyton Orient,2-0,2,0,2,2,2,2,H
1973-03-31,1972,Sunderland,Bristol City,2-2,2,2,2,2,4,0,D
1973-03-31,1972,Swindon Town,Middlesbrough,1-0,1,0,2,2,1,1,H
1973-04-07,1972,Bristol City,Carlisle United,4-1,4,1,2,2,5,3,H
1973-04-07,1972,Cardiff City,Swindon Town,1-1,1,1,2,2,2,0,D
1973-04-07,1972,Hull City,Aston Villa,1-2,1,2,2,2,3,-1,A
1973-04-07,1972,Leyton Orient,Nottingham Forest,3-0,3,0,2,2,3,3,H
1973-04-07,1972,Luton Town,Fulham,1-0,1,0,2,2,1,1,H
1973-04-07,1972,Middlesbrough,Brighton & Hove Albion,1-1,1,1,2,2,2,0,D
1973-04-07,1972,Millwall,Sheffield Wednesday,2-1,2,1,2,2,3,1,H
1973-04-07,1972,Oxford United,Queens Park Rangers,2-0,2,0,2,2,2,2,H
1973-04-07,1972,Portsmouth,Blackpool,1-0,1,0,2,2,1,1,H
1973-04-07,1972,Preston North End,Huddersfield Town,0-0,0,0,2,2,0,0,D
1973-04-10,1972,Hull City,Luton Town,4-0,4,0,2,2,4,4,H
1973-04-10,1972,Sunderland,Huddersfield Town,3-0,3,0,2,2,3,3,H
1973-04-14,1972,Aston Villa,Bristol City,1-0,1,0,2,2,1,1,H
1973-04-14,1972,Blackpool,Preston North End,2-0,2,0,2,2,2,2,H
1973-04-14,1972,Brighton & Hove Albion,Leyton Orient,2-1,2,1,2,2,3,1,H
1973-04-14,1972,Carlisle United,Hull City,0-1,0,1,2,2,1,-1,A
1973-04-14,1972,Fulham,Oxford United,2-0,2,0,2,2,2,2,H
1973-04-14,1972,Huddersfield Town,Burnley,0-2,0,2,2,2,2,-2,A
1973-04-14,1972,Nottingham Forest,Middlesbrough,1-3,1,3,2,2,4,-2,A
1973-04-14,1972,Queens Park Rangers,Luton Town,2-0,2,0,2,2,2,2,H
1973-04-14,1972,Sheffield Wednesday,Cardiff City,1-0,1,0,2,2,1,1,H
1973-04-14,1972,Sunderland,Portsmouth,2-0,2,0,2,2,2,2,H
1973-04-14,1972,Swindon Town,Millwall,0-0,0,0,2,2,0,0,D
1973-04-16,1972,Burnley,Sunderland,2-0,2,0,2,2,2,2,H
1973-04-18,1972,Cardiff City,Queens Park Rangers,0-0,0,0,2,2,0,0,D
1973-04-20,1972,Fulham,Swindon Town,0-0,0,0,2,2,0,0,D
1973-04-20,1972,Oxford United,Burnley,0-2,0,2,2,2,2,-2,A
1973-04-20,1972,Portsmouth,Leyton Orient,1-0,1,0,2,2,1,1,H
1973-04-21,1972,Bristol City,Blackpool,3-0,3,0,2,2,3,3,H
1973-04-21,1972,Burnley,Brighton & Hove Albion,3-0,3,0,2,2,3,3,H
1973-04-21,1972,Cardiff City,Huddersfield Town,4-1,4,1,2,2,5,3,H
1973-04-21,1972,Hull City,Sunderland,0-2,0,2,2,2,2,-2,A
1973-04-21,1972,Leyton Orient,Swindon Town,1-0,1,0,2,2,1,1,H
1973-04-21,1972,Luton Town,Aston Villa,0-0,0,0,2,2,0,0,D
1973-04-21,1972,Middlesbrough,Sheffield Wednesday,3-0,3,0,2,2,3,3,H
1973-04-21,1972,Millwall,Queens Park Rangers,0-1,0,1,2,2,1,-1,A
1973-04-21,1972,Oxford United,Carlisle United,1-1,1,1,2,2,2,0,D
1973-04-21,1972,Portsmouth,Fulham,1-2,1,2,2,2,3,-1,A
1973-04-21,1972,Preston North End,Nottingham Forest,2-1,2,1,2,2,3,1,H
1973-04-23,1972,Blackpool,Nottingham Forest,2-0,2,0,2,2,2,2,H
1973-04-23,1972,Brighton & Hove Albion,Portsmouth,1-1,1,1,2,2,2,0,D
1973-04-23,1972,Bristol City,Preston North End,2-1,2,1,2,2,3,1,H
1973-04-23,1972,Hull City,Huddersfield Town,0-0,0,0,2,2,0,0,D
1973-04-23,1972,Leyton Orient,Fulham,3-2,3,2,2,2,5,1,H
1973-04-23,1972,Luton Town,Middlesbrough,0-1,0,1,2,2,1,-1,A
1973-04-23,1972,Millwall,Aston Villa,1-1,1,1,2,2,2,0,D
1973-04-23,1972,Sheffield Wednesday,Carlisle United,0-0,0,0,2,2,0,0,D
1973-04-23,1972,Sunderland,Cardiff City,2-1,2,1,2,2,3,1,H
1973-04-24,1972,Aston Villa,Sheffield Wednesday,2-1,2,1,2,2,3,1,H
1973-04-24,1972,Burnley,Luton Town,3-0,3,0,2,2,3,3,H
1973-04-24,1972,Carlisle United,Millwall,0-1,0,1,2,2,1,-1,A
1973-04-24,1972,Nottingham Forest,Sunderland,1-0,1,0,2,2,1,1,H
1973-04-24,1972,Preston North End,Oxford United,0-1,0,1,2,2,1,-1,A
1973-04-24,1972,Queens Park Rangers,Brighton & Hove Albion,2-0,2,0,2,2,2,2,H
1973-04-24,1972,Swindon Town,Hull City,2-1,2,1,2,2,3,1,H
1973-04-28,1972,Brighton & Hove Albion,Nottingham Forest,2-2,2,2,2,2,4,0,D
1973-04-28,1972,Bristol City,Hull City,2-1,2,1,2,2,3,1,H
1973-04-28,1972,Carlisle United,Aston Villa,2-2,2,2,2,2,4,0,D
1973-04-28,1972,Huddersfield Town,Portsmouth,2-0,2,0,2,2,2,2,H
1973-04-28,1972,Middlesbrough,Leyton Orient,3-2,3,2,2,2,5,1,H
1973-04-28,1972,Millwall,Cardiff City,1-1,1,1,2,2,2,0,D
1973-04-28,1972,Oxford United,Luton Town,2-1,2,1,2,2,3,1,H
1973-04-28,1972,Preston North End,Burnley,1-1,1,1,2,2,2,0,D
1973-04-28,1972,Queens Park Rangers,Fulham,2-0,2,0,2,2,2,2,H
1973-04-28,1972,Sunderland,Blackpool,1-0,1,0,2,2,1,1,H
1973-04-30,1972,Leyton Orient,Sunderland,1-1,1,1,2,2,2,0,D
1973-05-07,1972,Cardiff City,Sunderland,1-1,1,1,2,2,2,0,D
1973-05-09,1972,Cardiff City,Hull City,0-2,0,2,2,2,2,-2,A
1973-05-09,1972,Sunderland,Queens Park Rangers,0-3,0,3,2,2,3,-3,A
1973-08-25,1973,Aston Villa,Preston North End,2-0,2,0,2,2,2,2,H
1973-08-25,1973,Blackpool,West Bromwich Albion,2-3,2,3,2,2,5,-1,A
1973-08-25,1973,Bristol City,Bolton Wanderers,1-0,1,0,2,2,1,1,H
1973-08-25,1973,Carlisle United,Cardiff City,1-1,1,1,2,2,2,0,D
1973-08-25,1973,Crystal Palace,Notts County,1-4,1,4,2,2,5,-3,A
1973-08-25,1973,Fulham,Millwall,2-0,2,0,2,2,2,2,H
1973-08-25,1973,Hull City,Oxford United,0-0,0,0,2,2,0,0,D
1973-08-25,1973,Nottingham Forest,Luton Town,4-0,4,0,2,2,4,4,H
1973-08-25,1973,Portsmouth,Middlesbrough,0-1,0,1,2,2,1,-1,A
1973-08-25,1973,Sunderland,Leyton Orient,1-1,1,1,2,2,2,0,D
1973-08-25,1973,Swindon Town,Sheffield Wednesday,3-1,3,1,2,2,4,2,H
1973-09-01,1973,Bolton Wanderers,Hull City,1-0,1,0,2,2,1,1,H
1973-09-01,1973,Cardiff City,Portsmouth,1-1,1,1,2,2,2,0,D
1973-09-01,1973,Leyton Orient,Bristol City,0-1,0,1,2,2,1,-1,A
1973-09-01,1973,Luton Town,Carlisle United,6-1,6,1,2,2,7,5,H
1973-09-01,1973,Middlesbrough,Fulham,0-2,0,2,2,2,2,-2,A
1973-09-01,1973,Millwall,Aston Villa,1-1,1,1,2,2,2,0,D
1973-09-01,1973,Notts County,Sunderland,1-4,1,4,2,2,5,-3,A
1973-09-01,1973,Oxford United,Nottingham Forest,1-0,1,0,2,2,1,1,H
1973-09-01,1973,Preston North End,Swindon Town,1-1,1,1,2,2,2,0,D
1973-09-01,1973,Sheffield Wednesday,Blackpool,0-0,0,0,2,2,0,0,D
1973-09-01,1973,West Bromwich Albion,Crystal Palace,1-0,1,0,2,2,1,1,H
1973-09-08,1973,Aston Villa,Oxford United,2-0,2,0,2,2,2,2,H
1973-09-08,1973,Blackpool,Millwall,1-0,1,0,2,2,1,1,H
1973-09-08,1973,Bristol City,Luton Town,1-3,1,3,2,2,4,-2,A
1973-09-08,1973,Carlisle United,Notts County,3-0,3,0,2,2,3,3,H
1973-09-08,1973,Crystal Palace,Middlesbrough,2-3,2,3,2,2,5,-1,A
1973-09-08,1973,Fulham,Leyton Orient,0-3,0,3,2,2,3,-3,A
1973-09-08,1973,Hull City,Preston North End,1-0,1,0,2,2,1,1,H
1973-09-08,1973,Nottingham Forest,Sheffield Wednesday,2-1,2,1,2,2,3,1,H
1973-09-08,1973,Portsmouth,Bolton Wanderers,0-2,0,2,2,2,2,-2,A
1973-09-08,1973,Sunderland,Cardiff City,1-1,1,1,2,2,2,0,D
1973-09-08,1973,Swindon Town,West Bromwich Albion,1-0,1,0,2,2,1,1,H
1973-09-11,1973,Bolton Wanderers,Leyton Orient,1-1,1,1,2,2,2,0,D
1973-09-11,1973,Crystal Palace,Aston Villa,0-0,0,0,2,2,0,0,D
1973-09-11,1973,Hull City,Nottingham Forest,0-0,0,0,2,2,0,0,D
1973-09-11,1973,Middlesbrough,Carlisle United,1-0,1,0,2,2,1,1,H
1973-09-11,1973,Notts County,Luton Town,1-1,1,1,2,2,2,0,D
1973-09-11,1973,Portsmouth,Sunderland,1-1,1,1,2,2,2,0,D
1973-09-11,1973,Preston North End,Millwall,2-0,2,0,2,2,2,2,H
1973-09-11,1973,Swindon Town,Bristol City,0-1,0,1,2,2,1,-1,A
1973-09-12,1973,Cardiff City,Oxford United,5-0,5,0,2,2,5,5,H
1973-09-12,1973,Fulham,Blackpool,0-0,0,0,2,2,0,0,D
1973-09-12,1973,Sheffield Wednesday,West Bromwich Albion,3-1,3,1,2,2,4,2,H
1973-09-15,1973,Bolton Wanderers,Crystal Palace,2-0,2,0,2,2,2,2,H
1973-09-15,1973,Cardiff City,Fulham,0-0,0,0,2,2,0,0,D
1973-09-15,1973,Leyton Orient,Blackpool,3-2,3,2,2,2,5,1,H
1973-09-15,1973,Luton Town,Portsmouth,3-3,3,3,2,2,6,0,D
1973-09-15,1973,Middlesbrough,Aston Villa,0-0,0,0,2,2,0,0,D
1973-09-15,1973,Millwall,Hull City,3-0,3,0,2,2,3,3,H
1973-09-15,1973,Notts County,Swindon Town,2-0,2,0,2,2,2,2,H
1973-09-15,1973,Oxford United,Sunderland,0-1,0,1,2,2,1,-1,A
1973-09-15,1973,Preston North End,Bristol City,1-1,1,1,2,2,2,0,D
1973-09-15,1973,Sheffield Wednesday,Carlisle United,1-0,1,0,2,2,1,1,H
1973-09-15,1973,West Bromwich Albion,Nottingham Forest,3-3,3,3,2,2,6,0,D
1973-09-17,1973,Blackpool,Crystal Palace,1-0,1,0,2,2,1,1,H
1973-09-17,1973,Leyton Orient,Middlesbrough,0-0,0,0,2,2,0,0,D
1973-09-17,1973,Millwall,Sheffield Wednesday,1-0,1,0,2,2,1,1,H
1973-09-18,1973,Bristol City,Hull City,3-1,3,1,2,2,4,2,H
1973-09-18,1973,Carlisle United,Portsmouth,0-2,0,2,2,2,2,-2,A
1973-09-18,1973,Nottingham Forest,Swindon Town,2-0,2,0,2,2,2,2,H
1973-09-18,1973,West Bromwich Albion,Preston North End,0-2,0,2,2,2,2,-2,A
1973-09-19,1973,Aston Villa,Fulham,1-1,1,1,2,2,2,0,D
1973-09-19,1973,Oxford United,Notts County,2-1,2,1,2,2,3,1,H
1973-09-22,1973,Aston Villa,Leyton Orient,2-2,2,2,2,2,4,0,D
1973-09-22,1973,Blackpool,Middlesbrough,0-0,0,0,2,2,0,0,D
1973-09-22,1973,Bristol City,Sheffield Wednesday,2-0,2,0,2,2,2,2,H
1973-09-22,1973,Carlisle United,Oxford United,2-1,2,1,2,2,3,1,H
1973-09-22,1973,Crystal Palace,Cardiff City,3-3,3,3,2,2,6,0,D
1973-09-22,1973,Fulham,Bolton Wanderers,1-0,1,0,2,2,1,1,H
1973-09-22,1973,Hull City,West Bromwich Albion,0-0,0,0,2,2,0,0,D
1973-09-22,1973,Nottingham Forest,Preston North End,1-1,1,1,2,2,2,0,D
1973-09-22,1973,Portsmouth,Notts County,1-2,1,2,2,2,3,-1,A
1973-09-22,1973,Sunderland,Luton Town,0-1,0,1,2,2,1,-1,A
1973-09-22,1973,Swindon Town,Millwall,1-3,1,3,2,2,4,-2,A
1973-09-26,1973,Oxford United,Fulham,0-0,0,0,2,2,0,0,D
1973-09-29,1973,Bolton Wanderers,Nottingham Forest,1-0,1,0,2,2,1,1,H
1973-09-29,1973,Cardiff City,Hull City,1-3,1,3,2,2,4,-2,A
1973-09-29,1973,Leyton Orient,Swindon Town,0-0,0,0,2,2,0,0,D
1973-09-29,1973,Luton Town,Blackpool,3-0,3,0,2,2,3,3,H
1973-09-29,1973,Middlesbrough,Bristol City,2-0,2,0,2,2,2,2,H
1973-09-29,1973,Millwall,Carlisle United,1-2,1,2,2,2,3,-1,A
1973-09-29,1973,Notts County,Aston Villa,2-0,2,0,2,2,2,2,H
1973-09-29,1973,Preston North End,Portsmouth,2-1,2,1,2,2,3,1,H
1973-09-29,1973,Sheffield Wednesday,Crystal Palace,4-0,4,0,2,2,4,4,H
1973-09-29,1973,West Bromwich Albion,Sunderland,1-1,1,1,2,2,2,0,D
1973-10-01,1973,Preston North End,West Bromwich Albion,3-1,3,1,2,2,4,2,H
1973-10-02,1973,Crystal Palace,Blackpool,1-2,1,2,2,2,3,-1,A
1973-10-02,1973,Fulham,Aston Villa,1-0,1,0,2,2,1,1,H
1973-10-02,1973,Hull City,Bristol City,2-1,2,1,2,2,3,1,H
1973-10-02,1973,Middlesbrough,Leyton Orient,3-2,3,2,2,2,5,1,H
1973-10-02,1973,Notts County,Oxford United,0-0,0,0,2,2,0,0,D
1973-10-02,1973,Portsmouth,Carlisle United,2-1,2,1,2,2,3,1,H
1973-10-02,1973,Swindon Town,Nottingham Forest,0-0,0,0,2,2,0,0,D
1973-10-03,1973,Sheffield Wednesday,Millwall,3-2,3,2,2,2,5,1,H
1973-10-06,1973,Aston Villa,Cardiff City,5-0,5,0,2,2,5,5,H
1973-10-06,1973,Blackpool,Notts County,0-1,0,1,2,2,1,-1,A
1973-10-06,1973,Bristol City,West Bromwich Albion,1-1,1,1,2,2,2,0,D
1973-10-06,1973,Carlisle United,Bolton Wanderers,1-0,1,0,2,2,1,1,H
1973-10-06,1973,Crystal Palace,Luton Town,1-2,1,2,2,2,3,-1,A
1973-10-06,1973,Fulham,Preston North End,0-0,0,0,2,2,0,0,D
1973-10-06,1973,Hull City,Leyton Orient,1-1,1,1,2,2,2,0,D
1973-10-06,1973,Nottingham Forest,Millwall,3-0,3,0,2,2,3,3,H
1973-10-06,1973,Portsmouth,Oxford United,2-1,2,1,2,2,3,1,H
1973-10-06,1973,Sunderland,Sheffield Wednesday,3-1,3,1,2,2,4,2,H
1973-10-06,1973,Swindon Town,Middlesbrough,0-1,0,1,2,2,1,-1,A
1973-10-13,1973,Bolton Wanderers,Aston Villa,1-2,1,2,2,2,3,-1,A
1973-10-13,1973,Cardiff City,Blackpool,1-0,1,0,2,2,1,1,H
1973-10-13,1973,Leyton Orient,Nottingham Forest,2-1,2,1,2,2,3,1,H
1973-10-13,1973,Luton Town,Swindon Town,2-1,2,1,2,2,3,1,H
1973-10-13,1973,Middlesbrough,Hull City,1-0,1,0,2,2,1,1,H
1973-10-13,1973,Millwall,Bristol City,0-2,0,2,2,2,2,-2,A
1973-10-13,1973,Notts County,Fulham,2-1,2,1,2,2,3,1,H
1973-10-13,1973,Oxford United,Crystal Palace,1-1,1,1,2,2,2,0,D
1973-10-13,1973,Preston North End,Sunderland,1-0,1,0,2,2,1,1,H
1973-10-13,1973,Sheffield Wednesday,Portsmouth,1-2,1,2,2,2,3,-1,A
1973-10-13,1973,West Bromwich Albion,Carlisle United,1-1,1,1,2,2,2,0,D
1973-10-20,1973,Aston Villa,Bristol City,2-2,2,2,2,2,4,0,D
1973-10-20,1973,Blackpool,Nottingham Forest,2-2,2,2,2,2,4,0,D
1973-10-20,1973,Bolton Wanderers,Millwall,0-1,0,1,2,2,1,-1,A
1973-10-20,1973,Cardiff City,Sheffield Wednesday,0-1,0,1,2,2,1,-1,A
1973-10-20,1973,Crystal Palace,Carlisle United,0-1,0,1,2,2,1,-1,A
1973-10-20,1973,Fulham,Sunderland,0-2,0,2,2,2,2,-2,A
1973-10-20,1973,Hull City,Portsmouth,4-1,4,1,2,2,5,3,H
1973-10-20,1973,Leyton Orient,Luton Town,2-0,2,0,2,2,2,2,H
1973-10-20,1973,Middlesbrough,West Bromwich Albion,0-0,0,0,2,2,0,0,D
1973-10-20,1973,Notts County,Preston North End,2-1,2,1,2,2,3,1,H
1973-10-20,1973,Swindon Town,Oxford United,1-0,1,0,2,2,1,1,H
1973-10-22,1973,Blackpool,Fulham,2-0,2,0,2,2,2,2,H
1973-10-22,1973,Leyton Orient,Bolton Wanderers,3-0,3,0,2,2,3,3,H
1973-10-22,1973,Millwall,Preston North End,5-1,5,1,2,2,6,4,H
1973-10-23,1973,Aston Villa,Crystal Palace,2-1,2,1,2,2,3,1,H
1973-10-23,1973,Bristol City,Swindon Town,1-0,1,0,2,2,1,1,H
1973-10-23,1973,Carlisle United,Middlesbrough,1-1,1,1,2,2,2,0,D
1973-10-23,1973,Nottingham Forest,Hull City,0-0,0,0,2,2,0,0,D
1973-10-24,1973,Oxford United,Cardiff City,4-2,4,2,2,2,6,2,H
1973-10-24,1973,West Bromwich Albion,Sheffield Wednesday,2-0,2,0,2,2,2,2,H
1973-10-27,1973,Bristol City,Blackpool,0-1,0,1,2,2,1,-1,A
1973-10-27,1973,Carlisle United,Fulham,3-0,3,0,2,2,3,3,H
1973-10-27,1973,Luton Town,Hull City,2-2,2,2,2,2,4,0,D
1973-10-27,1973,Millwall,Middlesbrough,0-1,0,1,2,2,1,-1,A
1973-10-27,1973,Nottingham Forest,Aston Villa,1-2,1,2,2,2,3,-1,A
1973-10-27,1973,Oxford United,Leyton Orient,1-1,1,1,2,2,2,0,D
1973-10-27,1973,Portsmouth,Swindon Town,3-1,3,1,2,2,4,2,H
1973-10-27,1973,Preston North End,Cardiff City,2-2,2,2,2,2,4,0,D
1973-10-27,1973,Sheffield Wednesday,Notts County,0-0,0,0,2,2,0,0,D
1973-10-27,1973,Sunderland,Crystal Palace,0-0,0,0,2,2,0,0,D
1973-10-27,1973,West Bromwich Albion,Bolton Wanderers,0-0,0,0,2,2,0,0,D
1973-11-03,1973,Aston Villa,Sheffield Wednesday,1-0,1,0,2,2,1,1,H
1973-11-03,1973,Blackpool,Portsmouth,5-0,5,0,2,2,5,5,H
1973-11-03,1973,Bolton Wanderers,Oxford United,2-1,2,1,2,2,3,1,H
1973-11-03,1973,Cardiff City,West Bromwich Albion,0-1,0,1,2,2,1,-1,A
1973-11-03,1973,Crystal Palace,Nottingham Forest,0-1,0,1,2,2,1,-1,A
1973-11-03,1973,Fulham,Bristol City,2-1,2,1,2,2,3,1,H
1973-11-03,1973,Hull City,Sunderland,2-0,2,0,2,2,2,2,H
1973-11-03,1973,Leyton Orient,Preston North End,2-2,2,2,2,2,4,0,D
1973-11-03,1973,Middlesbrough,Luton Town,2-1,2,1,2,2,3,1,H
1973-11-03,1973,Notts County,Millwall,3-3,3,3,2,2,6,0,D
1973-11-03,1973,Swindon Town,Carlisle United,2-2,2,2,2,2,4,0,D
1973-11-10,1973,Bristol City,Crystal Palace,0-1,0,1,2,2,1,-1,A
1973-11-10,1973,Carlisle United,Hull City,4-0,4,0,2,2,4,4,H
1973-11-10,1973,Luton Town,Bolton Wanderers,2-1,2,1,2,2,3,1,H
1973-11-10,1973,Millwall,Cardiff City,2-0,2,0,2,2,2,2,H
1973-11-10,1973,Nottingham Forest,Fulham,3-0,3,0,2,2,3,3,H
1973-11-10,1973,Oxford United,Middlesbrough,0-2,0,2,2,2,2,-2,A
1973-11-10,1973,Portsmouth,Aston Villa,2-0,2,0,2,2,2,2,H
1973-11-10,1973,Preston North End,Blackpool,1-3,1,3,2,2,4,-2,A
1973-11-10,1973,Sheffield Wednesday,Leyton Orient,1-2,1,2,2,2,3,-1,A
1973-11-10,1973,Sunderland,Swindon Town,4-1,4,1,2,2,5,3,H
1973-11-10,1973,West Bromwich Albion,Notts County,2-1,2,1,2,2,3,1,H
1973-11-13,1973,Sunderland,Bolton Wanderers,3-0,3,0,2,2,3,3,H
1973-11-14,1973,Cardiff City,Luton Town,0-0,0,0,2,2,0,0,D
1973-11-17,1973,Aston Villa,Hull City,1-1,1,1,2,2,2,0,D
1973-11-17,1973,Blackpool,Swindon Town,2-0,2,0,2,2,2,2,H
1973-11-17,1973,Bolton Wanderers,Notts County,1-3,1,3,2,2,4,-2,A
1973-11-17,1973,Bristol City,Sunderland,2-0,2,0,2,2,2,2,H
1973-11-17,1973,Crystal Palace,Millwall,1-1,1,1,2,2,2,0,D
1973-11-17,1973,Fulham,Portsmouth,2-0,2,0,2,2,2,2,H
1973-11-17,1973,Leyton Orient,West Bromwich Albion,2-0,2,0,2,2,2,2,H
1973-11-17,1973,Luton Town,Sheffield Wednesday,2-1,2,1,2,2,3,1,H
1973-11-17,1973,Middlesbrough,Cardiff City,3-0,3,0,2,2,3,3,H
1973-11-17,1973,Nottingham Forest,Carlisle United,2-0,2,0,2,2,2,2,H
1973-11-17,1973,Oxford United,Preston North End,1-1,1,1,2,2,2,0,D
1973-11-24,1973,Cardiff City,Bolton Wanderers,1-0,1,0,2,2,1,1,H
1973-11-24,1973,Carlisle United,Bristol City,2-1,2,1,2,2,3,1,H
1973-11-24,1973,Hull City,Blackpool,1-0,1,0,2,2,1,1,H
1973-11-24,1973,Millwall,Leyton Orient,0-1,0,1,2,2,1,-1,A
1973-11-24,1973,Notts County,Middlesbrough,2-2,2,2,2,2,4,0,D
1973-11-24,1973,Portsmouth,Crystal Palace,2-2,2,2,2,2,4,0,D
1973-11-24,1973,Preston North End,Luton Town,2-2,2,2,2,2,4,0,D
1973-11-24,1973,Sheffield Wednesday,Oxford United,0-1,0,1,2,2,1,-1,A
1973-11-24,1973,Sunderland,Nottingham Forest,0-0,0,0,2,2,0,0,D
1973-11-24,1973,Swindon Town,Aston Villa,1-0,1,0,2,2,1,1,H
1973-11-24,1973,West Bromwich Albion,Fulham,2-0,2,0,2,2,2,2,H
1973-12-01,1973,Blackpool,Sunderland,0-2,0,2,2,2,2,-2,A
1973-12-01,1973,Bristol City,Notts County,2-2,2,2,2,2,4,0,D
1973-12-01,1973,Crystal Palace,Swindon Town,4-2,4,2,2,2,6,2,H
1973-12-01,1973,Fulham,Hull City,0-0,0,0,2,2,0,0,D
1973-12-01,1973,Leyton Orient,Cardiff City,1-2,1,2,2,2,3,-1,A
1973-12-01,1973,Luton Town,West Bromwich Albion,0-2,0,2,2,2,2,-2,A
1973-12-05,1973,Bolton Wanderers,Sunderland,1-0,1,0,2,2,1,1,H
1973-12-08,1973,Cardiff City,Nottingham Forest,1-1,1,1,2,2,2,0,D
1973-12-08,1973,Carlisle United,Blackpool,2-3,2,3,2,2,5,-1,A
1973-12-08,1973,Hull City,Crystal Palace,3-0,3,0,2,2,3,3,H
1973-12-08,1973,Millwall,Luton Town,0-1,0,1,2,2,1,-1,A
1973-12-08,1973,Notts County,Leyton Orient,2-4,2,4,2,2,6,-2,A
1973-12-08,1973,Portsmouth,Bristol City,1-0,1,0,2,2,1,1,H
1973-12-08,1973,Preston North End,Bolton Wanderers,2-1,2,1,2,2,3,1,H
1973-12-08,1973,Sheffield Wednesday,Middlesbrough,2-2,2,2,2,2,4,0,D
1973-12-08,1973,Sunderland,Aston Villa,2-0,2,0,2,2,2,2,H
1973-12-08,1973,Swindon Town,Fulham,1-1,1,1,2,2,2,0,D
1973-12-08,1973,West Bromwich Albion,Oxford United,1-0,1,0,2,2,1,1,H
1973-12-11,1973,Middlesbrough,Preston North End,3-0,3,0,2,2,3,3,H
1973-12-12,1973,Luton Town,Cardiff City,1-0,1,0,2,2,1,1,H
1973-12-15,1973,Bolton Wanderers,Swindon Town,2-0,2,0,2,2,2,2,H
1973-12-15,1973,Cardiff City,Bristol City,0-1,0,1,2,2,1,-1,A
1973-12-15,1973,Leyton Orient,Carlisle United,0-1,0,1,2,2,1,-1,A
1973-12-15,1973,Luton Town,Aston Villa,1-0,1,0,2,2,1,1,H
1973-12-15,1973,Middlesbrough,Nottingham Forest,1-0,1,0,2,2,1,1,H
1973-12-15,1973,Millwall,Sunderland,2-1,2,1,2,2,3,1,H
1973-12-15,1973,Notts County,Hull City,3-2,3,2,2,2,5,1,H
1973-12-15,1973,Oxford United,Blackpool,2-2,2,2,2,2,4,0,D
1973-12-15,1973,Preston North End,Crystal Palace,1-1,1,1,2,2,2,0,D
1973-12-15,1973,Sheffield Wednesday,Fulham,0-3,0,3,2,2,3,-3,A
1973-12-15,1973,West Bromwich Albion,Portsmouth,1-2,1,2,2,2,3,-1,A
1973-12-22,1973,Aston Villa,Notts County,1-1,1,1,2,2,2,0,D
1973-12-22,1973,Blackpool,Luton Town,3-0,3,0,2,2,3,3,H
1973-12-22,1973,Bristol City,Middlesbrough,1-1,1,1,2,2,2,0,D
1973-12-22,1973,Carlisle United,Millwall,1-1,1,1,2,2,2,0,D
1973-12-22,1973,Crystal Palace,Sheffield Wednesday,0-0,0,0,2,2,0,0,D
1973-12-22,1973,Fulham,Oxford United,3-1,3,1,2,2,4,2,H
1973-12-22,1973,Hull City,Cardiff City,1-1,1,1,2,2,2,0,D
1973-12-22,1973,Nottingham Forest,Bolton Wanderers,3-2,3,2,2,2,5,1,H
1973-12-22,1973,Portsmouth,Preston North End,3-0,3,0,2,2,3,3,H
1973-12-22,1973,Sunderland,West Bromwich Albion,1-1,1,1,2,2,2,0,D
1973-12-22,1973,Swindon Town,Leyton Orient,2-2,2,2,2,2,4,0,D
1973-12-26,1973,Bolton Wanderers,Blackpool,1-1,1,1,2,2,2,0,D
1973-12-26,1973,Cardiff City,Swindon Town,2-1,2,1,2,2,3,1,H
1973-12-26,1973,Leyton Orient,Crystal Palace,3-0,3,0,2,2,3,3,H
1973-12-26,1973,Luton Town,Fulham,1-1,1,1,2,2,2,0,D
1973-12-26,1973,Middlesbrough,Sunderland,2-1,2,1,2,2,3,1,H
1973-12-26,1973,Millwall,Portsmouth,1-1,1,1,2,2,2,0,D
1973-12-26,1973,Notts County,Nottingham Forest,0-1,0,1,2,2,1,-1,A
1973-12-26,1973,Oxford United,Bristol City,5-0,5,0,2,2,5,5,H
1973-12-26,1973,Preston North End,Carlisle United,0-1,0,1,2,2,1,-1,A
1973-12-26,1973,Sheffield Wednesday,Hull City,1-1,1,1,2,2,2,0,D
1973-12-26,1973,West Bromwich Albion,Aston Villa,2-0,2,0,2,2,2,2,H
1973-12-29,1973,Bolton Wanderers,Portsmouth,4-0,4,0,2,2,4,4,H
1973-12-29,1973,Cardiff City,Sunderland,4-1,4,1,2,2,5,3,H
1973-12-29,1973,Leyton Orient,Fulham,1-0,1,0,2,2,1,1,H
1973-12-29,1973,Luton Town,Bristol City,1-0,1,0,2,2,1,1,H
1973-12-29,1973,Middlesbrough,Crystal Palace,2-0,2,0,2,2,2,2,H
1973-12-29,1973,Millwall,Blackpool,2-2,2,2,2,2,4,0,D
1973-12-29,1973,Notts County,Carlisle United,0-3,0,3,2,2,3,-3,A
1973-12-29,1973,Oxford United,Aston Villa,2-1,2,1,2,2,3,1,H
1973-12-29,1973,Preston North End,Hull City,2-0,2,0,2,2,2,2,H
1973-12-29,1973,Sheffield Wednesday,Nottingham Forest,1-1,1,1,2,2,2,0,D
1973-12-29,1973,West Bromwich Albion,Swindon Town,2-0,2,0,2,2,2,2,H
1974-01-01,1973,Aston Villa,Millwall,0-0,0,0,2,2,0,0,D
1974-01-01,1973,Blackpool,Sheffield Wednesday,0-0,0,0,2,2,0,0,D
1974-01-01,1973,Bristol City,Leyton Orient,0-2,0,2,2,2,2,-2,A
1974-01-01,1973,Carlisle United,Luton Town,2-0,2,0,2,2,2,2,H
1974-01-01,1973,Crystal Palace,West Bromwich Albion,1-0,1,0,2,2,1,1,H
1974-01-01,1973,Hull City,Bolton Wanderers,0-0,0,0,2,2,0,0,D
1974-01-01,1973,Nottingham Forest,Oxford United,1-1,1,1,2,2,2,0,D
1974-01-01,1973,Portsmouth,Cardiff City,1-0,1,0,2,2,1,1,H
1974-01-01,1973,Sunderland,Notts County,1-2,1,2,2,2,3,-1,A
1974-01-01,1973,Swindon Town,Preston North End,3-1,3,1,2,2,4,2,H
1974-01-12,1973,Aston Villa,Middlesbrough,1-1,1,1,2,2,2,0,D
1974-01-12,1973,Blackpool,Leyton Orient,1-1,1,1,2,2,2,0,D
1974-01-12,1973,Bristol City,Preston North End,0-0,0,0,2,2,0,0,D
1974-01-12,1973,Carlisle United,Sheffield Wednesday,2-2,2,2,2,2,4,0,D
1974-01-12,1973,Crystal Palace,Bolton Wanderers,0-0,0,0,2,2,0,0,D
1974-01-12,1973,Fulham,Cardiff City,0-1,0,1,2,2,1,-1,A
1974-01-12,1973,Hull City,Millwall,1-1,1,1,2,2,2,0,D
1974-01-12,1973,Nottingham Forest,West Bromwich Albion,1-4,1,4,2,2,5,-3,A
1974-01-12,1973,Portsmouth,Luton Town,0-0,0,0,2,2,0,0,D
1974-01-12,1973,Sunderland,Oxford United,0-0,0,0,2,2,0,0,D
1974-01-19,1973,Cardiff City,Carlisle United,2-2,2,2,2,2,4,0,D
1974-01-19,1973,Leyton Orient,Sunderland,2-1,2,1,2,2,3,1,H
1974-01-19,1973,Luton Town,Nottingham Forest,2-2,2,2,2,2,4,0,D
1974-01-19,1973,Middlesbrough,Portsmouth,3-0,3,0,2,2,3,3,H
1974-01-19,1973,Oxford United,Hull City,1-1,1,1,2,2,2,0,D
1974-01-19,1973,Preston North End,Aston Villa,0-0,0,0,2,2,0,0,D
1974-01-19,1973,Sheffield Wednesday,Swindon Town,2-1,2,1,2,2,3,1,H
1974-01-19,1973,West Bromwich Albion,Blackpool,1-1,1,1,2,2,2,0,D
1974-01-20,1973,Bolton Wanderers,Bristol City,2-1,2,1,2,2,3,1,H
1974-01-20,1973,Millwall,Fulham,1-0,1,0,2,2,1,1,H
1974-01-20,1973,Notts County,Crystal Palace,1-3,1,3,2,2,4,-2,A
1974-01-26,1973,Cardiff City,Notts County,1-0,1,0,2,2,1,1,H
1974-01-26,1973,Oxford United,Millwall,0-3,0,3,2,2,3,-3,A
1974-01-26,1973,Swindon Town,Hull City,1-1,1,1,2,2,2,0,D
1974-02-02,1973,Aston Villa,Luton Town,0-1,0,1,2,2,1,-1,A
1974-02-02,1973,Blackpool,Oxford United,2-0,2,0,2,2,2,2,H
1974-02-02,1973,Bristol City,Cardiff City,3-2,3,2,2,2,5,1,H
1974-02-02,1973,Carlisle United,Leyton Orient,3-0,3,0,2,2,3,3,H
1974-02-02,1973,Fulham,Sheffield Wednesday,4-1,4,1,2,2,5,3,H
1974-02-02,1973,Hull City,Notts County,1-0,1,0,2,2,1,1,H
1974-02-02,1973,Nottingham Forest,Middlesbrough,5-1,5,1,2,2,6,4,H
1974-02-02,1973,Sunderland,Millwall,4-0,4,0,2,2,4,4,H
1974-02-03,1973,Crystal Palace,Preston North End,2-0,2,0,2,2,2,2,H
1974-02-03,1973,Portsmouth,West Bromwich Albion,1-1,1,1,2,2,2,0,D
1974-02-03,1973,Swindon Town,Bolton Wanderers,2-2,2,2,2,2,4,0,D
1974-02-05,1973,Luton Town,Notts County,1-1,1,1,2,2,2,0,D
1974-02-09,1973,Middlesbrough,Blackpool,0-0,0,0,2,2,0,0,D
1974-02-09,1973,Notts County,Portsmouth,4-0,4,0,2,2,4,4,H
1974-02-10,1973,Preston North End,Nottingham Forest,2-1,2,1,2,2,3,1,H
1974-02-10,1973,Sheffield Wednesday,Bristol City,3-1,3,1,2,2,4,2,H
1974-02-16,1973,Blackpool,Cardiff City,2-1,2,1,2,2,3,1,H
1974-02-16,1973,Bolton Wanderers,Sheffield Wednesday,4-2,4,2,2,2,6,2,H
1974-02-16,1973,Fulham,Notts County,2-0,2,0,2,2,2,2,H
1974-02-16,1973,Hull City,Middlesbrough,1-3,1,3,2,2,4,-2,A
1974-02-16,1973,Millwall,Swindon Town,3-0,3,0,2,2,3,3,H
1974-02-16,1973,Sunderland,Preston North End,2-1,2,1,2,2,3,1,H
1974-02-17,1973,Crystal Palace,Oxford United,2-0,2,0,2,2,2,2,H
1974-02-19,1973,Swindon Town,Notts County,1-4,1,4,2,2,5,-3,A
1974-02-20,1973,Portsmouth,Sheffield Wednesday,1-1,1,1,2,2,2,0,D
1974-02-23,1973,Bolton Wanderers,Carlisle United,2-0,2,0,2,2,2,2,H
1974-02-23,1973,Cardiff City,Aston Villa,0-1,0,1,2,2,1,-1,A
1974-02-23,1973,Leyton Orient,Hull City,1-1,1,1,2,2,2,0,D
1974-02-23,1973,Luton Town,Crystal Palace,2-1,2,1,2,2,3,1,H
1974-02-23,1973,Middlesbrough,Swindon Town,2-1,2,1,2,2,3,1,H
1974-02-23,1973,Millwall,Nottingham Forest,0-0,0,0,2,2,0,0,D
1974-02-23,1973,Notts County,Blackpool,0-3,0,3,2,2,3,-3,A
1974-02-23,1973,Oxford United,Portsmouth,3-0,3,0,2,2,3,3,H
1974-02-23,1973,Preston North End,Fulham,0-1,0,1,2,2,1,-1,A
1974-02-23,1973,Sheffield Wednesday,Sunderland,0-1,0,1,2,2,1,-1,A
1974-02-23,1973,West Bromwich Albion,Bristol City,2-2,2,2,2,2,4,0,D
1974-02-25,1973,Carlisle United,West Bromwich Albion,0-1,0,1,2,2,1,-1,A
1974-02-26,1973,Bristol City,Millwall,5-2,5,2,2,2,7,3,H
1974-02-26,1973,Nottingham Forest,Leyton Orient,2-1,2,1,2,2,3,1,H
1974-02-26,1973,Swindon Town,Luton Town,0-2,0,2,2,2,2,-2,A
1974-02-27,1973,Aston Villa,Bolton Wanderers,1-1,1,1,2,2,2,0,D
1974-03-02,1973,Aston Villa,West Bromwich Albion,1-3,1,3,2,2,4,-2,A
1974-03-02,1973,Blackpool,Bolton Wanderers,0-2,0,2,2,2,2,-2,A
1974-03-02,1973,Bristol City,Oxford United,0-0,0,0,2,2,0,0,D
1974-03-02,1973,Carlisle United,Preston North End,2-2,2,2,2,2,4,0,D
1974-03-02,1973,Hull City,Sheffield Wednesday,2-1,2,1,2,2,3,1,H
1974-03-02,1973,Portsmouth,Millwall,0-0,0,0,2,2,0,0,D
1974-03-02,1973,Sunderland,Middlesbrough,0-2,0,2,2,2,2,-2,A
1974-03-02,1973,Swindon Town,Cardiff City,1-1,1,1,2,2,2,0,D
1974-03-03,1973,Crystal Palace,Leyton Orient,0-0,0,0,2,2,0,0,D
1974-03-03,1973,Nottingham Forest,Notts County,0-0,0,0,2,2,0,0,D
1974-03-05,1973,Fulham,Luton Town,2-1,2,1,2,2,3,1,H
1974-03-05,1973,Sunderland,Portsmouth,3-0,3,0,2,2,3,3,H
1974-03-09,1973,Bolton Wanderers,West Bromwich Albion,1-1,1,1,2,2,2,0,D
1974-03-09,1973,Cardiff City,Preston North End,2-0,2,0,2,2,2,2,H
1974-03-09,1973,Crystal Palace,Sunderland,3-0,3,0,2,2,3,3,H
1974-03-09,1973,Fulham,Carlisle United,0-2,0,2,2,2,2,-2,A
1974-03-09,1973,Hull City,Luton Town,1-3,1,3,2,2,4,-2,A
1974-03-09,1973,Middlesbrough,Millwall,2-1,2,1,2,2,3,1,H
1974-03-09,1973,Notts County,Sheffield Wednesday,1-5,1,5,2,2,6,-4,A
1974-03-09,1973,Swindon Town,Portsmouth,1-2,1,2,2,2,3,-1,A
1974-03-10,1973,Leyton Orient,Oxford United,1-1,1,1,2,2,2,0,D
1974-03-13,1973,Aston Villa,Carlisle United,2-1,2,1,2,2,3,1,H
1974-03-16,1973,Bristol City,Aston Villa,0-1,0,1,2,2,1,-1,A
1974-03-16,1973,Carlisle United,Crystal Palace,1-0,1,0,2,2,1,1,H
1974-03-16,1973,Luton Town,Leyton Orient,3-1,3,1,2,2,4,2,H
1974-03-16,1973,Millwall,Bolton Wanderers,2-1,2,1,2,2,3,1,H
1974-03-16,1973,Nottingham Forest,Blackpool,2-0,2,0,2,2,2,2,H
1974-03-16,1973,Portsmouth,Hull City,3-1,3,1,2,2,4,2,H
1974-03-16,1973,Preston North End,Notts County,0-2,0,2,2,2,2,-2,A
1974-03-16,1973,Sheffield Wednesday,Cardiff City,5-0,5,0,2,2,5,5,H
1974-03-16,1973,Sunderland,Fulham,1-0,1,0,2,2,1,1,H
1974-03-16,1973,West Bromwich Albion,Middlesbrough,0-4,0,4,2,2,4,-4,A
1974-03-17,1973,Oxford United,Swindon Town,1-1,1,1,2,2,2,0,D
1974-03-19,1973,Blackpool,Bristol City,2-2,2,2,2,2,4,0,D
1974-03-19,1973,Fulham,Middlesbrough,0-4,0,4,2,2,4,-4,A
1974-03-19,1973,West Bromwich Albion,Hull City,2-3,2,3,2,2,5,-1,A
1974-03-23,1973,Aston Villa,Portsmouth,4-1,4,1,2,2,5,3,H
1974-03-23,1973,Blackpool,Preston North End,3-0,3,0,2,2,3,3,H
1974-03-23,1973,Bolton Wanderers,Luton Town,1-0,1,0,2,2,1,1,H
1974-03-23,1973,Cardiff City,Millwall,1-3,1,3,2,2,4,-2,A
1974-03-23,1973,Crystal Palace,Bristol City,3-1,3,1,2,2,4,2,H
1974-03-23,1973,Fulham,Nottingham Forest,2-0,2,0,2,2,2,2,H
1974-03-23,1973,Hull City,Carlisle United,1-1,1,1,2,2,2,0,D
1974-03-23,1973,Leyton Orient,Sheffield Wednesday,0-1,0,1,2,2,1,-1,A
1974-03-23,1973,Middlesbrough,Oxford United,1-0,1,0,2,2,1,1,H
1974-03-23,1973,Notts County,West Bromwich Albion,1-0,1,0,2,2,1,1,H
1974-03-23,1973,Swindon Town,Sunderland,0-2,0,2,2,2,2,-2,A
1974-03-26,1973,Nottingham Forest,Portsmouth,2-0,2,0,2,2,2,2,H
1974-03-30,1973,Bristol City,Fulham,0-1,0,1,2,2,1,-1,A
1974-03-30,1973,Carlisle United,Swindon Town,5-1,5,1,2,2,6,4,H
1974-03-30,1973,Luton Town,Middlesbrough,0-1,0,1,2,2,1,-1,A
1974-03-30,1973,Millwall,Notts County,0-0,0,0,2,2,0,0,D
1974-03-30,1973,Nottingham Forest,Crystal Palace,1-2,1,2,2,2,3,-1,A
1974-03-30,1973,Oxford United,Bolton Wanderers,0-2,0,2,2,2,2,-2,A
1974-03-30,1973,Portsmouth,Blackpool,0-0,0,0,2,2,0,0,D
1974-03-30,1973,Preston North End,Leyton Orient,0-1,0,1,2,2,1,-1,A
1974-03-30,1973,Sunderland,Hull City,1-0,1,0,2,2,1,1,H
1974-03-30,1973,West Bromwich Albion,Cardiff City,2-2,2,2,2,2,4,0,D
1974-04-01,1973,Sheffield Wednesday,Aston Villa,2-4,2,4,2,2,6,-2,A
1974-04-02,1973,Bolton Wanderers,Fulham,0-0,0,0,2,2,0,0,D
1974-04-06,1973,Aston Villa,Swindon Town,1-1,1,1,2,2,2,0,D
1974-04-06,1973,Blackpool,Hull City,1-2,1,2,2,2,3,-1,A
1974-04-06,1973,Bolton Wanderers,Cardiff City,1-1,1,1,2,2,2,0,D
1974-04-06,1973,Bristol City,Carlisle United,2-0,2,0,2,2,2,2,H
1974-04-06,1973,Crystal Palace,Portsmouth,0-0,0,0,2,2,0,0,D
1974-04-06,1973,Fulham,West Bromwich Albion,0-0,0,0,2,2,0,0,D
1974-04-06,1973,Leyton Orient,Millwall,1-1,1,1,2,2,2,0,D
1974-04-06,1973,Luton Town,Preston North End,4-2,4,2,2,2,6,2,H
1974-04-06,1973,Middlesbrough,Notts County,4-0,4,0,2,2,4,4,H
1974-04-06,1973,Nottingham Forest,Sunderland,2-2,2,2,2,2,4,0,D
1974-04-06,1973,Oxford United,Sheffield Wednesday,1-0,1,0,2,2,1,1,H
1974-04-09,1973,Middlesbrough,Bolton Wanderers,0-0,0,0,2,2,0,0,D
1974-04-12,1973,Bristol City,Nottingham Forest,1-0,1,0,2,2,1,1,H
1974-04-12,1973,Fulham,Crystal Palace,1-3,1,3,2,2,4,-2,A
1974-04-12,1973,Millwall,West Bromwich Albion,1-0,1,0,2,2,1,1,H
1974-04-12,1973,Oxford United,Luton Town,1-1,1,1,2,2,2,0,D
1974-04-12,1973,Portsmouth,Leyton Orient,0-0,0,0,2,2,0,0,D
1974-04-12,1973,Preston North End,Sheffield Wednesday,0-0,0,0,2,2,0,0,D
1974-04-12,1973,Sunderland,Carlisle United,2-1,2,1,2,2,3,1,H
1974-04-13,1973,Cardiff City,Middlesbrough,3-2,3,2,2,2,5,1,H
1974-04-13,1973,Carlisle United,Nottingham Forest,2-1,2,1,2,2,3,1,H
1974-04-13,1973,Hull City,Aston Villa,1-1,1,1,2,2,2,0,D
1974-04-13,1973,Millwall,Crystal Palace,3-2,3,2,2,2,5,1,H
1974-04-13,1973,Notts County,Bolton Wanderers,0-0,0,0,2,2,0,0,D
1974-04-13,1973,Portsmouth,Fulham,3-0,3,0,2,2,3,3,H
1974-04-13,1973,Preston North End,Oxford United,0-0,0,0,2,2,0,0,D
1974-04-13,1973,Sheffield Wednesday,Luton Town,2-2,2,2,2,2,4,0,D
1974-04-13,1973,Sunderland,Bristol City,1-2,1,2,2,2,3,-1,A
1974-04-13,1973,Swindon Town,Blackpool,1-0,1,0,2,2,1,1,H
1974-04-13,1973,West Bromwich Albion,Leyton Orient,1-0,1,0,2,2,1,1,H
1974-04-15,1973,Aston Villa,Blackpool,0-1,0,1,2,2,1,-1,A
1974-04-15,1973,Bolton Wanderers,Middlesbrough,2-1,2,1,2,2,3,1,H
1974-04-15,1973,Hull City,Swindon Town,0-1,0,1,2,2,1,-1,A
1974-04-15,1973,Leyton Orient,Portsmouth,2-1,2,1,2,2,3,1,H
1974-04-15,1973,Notts County,Cardiff City,1-1,1,1,2,2,2,0,D
1974-04-15,1973,Sheffield Wednesday,Preston North End,1-0,1,0,2,2,1,1,H
1974-04-16,1973,Blackpool,Aston Villa,2-1,2,1,2,2,3,1,H
1974-04-16,1973,Carlisle United,Sunderland,1-0,1,0,2,2,1,1,H
1974-04-16,1973,Crystal Palace,Fulham,0-2,0,2,2,2,2,-2,A
1974-04-16,1973,Luton Town,Oxford United,0-1,0,1,2,2,1,-1,A
1974-04-16,1973,Nottingham Forest,Bristol City,1-1,1,1,2,2,2,0,D
1974-04-17,1973,West Bromwich Albion,Millwall,1-1,1,1,2,2,2,0,D
1974-04-20,1973,Aston Villa,Sunderland,1-2,1,2,2,2,3,-1,A
1974-04-20,1973,Blackpool,Carlisle United,4-0,4,0,2,2,4,4,H
1974-04-20,1973,Bolton Wanderers,Preston North End,0-2,0,2,2,2,2,-2,A
1974-04-20,1973,Bristol City,Portsmouth,0-2,0,2,2,2,2,-2,A
1974-04-20,1973,Crystal Palace,Hull City,0-2,0,2,2,2,2,-2,A
1974-04-20,1973,Fulham,Swindon Town,4-1,4,1,2,2,5,3,H
1974-04-20,1973,Leyton Orient,Notts County,1-1,1,1,2,2,2,0,D
1974-04-20,1973,Luton Town,Millwall,3-0,3,0,2,2,3,3,H
1974-04-20,1973,Middlesbrough,Sheffield Wednesday,8-0,8,0,2,2,8,8,H
1974-04-20,1973,Nottingham Forest,Cardiff City,2-1,2,1,2,2,3,1,H
1974-04-20,1973,Oxford United,West Bromwich Albion,1-0,1,0,2,2,1,1,H
1974-04-23,1973,Oxford United,Carlisle United,0-1,0,1,2,2,1,-1,A
1974-04-24,1973,Aston Villa,Nottingham Forest,3-1,3,1,2,2,4,2,H
1974-04-27,1973,Cardiff City,Leyton Orient,1-1,1,1,2,2,2,0,D
1974-04-27,1973,Carlisle United,Aston Villa,2-0,2,0,2,2,2,2,H
1974-04-27,1973,Hull City,Fulham,2-0,2,0,2,2,2,2,H
1974-04-27,1973,Millwall,Oxford United,0-0,0,0,2,2,0,0,D
1974-04-27,1973,Notts County,Bristol City,2-1,2,1,2,2,3,1,H
1974-04-27,1973,Portsmouth,Nottingham Forest,0-2,0,2,2,2,2,-2,A
1974-04-27,1973,Preston North End,Middlesbrough,2-4,2,4,2,2,6,-2,A
1974-04-27,1973,Sheffield Wednesday,Bolton Wanderers,1-0,1,0,2,2,1,1,H
1974-04-27,1973,Sunderland,Blackpool,2-1,2,1,2,2,3,1,H
1974-04-27,1973,Swindon Town,Crystal Palace,0-1,0,1,2,2,1,-1,A
1974-04-27,1973,West Bromwich Albion,Luton Town,1-1,1,1,2,2,2,0,D
1974-04-30,1973,Cardiff City,Crystal Palace,1-1,1,1,2,2,2,0,D
1974-05-01,1973,Luton Town,Sunderland,3-4,3,4,2,2,7,-1,A
1974-05-03,1973,Leyton Orient,Aston Villa,1-1,1,1,2,2,2,0,D
1974-08-17,1974,Bolton Wanderers,Portsmouth,3-0,3,0,2,2,3,3,H
1974-08-17,1974,Bristol Rovers,Notts County,0-0,0,0,2,2,0,0,D
1974-08-17,1974,Cardiff City,Oxford United,1-1,1,1,2,2,2,0,D
1974-08-17,1974,Leyton Orient,Manchester United,0-2,0,2,2,2,2,-2,A
1974-08-17,1974,Millwall,Sunderland,1-4,1,4,2,2,5,-3,A
1974-08-17,1974,Norwich City,Blackpool,2-1,2,1,2,2,3,1,H
1974-08-17,1974,Nottingham Forest,Bristol City,0-0,0,0,2,2,0,0,D
1974-08-17,1974,Oldham Athletic,Sheffield Wednesday,2-1,2,1,2,2,3,1,H
1974-08-17,1974,Southampton,Hull City,3-3,3,3,2,2,6,0,D
1974-08-17,1974,West Bromwich Albion,Fulham,0-1,0,1,2,2,1,-1,A
1974-08-17,1974,York City,Aston Villa,1-1,1,1,2,2,2,0,D
1974-08-19,1974,Millwall,Nottingham Forest,3-0,3,0,2,2,3,3,H
1974-08-20,1974,Blackpool,Leyton Orient,0-0,0,0,2,2,0,0,D
1974-08-20,1974,Hull City,Aston Villa,1-1,1,1,2,2,2,0,D
1974-08-20,1974,Notts County,Fulham,1-1,1,1,2,2,2,0,D
1974-08-21,1974,Norwich City,Southampton,1-0,1,0,2,2,1,1,H
1974-08-24,1974,Aston Villa,Norwich City,1-1,1,1,2,2,2,0,D
1974-08-24,1974,Blackpool,Bolton Wanderers,2-1,2,1,2,2,3,1,H
1974-08-24,1974,Bristol City,Leyton Orient,0-0,0,0,2,2,0,0,D
1974-08-24,1974,Fulham,Cardiff City,4-0,4,0,2,2,4,4,H
1974-08-24,1974,Hull City,West Bromwich Albion,1-0,1,0,2,2,1,1,H
1974-08-24,1974,Manchester United,Millwall,4-0,4,0,2,2,4,4,H
1974-08-24,1974,Notts County,Oldham Athletic,1-0,1,0,2,2,1,1,H
1974-08-24,1974,Oxford United,York City,3-1,3,1,2,2,4,2,H
1974-08-24,1974,Portsmouth,Nottingham Forest,2-0,2,0,2,2,2,2,H
1974-08-24,1974,Sheffield Wednesday,Bristol Rovers,1-1,1,1,2,2,2,0,D
1974-08-24,1974,Sunderland,Southampton,3-1,3,1,2,2,4,2,H
1974-08-27,1974,Leyton Orient,Blackpool,0-0,0,0,2,2,0,0,D
1974-08-27,1974,Nottingham Forest,Millwall,2-1,2,1,2,2,3,1,H
1974-08-27,1974,Southampton,Norwich City,1-1,1,1,2,2,2,0,D
1974-08-27,1974,York City,Cardiff City,1-0,1,0,2,2,1,1,H
1974-08-28,1974,Aston Villa,Hull City,6-0,6,0,2,2,6,6,H
1974-08-28,1974,Fulham,Notts County,3-0,3,0,2,2,3,3,H
1974-08-28,1974,Manchester United,Portsmouth,2-1,2,1,2,2,3,1,H
1974-08-31,1974,Bolton Wanderers,Aston Villa,1-0,1,0,2,2,1,1,H
1974-08-31,1974,Bristol Rovers,Hull City,2-0,2,0,2,2,2,2,H
1974-08-31,1974,Cardiff City,Manchester United,0-1,0,1,2,2,1,-1,A
1974-08-31,1974,Leyton Orient,Portsmouth,1-1,1,1,2,2,2,0,D
1974-08-31,1974,Millwall,Fulham,2-0,2,0,2,2,2,2,H
1974-08-31,1974,Norwich City,Sheffield Wednesday,1-1,1,1,2,2,2,0,D
1974-08-31,1974,Nottingham Forest,Oxford United,1-2,1,2,2,2,3,-1,A
1974-08-31,1974,Oldham Athletic,Bristol City,2-0,2,0,2,2,2,2,H
1974-08-31,1974,Southampton,Blackpool,1-1,1,1,2,2,2,0,D
1974-08-31,1974,West Bromwich Albion,Sunderland,1-0,1,0,2,2,1,1,H
1974-08-31,1974,York City,Notts County,2-2,2,2,2,2,4,0,D
1974-09-07,1974,Aston Villa,Leyton Orient,3-1,3,1,2,2,4,2,H
1974-09-07,1974,Blackpool,Millwall,1-0,1,0,2,2,1,1,H
1974-09-07,1974,Bristol City,Bolton Wanderers,2-1,2,1,2,2,3,1,H
1974-09-07,1974,Fulham,York City,0-2,0,2,2,2,2,-2,A
1974-09-07,1974,Hull City,Norwich City,0-0,0,0,2,2,0,0,D
1974-09-07,1974,Manchester United,Nottingham Forest,2-2,2,2,2,2,4,0,D
1974-09-07,1974,Notts County,Southampton,3-2,3,2,2,2,5,1,H
1974-09-07,1974,Oxford United,Oldham Athletic,1-0,1,0,2,2,1,1,H
1974-09-07,1974,Portsmouth,West Bromwich Albion,1-3,1,3,2,2,4,-2,A
1974-09-07,1974,Sheffield Wednesday,Cardiff City,1-2,1,2,2,2,3,-1,A
1974-09-07,1974,Sunderland,Bristol Rovers,5-1,5,1,2,2,6,4,H
1974-09-14,1974,Bolton Wanderers,Sheffield Wednesday,0-1,0,1,2,2,1,-1,A
1974-09-14,1974,Bristol Rovers,Aston Villa,2-0,2,0,2,2,2,2,H
1974-09-14,1974,Cardiff City,Bristol City,0-1,0,1,2,2,1,-1,A
1974-09-14,1974,Leyton Orient,Fulham,0-0,0,0,2,2,0,0,D
1974-09-14,1974,Millwall,Oxford United,0-0,0,0,2,2,0,0,D
1974-09-14,1974,Norwich City,Notts County,3-0,3,0,2,2,3,3,H
1974-09-14,1974,Nottingham Forest,Hull City,4-0,4,0,2,2,4,4,H
1974-09-14,1974,Oldham Athletic,Blackpool,1-0,1,0,2,2,1,1,H
1974-09-14,1974,Southampton,Portsmouth,2-1,2,1,2,2,3,1,H
1974-09-14,1974,West Bromwich Albion,Manchester United,1-1,1,1,2,2,2,0,D
1974-09-14,1974,York City,Sunderland,0-1,0,1,2,2,1,-1,A
1974-09-16,1974,Millwall,Manchester United,0-1,0,1,2,2,1,-1,A
1974-09-17,1974,Bristol Rovers,Sheffield Wednesday,1-1,1,1,2,2,2,0,D
1974-09-17,1974,Nottingham Forest,Portsmouth,1-2,1,2,2,2,3,-1,A
1974-09-17,1974,York City,Oxford United,1-1,1,1,2,2,2,0,D
1974-09-18,1974,West Bromwich Albion,Hull City,2-2,2,2,2,2,4,0,D
1974-09-21,1974,Aston Villa,Millwall,3-0,3,0,2,2,3,3,H
1974-09-21,1974,Blackpool,York City,1-1,1,1,2,2,2,0,D
1974-09-21,1974,Bristol City,Southampton,2-0,2,0,2,2,2,2,H
1974-09-21,1974,Fulham,Norwich City,4-0,4,0,2,2,4,4,H
1974-09-21,1974,Hull City,Oldham Athletic,1-1,1,1,2,2,2,0,D
1974-09-21,1974,Manchester United,Bristol Rovers,2-0,2,0,2,2,2,2,H
1974-09-21,1974,Notts County,West Bromwich Albion,0-0,0,0,2,2,0,0,D
1974-09-21,1974,Oxford United,Leyton Orient,1-2,1,2,2,2,3,-1,A
1974-09-21,1974,Portsmouth,Cardiff City,2-2,2,2,2,2,4,0,D
1974-09-21,1974,Sheffield Wednesday,Nottingham Forest,2-3,2,3,2,2,5,-1,A
1974-09-21,1974,Sunderland,Bolton Wanderers,0-0,0,0,2,2,0,0,D
1974-09-24,1974,Blackpool,Cardiff City,4-0,4,0,2,2,4,4,H
1974-09-24,1974,Bristol City,York City,0-0,0,0,2,2,0,0,D
1974-09-24,1974,Hull City,Millwall,1-1,1,1,2,2,2,0,D
1974-09-24,1974,Notts County,Leyton Orient,1-1,1,1,2,2,2,0,D
1974-09-24,1974,Portsmouth,Oldham Athletic,1-1,1,1,2,2,2,0,D
1974-09-24,1974,Sunderland,Norwich City,0-0,0,0,2,2,0,0,D
1974-09-25,1974,Fulham,Bristol Rovers,0-0,0,0,2,2,0,0,D
1974-09-25,1974,Manchester United,Bolton Wanderers,3-0,3,0,2,2,3,3,H
1974-09-25,1974,Oxford United,Southampton,0-4,0,4,2,2,4,-4,A
1974-09-25,1974,Sheffield Wednesday,West Bromwich Albion,0-0,0,0,2,2,0,0,D
1974-09-28,1974,Bolton Wanderers,Notts County,1-1,1,1,2,2,2,0,D
1974-09-28,1974,Bristol Rovers,Blackpool,1-3,1,3,2,2,4,-2,A
1974-09-28,1974,Cardiff City,Hull City,1-2,1,2,2,2,3,-1,A
1974-09-28,1974,Leyton Orient,Sheffield Wednesday,1-0,1,0,2,2,1,1,H
1974-09-28,1974,Millwall,Bristol City,1-0,1,0,2,2,1,1,H
1974-09-28,1974,Norwich City,Manchester United,2-0,2,0,2,2,2,2,H
1974-09-28,1974,Nottingham Forest,Sunderland,1-1,1,1,2,2,2,0,D
1974-09-28,1974,Oldham Athletic,Fulham,1-0,1,0,2,2,1,1,H
1974-09-28,1974,Southampton,Aston Villa,0-0,0,0,2,2,0,0,D
1974-09-28,1974,West Bromwich Albion,Oxford United,3-0,3,0,2,2,3,3,H
1974-09-28,1974,York City,Portsmouth,3-0,3,0,2,2,3,3,H
1974-10-02,1974,Aston Villa,Nottingham Forest,3-0,3,0,2,2,3,3,H
1974-10-02,1974,Sheffield Wednesday,Sunderland,0-2,0,2,2,2,2,-2,A
1974-10-05,1974,Blackpool,Hull City,1-2,1,2,2,2,3,-1,A
1974-10-05,1974,Bolton Wanderers,Leyton Orient,2-0,2,0,2,2,2,2,H
1974-10-05,1974,Bristol Rovers,Cardiff City,1-0,1,0,2,2,1,1,H
1974-10-05,1974,Fulham,Manchester United,1-2,1,2,2,2,3,-1,A
1974-10-05,1974,Norwich City,Millwall,2-0,2,0,2,2,2,2,H
1974-10-05,1974,Notts County,Portsmouth,1-1,1,1,2,2,2,0,D
1974-10-05,1974,Oldham Athletic,Aston Villa,1-2,1,2,2,2,3,-1,A
1974-10-05,1974,Sheffield Wednesday,Bristol City,1-1,1,1,2,2,2,0,D
1974-10-05,1974,Southampton,Nottingham Forest,0-1,0,1,2,2,1,-1,A
1974-10-05,1974,Sunderland,Oxford United,2-0,2,0,2,2,2,2,H
1974-10-05,1974,West Bromwich Albion,York City,2-0,2,0,2,2,2,2,H
1974-10-12,1974,Aston Villa,Blackpool,1-0,1,0,2,2,1,1,H
1974-10-12,1974,Bristol City,Sunderland,1-1,1,1,2,2,2,0,D
1974-10-12,1974,Cardiff City,West Bromwich Albion,0-2,0,2,2,2,2,-2,A
1974-10-12,1974,Hull City,Bolton Wanderers,2-0,2,0,2,2,2,2,H
1974-10-12,1974,Leyton Orient,Oldham Athletic,3-1,3,1,2,2,4,2,H
1974-10-12,1974,Manchester United,Notts County,1-0,1,0,2,2,1,1,H
1974-10-12,1974,Millwall,Southampton,4-0,4,0,2,2,4,4,H
1974-10-12,1974,Nottingham Forest,Norwich City,1-3,1,3,2,2,4,-2,A
1974-10-12,1974,Oxford United,Sheffield Wednesday,1-0,1,0,2,2,1,1,H
1974-10-12,1974,Portsmouth,Fulham,0-0,0,0,2,2,0,0,D
1974-10-12,1974,York City,Bristol Rovers,3-0,3,0,2,2,3,3,H
1974-10-15,1974,Oldham Athletic,Notts County,1-0,1,0,2,2,1,1,H
1974-10-15,1974,Portsmouth,Manchester United,0-0,0,0,2,2,0,0,D
1974-10-15,1974,Sunderland,Sheffield Wednesday,3-0,3,0,2,2,3,3,H
1974-10-16,1974,Cardiff City,York City,3-2,3,2,2,2,5,1,H
1974-10-19,1974,Blackpool,Manchester United,0-3,0,3,2,2,3,-3,A
1974-10-19,1974,Bolton Wanderers,Cardiff City,2-1,2,1,2,2,3,1,H
1974-10-19,1974,Bristol Rovers,Millwall,2-0,2,0,2,2,2,2,H
1974-10-19,1974,Fulham,Bristol City,1-1,1,1,2,2,2,0,D
1974-10-19,1974,Norwich City,Portsmouth,2-0,2,0,2,2,2,2,H
1974-10-19,1974,Notts County,Oxford United,4-1,4,1,2,2,5,3,H
1974-10-19,1974,Oldham Athletic,York City,2-3,2,3,2,2,5,-1,A
1974-10-19,1974,Sheffield Wednesday,Hull City,2-1,2,1,2,2,3,1,H
1974-10-19,1974,Southampton,Leyton Orient,4-2,4,2,2,2,6,2,H
1974-10-19,1974,Sunderland,Aston Villa,0-0,0,0,2,2,0,0,D
1974-10-19,1974,West Bromwich Albion,Nottingham Forest,0-1,0,1,2,2,1,-1,A
1974-10-22,1974,Bolton Wanderers,Blackpool,0-0,0,0,2,2,0,0,D
1974-10-22,1974,Bristol Rovers,West Bromwich Albion,2-1,2,1,2,2,3,1,H
1974-10-23,1974,Oxford United,Bristol City,2-0,2,0,2,2,2,2,H
1974-10-26,1974,Aston Villa,Sheffield Wednesday,3-1,3,1,2,2,4,2,H
1974-10-26,1974,Bristol City,Notts County,3-0,3,0,2,2,3,3,H
1974-10-26,1974,Cardiff City,Oldham Athletic,3-1,3,1,2,2,4,2,H
1974-10-26,1974,Hull City,Sunderland,3-1,3,1,2,2,4,2,H
1974-10-26,1974,Leyton Orient,Norwich City,0-3,0,3,2,2,3,-3,A
1974-10-26,1974,Manchester United,Southampton,1-0,1,0,2,2,1,1,H
1974-10-26,1974,Millwall,West Bromwich Albion,2-2,2,2,2,2,4,0,D
1974-10-26,1974,Nottingham Forest,Bristol Rovers,1-0,1,0,2,2,1,1,H
1974-10-26,1974,Oxford United,Fulham,2-1,2,1,2,2,3,1,H
1974-10-26,1974,Portsmouth,Blackpool,0-0,0,0,2,2,0,0,D
1974-10-26,1974,York City,Bolton Wanderers,1-3,1,3,2,2,4,-2,A
1974-11-01,1974,York City,Leyton Orient,0-1,0,1,2,2,1,-1,A
1974-11-02,1974,Blackpool,Sheffield Wednesday,3-1,3,1,2,2,4,2,H
1974-11-02,1974,Bolton Wanderers,Nottingham Forest,2-0,2,0,2,2,2,2,H
1974-11-02,1974,Bristol Rovers,Southampton,0-1,0,1,2,2,1,-1,A
1974-11-02,1974,Cardiff City,Sunderland,2-0,2,0,2,2,2,2,H
1974-11-02,1974,Fulham,Aston Villa,3-1,3,1,2,2,4,2,H
1974-11-02,1974,Manchester United,Oxford United,4-0,4,0,2,2,4,4,H
1974-11-02,1974,Notts County,Hull City,5-0,5,0,2,2,5,5,H
1974-11-02,1974,Oldham Athletic,Millwall,1-1,1,1,2,2,2,0,D
1974-11-02,1974,Portsmouth,Bristol City,0-1,0,1,2,2,1,-1,A
1974-11-02,1974,West Bromwich Albion,Norwich City,1-1,1,1,2,2,2,0,D
1974-11-05,1974,Bristol City,Oxford United,3-0,3,0,2,2,3,3,H
1974-11-06,1974,West Bromwich Albion,Bristol Rovers,2-2,2,2,2,2,4,0,D
1974-11-09,1974,Aston Villa,Notts County,0-1,0,1,2,2,1,-1,A
1974-11-09,1974,Bristol City,Manchester United,1-0,1,0,2,2,1,1,H
1974-11-09,1974,Hull City,Fulham,2-1,2,1,2,2,3,1,H
1974-11-09,1974,Leyton Orient,Cardiff City,1-1,1,1,2,2,2,0,D
1974-11-09,1974,Millwall,Bolton Wanderers,1-1,1,1,2,2,2,0,D
1974-11-09,1974,Norwich City,Bristol Rovers,0-1,0,1,2,2,1,-1,A
1974-11-09,1974,Nottingham Forest,Oldham Athletic,1-0,1,0,2,2,1,1,H
1974-11-09,1974,Oxford United,Portsmouth,1-0,1,0,2,2,1,1,H
1974-11-09,1974,Sheffield Wednesday,York City,3-0,3,0,2,2,3,3,H
1974-11-09,1974,Southampton,West Bromwich Albion,1-0,1,0,2,2,1,1,H
1974-11-09,1974,Sunderland,Blackpool,1-0,1,0,2,2,1,1,H
1974-11-12,1974,Bolton Wanderers,Oldham Athletic,1-1,1,1,2,2,2,0,D
1974-11-16,1974,Blackpool,Oxford United,0-0,0,0,2,2,0,0,D
1974-11-16,1974,Bolton Wanderers,Southampton,3-2,3,2,2,2,5,1,H
1974-11-16,1974,Bristol Rovers,Leyton Orient,0-0,0,0,2,2,0,0,D
1974-11-16,1974,Cardiff City,Nottingham Forest,2-1,2,1,2,2,3,1,H
1974-11-16,1974,Fulham,Sunderland,1-3,1,3,2,2,4,-2,A
1974-11-16,1974,Manchester United,Aston Villa,2-1,2,1,2,2,3,1,H
1974-11-16,1974,Notts County,Sheffield Wednesday,3-3,3,3,2,2,6,0,D
1974-11-16,1974,Oldham Athletic,Norwich City,2-2,2,2,2,2,4,0,D
1974-11-16,1974,Portsmouth,Hull City,1-1,1,1,2,2,2,0,D
1974-11-16,1974,West Bromwich Albion,Bristol City,1-0,1,0,2,2,1,1,H
1974-11-16,1974,York City,Millwall,2-1,2,1,2,2,3,1,H
1974-11-23,1974,Aston Villa,Portsmouth,2-0,2,0,2,2,2,2,H
1974-11-23,1974,Bristol City,Blackpool,0-1,0,1,2,2,1,-1,A
1974-11-23,1974,Hull City,Manchester United,2-0,2,0,2,2,2,2,H
1974-11-23,1974,Leyton Orient,West Bromwich Albion,0-2,0,2,2,2,2,-2,A
1974-11-23,1974,Norwich City,Bolton Wanderers,2-0,2,0,2,2,2,2,H
1974-11-23,1974,Nottingham Forest,York City,2-1,2,1,2,2,3,1,H
1974-11-23,1974,Oxford United,Bristol Rovers,2-1,2,1,2,2,3,1,H
1974-11-23,1974,Sheffield Wednesday,Fulham,1-0,1,0,2,2,1,1,H
1974-11-23,1974,Sunderland,Notts County,3-0,3,0,2,2,3,3,H
1974-11-29,1974,Aston Villa,Oxford United,0-0,0,0,2,2,0,0,D
1974-11-29,1974,Cardiff City,Southampton,2-2,2,2,2,2,4,0,D
1974-11-30,1974,Bristol Rovers,Bolton Wanderers,1-0,1,0,2,2,1,1,H
1974-11-30,1974,Fulham,Blackpool,1-0,1,0,2,2,1,1,H
1974-11-30,1974,Hull City,Bristol City,1-0,1,0,2,2,1,1,H
1974-11-30,1974,Leyton Orient,Nottingham Forest,1-1,1,1,2,2,2,0,D
1974-11-30,1974,Manchester United,Sunderland,3-2,3,2,2,2,5,1,H
1974-11-30,1974,Notts County,Millwall,2-1,2,1,2,2,3,1,H
1974-11-30,1974,Portsmouth,Sheffield Wednesday,1-0,1,0,2,2,1,1,H
1974-11-30,1974,West Bromwich Albion,Oldham Athletic,1-0,1,0,2,2,1,1,H
1974-11-30,1974,York City,Norwich City,1-0,1,0,2,2,1,1,H
1974-12-07,1974,Blackpool,Notts County,3-1,3,1,2,2,4,2,H
1974-12-07,1974,Bolton Wanderers,West Bromwich Albion,0-1,0,1,2,2,1,-1,A
1974-12-07,1974,Bristol City,Aston Villa,1-0,1,0,2,2,1,1,H
1974-12-07,1974,Millwall,Leyton Orient,1-1,1,1,2,2,2,0,D
1974-12-07,1974,Norwich City,Cardiff City,1-1,1,1,2,2,2,0,D
1974-12-07,1974,Nottingham Forest,Fulham,1-1,1,1,2,2,2,0,D
1974-12-07,1974,Oldham Athletic,Bristol Rovers,3-4,3,4,2,2,7,-1,A
1974-12-07,1974,Oxford United,Hull City,3-1,3,1,2,2,4,2,H
1974-12-07,1974,Sheffield Wednesday,Manchester United,4-4,4,4,2,2,8,0,D
1974-12-07,1974,Southampton,York City,2-1,2,1,2,2,3,1,H
1974-12-07,1974,Sunderland,Portsmouth,4-1,4,1,2,2,5,3,H
1974-12-11,1974,Cardiff City,Fulham,0-0,0,0,2,2,0,0,D
1974-12-14,1974,Aston Villa,York City,4-0,4,0,2,2,4,4,H
1974-12-14,1974,Blackpool,Norwich City,2-1,2,1,2,2,3,1,H
1974-12-14,1974,Bristol City,Nottingham Forest,1-0,1,0,2,2,1,1,H
1974-12-14,1974,Fulham,West Bromwich Albion,1-0,1,0,2,2,1,1,H
1974-12-14,1974,Hull City,Southampton,1-1,1,1,2,2,2,0,D
1974-12-14,1974,Manchester United,Leyton Orient,0-0,0,0,2,2,0,0,D
1974-12-14,1974,Notts County,Bristol Rovers,3-2,3,2,2,2,5,1,H
1974-12-14,1974,Oxford United,Cardiff City,1-0,1,0,2,2,1,1,H
1974-12-14,1974,Portsmouth,Bolton Wanderers,2-0,2,0,2,2,2,2,H
1974-12-14,1974,Sheffield Wednesday,Oldham Athletic,1-1,1,1,2,2,2,0,D
1974-12-14,1974,Sunderland,Millwall,2-0,2,0,2,2,2,2,H
1974-12-21,1974,Bolton Wanderers,Oxford United,3-1,3,1,2,2,4,2,H
1974-12-21,1974,Bristol Rovers,Portsmouth,0-1,0,1,2,2,1,-1,A
1974-12-21,1974,Cardiff City,Notts County,0-0,0,0,2,2,0,0,D
1974-12-21,1974,Leyton Orient,Hull City,0-0,0,0,2,2,0,0,D
1974-12-21,1974,Millwall,Sheffield Wednesday,2-1,2,1,2,2,3,1,H
1974-12-21,1974,Norwich City,Bristol City,3-2,3,2,2,2,5,1,H
1974-12-21,1974,Nottingham Forest,Blackpool,0-0,0,0,2,2,0,0,D
1974-12-21,1974,Oldham Athletic,Sunderland,0-0,0,0,2,2,0,0,D
1974-12-21,1974,Southampton,Fulham,0-0,0,0,2,2,0,0,D
1974-12-21,1974,West Bromwich Albion,Aston Villa,2-0,2,0,2,2,2,2,H
1974-12-21,1974,York City,Manchester United,0-1,0,1,2,2,1,-1,A
1974-12-26,1974,Aston Villa,Bristol Rovers,1-0,1,0,2,2,1,1,H
1974-12-26,1974,Blackpool,Oldham Athletic,1-0,1,0,2,2,1,1,H
1974-12-26,1974,Bristol City,Cardiff City,0-0,0,0,2,2,0,0,D
1974-12-26,1974,Fulham,Leyton Orient,0-0,0,0,2,2,0,0,D
1974-12-26,1974,Hull City,Nottingham Forest,1-3,1,3,2,2,4,-2,A
1974-12-26,1974,Manchester United,West Bromwich Albion,2-1,2,1,2,2,3,1,H
1974-12-26,1974,Notts County,Norwich City,1-1,1,1,2,2,2,0,D
1974-12-26,1974,Oxford United,Millwall,3-1,3,1,2,2,4,2,H
1974-12-26,1974,Portsmouth,Southampton,1-2,1,2,2,2,3,-1,A
1974-12-26,1974,Sheffield Wednesday,Bolton Wanderers,0-2,0,2,2,2,2,-2,A
1974-12-26,1974,Sunderland,York City,2-0,2,0,2,2,2,2,H
1974-12-28,1974,Bolton Wanderers,Fulham,0-0,0,0,2,2,0,0,D
1974-12-28,1974,Bristol Rovers,Bristol City,1-4,1,4,2,2,5,-3,A
1974-12-28,1974,Cardiff City,Aston Villa,3-1,3,1,2,2,4,2,H
1974-12-28,1974,Leyton Orient,Sunderland,1-1,1,1,2,2,2,0,D
1974-12-28,1974,Millwall,Portsmouth,0-0,0,0,2,2,0,0,D
1974-12-28,1974,Norwich City,Oxford United,1-0,1,0,2,2,1,1,H
1974-12-28,1974,Nottingham Forest,Notts County,0-2,0,2,2,2,2,-2,A
1974-12-28,1974,Oldham Athletic,Manchester United,1-0,1,0,2,2,1,1,H
1974-12-28,1974,Southampton,Sheffield Wednesday,0-1,0,1,2,2,1,-1,A
1974-12-28,1974,West Bromwich Albion,Blackpool,2-0,2,0,2,2,2,2,H
1974-12-28,1974,York City,Hull City,3-0,3,0,2,2,3,3,H
1975-01-10,1974,York City,Southampton,1-1,1,1,2,2,2,0,D
1975-01-11,1974,Aston Villa,Bristol City,2-0,2,0,2,2,2,2,H
1975-01-11,1974,Bristol Rovers,Oldham Athletic,2-1,2,1,2,2,3,1,H
1975-01-11,1974,Cardiff City,Norwich City,2-1,2,1,2,2,3,1,H
1975-01-11,1974,Fulham,Nottingham Forest,0-1,0,1,2,2,1,-1,A
1975-01-11,1974,Hull City,Oxford United,1-0,1,0,2,2,1,1,H
1975-01-11,1974,Leyton Orient,Millwall,2-1,2,1,2,2,3,1,H
1975-01-11,1974,Manchester United,Sheffield Wednesday,2-0,2,0,2,2,2,2,H
1975-01-11,1974,Notts County,Blackpool,0-0,0,0,2,2,0,0,D
1975-01-11,1974,Portsmouth,Sunderland,4-2,4,2,2,2,6,2,H
1975-01-14,1974,Southampton,Sunderland,1-1,1,1,2,2,2,0,D
1975-01-18,1974,Blackpool,Fulham,1-0,1,0,2,2,1,1,H
1975-01-18,1974,Bolton Wanderers,Bristol Rovers,5-1,5,1,2,2,6,4,H
1975-01-18,1974,Bristol City,Hull City,2-0,2,0,2,2,2,2,H
1975-01-18,1974,Millwall,Notts County,3-0,3,0,2,2,3,3,H
1975-01-18,1974,Norwich City,York City,2-3,2,3,2,2,5,-1,A
1975-01-18,1974,Nottingham Forest,Leyton Orient,2-2,2,2,2,2,4,0,D
1975-01-18,1974,Oldham Athletic,West Bromwich Albion,0-0,0,0,2,2,0,0,D
1975-01-18,1974,Oxford United,Aston Villa,1-2,1,2,2,2,3,-1,A
1975-01-18,1974,Sheffield Wednesday,Portsmouth,0-2,0,2,2,2,2,-2,A
1975-01-18,1974,Sunderland,Manchester United,0-0,0,0,2,2,0,0,D
1975-01-25,1974,Millwall,Cardiff City,5-1,5,1,2,2,6,4,H
1975-01-25,1974,Oxford United,Norwich City,2-1,2,1,2,2,3,1,H
1975-01-25,1974,Southampton,Oldham Athletic,1-0,1,0,2,2,1,1,H
1975-01-31,1974,York City,Sheffield Wednesday,3-0,3,0,2,2,3,3,H
1975-02-01,1974,Blackpool,Sunderland,3-2,3,2,2,2,5,1,H
1975-02-01,1974,Bolton Wanderers,Millwall,2-0,2,0,2,2,2,2,H
1975-02-01,1974,Bristol Rovers,Norwich City,0-2,0,2,2,2,2,-2,A
1975-02-01,1974,Cardiff City,Leyton Orient,0-0,0,0,2,2,0,0,D
1975-02-01,1974,Fulham,Hull City,1-1,1,1,2,2,2,0,D
1975-02-01,1974,Manchester United,Bristol City,0-1,0,1,2,2,1,-1,A
1975-02-01,1974,Notts County,Aston Villa,1-3,1,3,2,2,4,-2,A
1975-02-01,1974,Oldham Athletic,Nottingham Forest,2-0,2,0,2,2,2,2,H
1975-02-01,1974,Portsmouth,Oxford United,2-1,2,1,2,2,3,1,H
1975-02-01,1974,West Bromwich Albion,Southampton,0-3,0,3,2,2,3,-3,A
1975-02-04,1974,Oldham Athletic,Bolton Wanderers,1-0,1,0,2,2,1,1,H
1975-02-08,1974,Aston Villa,Fulham,1-1,1,1,2,2,2,0,D
1975-02-08,1974,Bristol City,Portsmouth,3-1,3,1,2,2,4,2,H
1975-02-08,1974,Hull City,Notts County,1-0,1,0,2,2,1,1,H
1975-02-08,1974,Leyton Orient,York City,1-0,1,0,2,2,1,1,H
1975-02-08,1974,Millwall,Oldham Athletic,0-0,0,0,2,2,0,0,D
1975-02-08,1974,Norwich City,West Bromwich Albion,3-2,3,2,2,2,5,1,H
1975-02-08,1974,Nottingham Forest,Bolton Wanderers,2-3,2,3,2,2,5,-1,A
1975-02-08,1974,Oxford United,Manchester United,1-0,1,0,2,2,1,1,H
1975-02-08,1974,Sheffield Wednesday,Blackpool,0-0,0,0,2,2,0,0,D
1975-02-08,1974,Southampton,Bristol Rovers,3-0,3,0,2,2,3,3,H
1975-02-08,1974,Sunderland,Cardiff City,3-1,3,1,2,2,4,2,H
1975-02-14,1974,Cardiff City,Millwall,0-1,0,1,2,2,1,-1,A
1975-02-14,1974,York City,Nottingham Forest,1-1,1,1,2,2,2,0,D
1975-02-15,1974,Blackpool,Bristol City,2-0,2,0,2,2,2,2,H
1975-02-15,1974,Bolton Wanderers,Norwich City,0-0,0,0,2,2,0,0,D
1975-02-15,1974,Bristol Rovers,Oxford United,1-0,1,0,2,2,1,1,H
1975-02-15,1974,Manchester United,Hull City,2-0,2,0,2,2,2,2,H
1975-02-15,1974,Notts County,Sunderland,0-0,0,0,2,2,0,0,D
1975-02-15,1974,Oldham Athletic,Southampton,1-1,1,1,2,2,2,0,D
1975-02-15,1974,West Bromwich Albion,Leyton Orient,1-0,1,0,2,2,1,1,H
1975-02-18,1974,Portsmouth,Aston Villa,2-3,2,3,2,2,5,-1,A
1975-02-22,1974,Aston Villa,Manchester United,2-0,2,0,2,2,2,2,H
1975-02-22,1974,Bristol City,West Bromwich Albion,2-1,2,1,2,2,3,1,H
1975-02-22,1974,Hull City,Portsmouth,0-0,0,0,2,2,0,0,D
1975-02-22,1974,Leyton Orient,Bristol Rovers,1-0,1,0,2,2,1,1,H
1975-02-22,1974,Millwall,York City,1-3,1,3,2,2,4,-2,A
1975-02-22,1974,Norwich City,Oldham Athletic,1-0,1,0,2,2,1,1,H
1975-02-22,1974,Nottingham Forest,Cardiff City,0-0,0,0,2,2,0,0,D
1975-02-22,1974,Oxford United,Blackpool,0-0,0,0,2,2,0,0,D
1975-02-22,1974,Sheffield Wednesday,Notts County,0-1,0,1,2,2,1,-1,A
1975-02-22,1974,Southampton,Bolton Wanderers,0-1,0,1,2,2,1,-1,A
1975-02-22,1974,Sunderland,Fulham,1-2,1,2,2,2,3,-1,A
1975-02-25,1974,Fulham,Sheffield Wednesday,2-1,2,1,2,2,3,1,H
1975-02-28,1974,Oxford United,Nottingham Forest,1-1,1,1,2,2,2,0,D
1975-02-28,1974,Portsmouth,Leyton Orient,3-0,3,0,2,2,3,3,H
1975-03-01,1974,Blackpool,Southampton,3-0,3,0,2,2,3,3,H
1975-03-01,1974,Bristol City,Oldham Athletic,3-1,3,1,2,2,4,2,H
1975-03-01,1974,Hull City,Bristol Rovers,2-0,2,0,2,2,2,2,H
1975-03-01,1974,Manchester United,Cardiff City,4-0,4,0,2,2,4,4,H
1975-03-01,1974,Notts County,York City,2-1,2,1,2,2,3,1,H
1975-03-01,1974,Sunderland,West Bromwich Albion,3-0,3,0,2,2,3,3,H
1975-03-04,1974,Fulham,Millwall,0-0,0,0,2,2,0,0,D
1975-03-05,1974,Aston Villa,Bolton Wanderers,0-0,0,0,2,2,0,0,D
1975-03-08,1974,Bolton Wanderers,Manchester United,0-1,0,1,2,2,1,-1,A
1975-03-08,1974,Cardiff City,Blackpool,1-1,1,1,2,2,2,0,D
1975-03-08,1974,Leyton Orient,Notts County,0-1,0,1,2,2,1,-1,A
1975-03-08,1974,Millwall,Hull City,2-0,2,0,2,2,2,2,H
1975-03-08,1974,Norwich City,Sunderland,0-0,0,0,2,2,0,0,D
1975-03-08,1974,Nottingham Forest,Aston Villa,2-3,2,3,2,2,5,-1,A
1975-03-08,1974,Oldham Athletic,Portsmouth,2-0,2,0,2,2,2,2,H
1975-03-08,1974,West Bromwich Albion,Sheffield Wednesday,4-0,4,0,2,2,4,4,H
1975-03-08,1974,York City,Bristol City,1-0,1,0,2,2,1,1,H
1975-03-11,1974,Bristol Rovers,Fulham,1-2,1,2,2,2,3,-1,A
1975-03-15,1974,Aston Villa,Southampton,3-0,3,0,2,2,3,3,H
1975-03-15,1974,Blackpool,Bristol Rovers,0-0,0,0,2,2,0,0,D
1975-03-15,1974,Bristol City,Millwall,2-1,2,1,2,2,3,1,H
1975-03-15,1974,Fulham,Oldham Athletic,0-0,0,0,2,2,0,0,D
1975-03-15,1974,Hull City,Cardiff City,1-1,1,1,2,2,2,0,D
1975-03-15,1974,Manchester United,Norwich City,1-1,1,1,2,2,2,0,D
1975-03-15,1974,Notts County,Bolton Wanderers,1-1,1,1,2,2,2,0,D
1975-03-15,1974,Oxford United,West Bromwich Albion,1-1,1,1,2,2,2,0,D
1975-03-15,1974,Portsmouth,York City,1-0,1,0,2,2,1,1,H
1975-03-15,1974,Sheffield Wednesday,Leyton Orient,0-1,0,1,2,2,1,-1,A
1975-03-15,1974,Sunderland,Nottingham Forest,0-0,0,0,2,2,0,0,D
1975-03-18,1974,Southampton,Oxford United,2-1,2,1,2,2,3,1,H
1975-03-22,1974,Bolton Wanderers,Bristol City,0-2,0,2,2,2,2,-2,A
1975-03-22,1974,Bristol Rovers,Sunderland,2-1,2,1,2,2,3,1,H
1975-03-22,1974,Cardiff City,Sheffield Wednesday,0-0,0,0,2,2,0,0,D
1975-03-22,1974,Leyton Orient,Aston Villa,1-0,1,0,2,2,1,1,H
1975-03-22,1974,Millwall,Blackpool,0-0,0,0,2,2,0,0,D
1975-03-22,1974,Norwich City,Hull City,1-0,1,0,2,2,1,1,H
1975-03-22,1974,Nottingham Forest,Manchester United,0-1,0,1,2,2,1,-1,A
1975-03-22,1974,Oldham Athletic,Oxford United,1-1,1,1,2,2,2,0,D
1975-03-22,1974,Southampton,Notts County,3-2,3,2,2,2,5,1,H
1975-03-22,1974,West Bromwich Albion,Portsmouth,2-1,2,1,2,2,3,1,H
1975-03-22,1974,York City,Fulham,3-2,3,2,2,2,5,1,H
1975-03-24,1974,Fulham,Southampton,3-2,3,2,2,2,5,1,H
1975-03-25,1974,Notts County,Nottingham Forest,2-2,2,2,2,2,4,0,D
1975-03-25,1974,Sunderland,Oldham Athletic,2-2,2,2,2,2,4,0,D
1975-03-28,1974,Bristol Rovers,Manchester United,1-1,1,1,2,2,2,0,D
1975-03-28,1974,Fulham,Bolton Wanderers,2-1,2,1,2,2,3,1,H
1975-03-28,1974,Oldham Athletic,Hull City,0-1,0,1,2,2,1,-1,A
1975-03-28,1974,Southampton,Bristol City,0-1,0,1,2,2,1,-1,A
1975-03-28,1974,Sunderland,Leyton Orient,3-0,3,0,2,2,3,3,H
1975-03-29,1974,Aston Villa,West Bromwich Albion,3-1,3,1,2,2,4,2,H
1975-03-29,1974,Blackpool,Nottingham Forest,0-0,0,0,2,2,0,0,D
1975-03-29,1974,Bristol City,Norwich City,0-1,0,1,2,2,1,-1,A
1975-03-29,1974,Hull City,Leyton Orient,0-0,0,0,2,2,0,0,D
1975-03-29,1974,Manchester United,York City,2-1,2,1,2,2,3,1,H
1975-03-29,1974,Notts County,Cardiff City,0-2,0,2,2,2,2,-2,A
1975-03-29,1974,Oxford United,Bolton Wanderers,2-1,2,1,2,2,3,1,H
1975-03-29,1974,Portsmouth,Bristol Rovers,3-0,3,0,2,2,3,3,H
1975-03-29,1974,Sheffield Wednesday,Millwall,0-1,0,1,2,2,1,-1,A
1975-03-31,1974,Blackpool,West Bromwich Albion,2-0,2,0,2,2,2,2,H
1975-03-31,1974,Bolton Wanderers,Sunderland,0-2,0,2,2,2,2,-2,A
1975-03-31,1974,Hull City,York City,2-0,2,0,2,2,2,2,H
1975-03-31,1974,Leyton Orient,Oxford United,1-1,1,1,2,2,2,0,D
1975-03-31,1974,Manchester United,Oldham Athletic,3-2,3,2,2,2,5,1,H
1975-03-31,1974,Norwich City,Fulham,1-2,1,2,2,2,3,-1,A
1975-03-31,1974,Portsmouth,Millwall,1-0,1,0,2,2,1,1,H
1975-03-31,1974,Sheffield Wednesday,Southampton,0-1,0,1,2,2,1,-1,A
1975-04-01,1974,Bristol City,Bristol Rovers,1-1,1,1,2,2,2,0,D
1975-04-01,1974,Millwall,Aston Villa,1-3,1,3,2,2,4,-2,A
1975-04-01,1974,Nottingham Forest,Sheffield Wednesday,1-0,1,0,2,2,1,1,H
1975-04-01,1974,York City,Blackpool,0-0,0,0,2,2,0,0,D
1975-04-02,1974,Cardiff City,Portsmouth,1-0,1,0,2,2,1,1,H
1975-04-02,1974,West Bromwich Albion,Notts County,4-1,4,1,2,2,5,3,H
1975-04-05,1974,Blackpool,Portsmouth,2-2,2,2,2,2,4,0,D
1975-04-05,1974,Bolton Wanderers,York City,1-1,1,1,2,2,2,0,D
1975-04-05,1974,Bristol Rovers,Nottingham Forest,4-2,4,2,2,2,6,2,H
1975-04-05,1974,Norwich City,Leyton Orient,2-0,2,0,2,2,2,2,H
1975-04-05,1974,Notts County,Bristol City,1-2,1,2,2,2,3,-1,A
1975-04-05,1974,Oldham Athletic,Cardiff City,4-0,4,0,2,2,4,4,H
1975-04-05,1974,Southampton,Manchester United,0-1,0,1,2,2,1,-1,A
1975-04-05,1974,Sunderland,Hull City,1-0,1,0,2,2,1,1,H
1975-04-05,1974,West Bromwich Albion,Millwall,2-1,2,1,2,2,3,1,H
1975-04-08,1974,Sheffield Wednesday,Norwich City,0-1,0,1,2,2,1,-1,A
1975-04-08,1974,West Bromwich Albion,Bolton Wanderers,0-1,0,1,2,2,1,-1,A
1975-04-09,1974,Aston Villa,Cardiff City,2-0,2,0,2,2,2,2,H
1975-04-12,1974,Aston Villa,Oldham Athletic,5-0,5,0,2,2,5,5,H
1975-04-12,1974,Bristol City,Sheffield Wednesday,1-0,1,0,2,2,1,1,H
1975-04-12,1974,Cardiff City,Bristol Rovers,2-2,2,2,2,2,4,0,D
1975-04-12,1974,Hull City,Blackpool,1-0,1,0,2,2,1,1,H
1975-04-12,1974,Leyton Orient,Bolton Wanderers,0-0,0,0,2,2,0,0,D
1975-04-12,1974,Manchester United,Fulham,1-0,1,0,2,2,1,1,H
1975-04-12,1974,Millwall,Norwich City,1-1,1,1,2,2,2,0,D
1975-04-12,1974,Nottingham Forest,Southampton,0-0,0,0,2,2,0,0,D
1975-04-12,1974,Oxford United,Sunderland,1-0,1,0,2,2,1,1,H
1975-04-12,1974,Portsmouth,Notts County,1-1,1,1,2,2,2,0,D
1975-04-12,1974,York City,West Bromwich Albion,1-3,1,3,2,2,4,-2,A
1975-04-15,1974,Leyton Orient,Bristol City,1-0,1,0,2,2,1,1,H
1975-04-18,1974,Southampton,Millwall,3-2,3,2,2,2,5,1,H
1975-04-19,1974,Blackpool,Aston Villa,0-3,0,3,2,2,3,-3,A
1975-04-19,1974,Bolton Wanderers,Hull City,1-1,1,1,2,2,2,0,D
1975-04-19,1974,Bristol Rovers,York City,1-3,1,3,2,2,4,-2,A
1975-04-19,1974,Fulham,Portsmouth,2-2,2,2,2,2,4,0,D
1975-04-19,1974,Norwich City,Nottingham Forest,3-0,3,0,2,2,3,3,H
1975-04-19,1974,Notts County,Manchester United,2-2,2,2,2,2,4,0,D
1975-04-19,1974,Oldham Athletic,Leyton Orient,0-0,0,0,2,2,0,0,D
1975-04-19,1974,Sheffield Wednesday,Oxford United,1-1,1,1,2,2,2,0,D
1975-04-19,1974,Sunderland,Bristol City,3-0,3,0,2,2,3,3,H
1975-04-19,1974,West Bromwich Albion,Cardiff City,2-0,2,0,2,2,2,2,H
1975-04-22,1974,Fulham,Oxford United,0-0,0,0,2,2,0,0,D
1975-04-22,1974,Southampton,Cardiff City,2-0,2,0,2,2,2,2,H
1975-04-23,1974,Sheffield Wednesday,Aston Villa,0-4,0,4,2,2,4,-4,A
1975-04-26,1974,Aston Villa,Sunderland,2-0,2,0,2,2,2,2,H
1975-04-26,1974,Bristol City,Fulham,3-1,3,1,2,2,4,2,H
1975-04-26,1974,Cardiff City,Bolton Wanderers,1-2,1,2,2,2,3,-1,A
1975-04-26,1974,Hull City,Sheffield Wednesday,1-0,1,0,2,2,1,1,H
1975-04-26,1974,Leyton Orient,Southampton,2-1,2,1,2,2,3,1,H
1975-04-26,1974,Manchester United,Blackpool,4-0,4,0,2,2,4,4,H
1975-04-26,1974,Millwall,Bristol Rovers,1-1,1,1,2,2,2,0,D
1975-04-26,1974,Nottingham Forest,West Bromwich Albion,2-1,2,1,2,2,3,1,H
1975-04-26,1974,Oxford United,Notts County,1-2,1,2,2,2,3,-1,A
1975-04-26,1974,Portsmouth,Norwich City,0-3,0,3,2,2,3,-3,A
1975-04-26,1974,York City,Oldham Athletic,0-0,0,0,2,2,0,0,D
1975-04-30,1974,Norwich City,Aston Villa,1-4,1,4,2,2,5,-3,A
1975-08-16,1975,Bristol City,Bolton Wanderers,1-0,1,0,2,2,1,1,H
1975-08-16,1975,Carlisle United,Oxford United,1-1,1,1,2,2,2,0,D
1975-08-16,1975,Charlton Athletic,Notts County,1-2,1,2,2,2,3,-1,A
1975-08-16,1975,Fulham,Blackpool,0-0,0,0,2,2,0,0,D
1975-08-16,1975,Leyton Orient,Blackburn Rovers,1-1,1,1,2,2,2,0,D
1975-08-16,1975,Luton Town,Hull City,2-0,2,0,2,2,2,2,H
1975-08-16,1975,Nottingham Forest,Plymouth Argyle,2-0,2,0,2,2,2,2,H
1975-08-16,1975,Oldham Athletic,Bristol Rovers,2-0,2,0,2,2,2,2,H
1975-08-16,1975,Southampton,West Bromwich Albion,3-0,3,0,2,2,3,3,H
1975-08-16,1975,Sunderland,Chelsea,2-1,2,1,2,2,3,1,H
1975-08-16,1975,York City,Portsmouth,2-1,2,1,2,2,3,1,H
1975-08-19,1975,Bristol City,Sunderland,3-0,3,0,2,2,3,3,H
1975-08-19,1975,Hull City,Blackpool,1-0,1,0,2,2,1,1,H
1975-08-19,1975,Leyton Orient,Notts County,1-1,1,1,2,2,2,0,D
1975-08-20,1975,Fulham,Carlisle United,3-0,3,0,2,2,3,3,H
1975-08-20,1975,Oxford United,Bolton Wanderers,2-0,2,0,2,2,2,2,H
1975-08-20,1975,West Bromwich Albion,Chelsea,0-0,0,0,2,2,0,0,D
1975-08-23,1975,Blackburn Rovers,Oldham Athletic,4-1,4,1,2,2,5,3,H
1975-08-23,1975,Blackpool,Leyton Orient,1-0,1,0,2,2,1,1,H
1975-08-23,1975,Bolton Wanderers,Fulham,2-2,2,2,2,2,4,0,D
1975-08-23,1975,Bristol Rovers,York City,2-1,2,1,2,2,3,1,H
1975-08-23,1975,Chelsea,Carlisle United,3-1,3,1,2,2,4,2,H
1975-08-23,1975,Hull City,Bristol City,3-1,3,1,2,2,4,2,H
1975-08-23,1975,Notts County,Southampton,0-0,0,0,2,2,0,0,D
1975-08-23,1975,Oxford United,Sunderland,1-1,1,1,2,2,2,0,D
1975-08-23,1975,Plymouth Argyle,Charlton Athletic,1-0,1,0,2,2,1,1,H
1975-08-23,1975,Portsmouth,Nottingham Forest,1-1,1,1,2,2,2,0,D
1975-08-23,1975,West Bromwich Albion,Luton Town,1-0,1,0,2,2,1,1,H
1975-08-26,1975,Southampton,Bristol City,3-1,3,1,2,2,4,2,H
1975-08-26,1975,Sunderland,Fulham,2-0,2,0,2,2,2,2,H
1975-08-27,1975,Chelsea,Oxford United,3-1,3,1,2,2,4,2,H
1975-08-29,1975,Charlton Athletic,Oxford United,2-1,2,1,2,2,3,1,H
1975-08-29,1975,Leyton Orient,Portsmouth,0-1,0,1,2,2,1,-1,A
1975-08-29,1975,Southampton,Plymouth Argyle,1-0,1,0,2,2,1,1,H
1975-08-30,1975,Bristol City,Bristol Rovers,1-1,1,1,2,2,2,0,D
1975-08-30,1975,Carlisle United,Blackburn Rovers,0-1,0,1,2,2,1,-1,A
1975-08-30,1975,Fulham,West Bromwich Albion,4-0,4,0,2,2,4,4,H
1975-08-30,1975,Luton Town,Chelsea,3-0,3,0,2,2,3,3,H
1975-08-30,1975,Nottingham Forest,Notts County,0-1,0,1,2,2,1,-1,A
1975-08-30,1975,Oldham Athletic,Hull City,1-0,1,0,2,2,1,1,H
1975-08-30,1975,Sunderland,Blackpool,2-0,2,0,2,2,2,2,H
1975-08-30,1975,York City,Bolton Wanderers,1-2,1,2,2,2,3,-1,A
1975-09-06,1975,Blackburn Rovers,Bristol City,1-2,1,2,2,2,3,-1,A
1975-09-06,1975,Blackpool,Oldham Athletic,1-1,1,1,2,2,2,0,D
1975-09-06,1975,Bolton Wanderers,Southampton,3-0,3,0,2,2,3,3,H
1975-09-06,1975,Bristol Rovers,Charlton Athletic,0-0,0,0,2,2,0,0,D
1975-09-06,1975,Chelsea,Nottingham Forest,0-0,0,0,2,2,0,0,D
1975-09-06,1975,Hull City,Leyton Orient,1-0,1,0,2,2,1,1,H
1975-09-06,1975,Notts County,Carlisle United,1-0,1,0,2,2,1,1,H
1975-09-06,1975,Oxford United,Fulham,1-3,1,3,2,2,4,-2,A
1975-09-06,1975,Plymouth Argyle,Sunderland,1-0,1,0,2,2,1,1,H
1975-09-06,1975,Portsmouth,Luton Town,0-2,0,2,2,2,2,-2,A
1975-09-06,1975,West Bromwich Albion,York City,2-2,2,2,2,2,4,0,D
1975-09-12,1975,Bristol City,Oxford United,4-1,4,1,2,2,5,3,H
1975-09-13,1975,Carlisle United,Portsmouth,2-1,2,1,2,2,3,1,H
1975-09-13,1975,Charlton Athletic,Blackpool,1-1,1,1,2,2,2,0,D
1975-09-13,1975,Fulham,Bristol Rovers,0-2,0,2,2,2,2,-2,A
1975-09-13,1975,Leyton Orient,Plymouth Argyle,1-0,1,0,2,2,1,1,H
1975-09-13,1975,Luton Town,Bolton Wanderers,0-2,0,2,2,2,2,-2,A
1975-09-13,1975,Nottingham Forest,Hull City,1-2,1,2,2,2,3,-1,A
1975-09-13,1975,Oldham Athletic,Chelsea,2-1,2,1,2,2,3,1,H
1975-09-13,1975,Southampton,Blackburn Rovers,2-1,2,1,2,2,3,1,H
1975-09-13,1975,Sunderland,West Bromwich Albion,2-0,2,0,2,2,2,2,H
1975-09-13,1975,York City,Notts County,1-2,1,2,2,2,3,-1,A
1975-09-20,1975,Blackburn Rovers,Sunderland,0-1,0,1,2,2,1,-1,A
1975-09-20,1975,Blackpool,Southampton,4-3,4,3,2,2,7,1,H
1975-09-20,1975,Bolton Wanderers,Leyton Orient,1-1,1,1,2,2,2,0,D
1975-09-20,1975,Bristol Rovers,Carlisle United,0-1,0,1,2,2,1,-1,A
1975-09-20,1975,Chelsea,Bristol City,1-1,1,1,2,2,2,0,D
1975-09-20,1975,Hull City,Fulham,1-2,1,2,2,2,3,-1,A
1975-09-20,1975,Notts County,Luton Town,1-0,1,0,2,2,1,1,H
1975-09-20,1975,Oxford United,Nottingham Forest,0-1,0,1,2,2,1,-1,A
1975-09-20,1975,Plymouth Argyle,York City,1-1,1,1,2,2,2,0,D
1975-09-20,1975,Portsmouth,Oldham Athletic,1-1,1,1,2,2,2,0,D
1975-09-20,1975,West Bromwich Albion,Charlton Athletic,1-1,1,1,2,2,2,0,D
1975-09-23,1975,Bristol Rovers,Bolton Wanderers,2-2,2,2,2,2,4,0,D
1975-09-23,1975,Hull City,Notts County,0-2,0,2,2,2,2,-2,A
1975-09-23,1975,Leyton Orient,York City,1-0,1,0,2,2,1,1,H
1975-09-23,1975,Portsmouth,Chelsea,1-1,1,1,2,2,2,0,D
1975-09-23,1975,Sunderland,Carlisle United,3-2,3,2,2,2,5,1,H
1975-09-24,1975,Blackburn Rovers,Blackpool,0-2,0,2,2,2,2,-2,A
1975-09-24,1975,Luton Town,Plymouth Argyle,1-1,1,1,2,2,2,0,D
1975-09-24,1975,Nottingham Forest,Charlton Athletic,1-2,1,2,2,2,3,-1,A
1975-09-26,1975,Charlton Athletic,Hull City,1-0,1,0,2,2,1,1,H
1975-09-26,1975,Leyton Orient,Bristol Rovers,0-0,0,0,2,2,0,0,D
1975-09-27,1975,Bristol City,Blackpool,2-0,2,0,2,2,2,2,H
1975-09-27,1975,Carlisle United,West Bromwich Albion,1-1,1,1,2,2,2,0,D
1975-09-27,1975,Fulham,Chelsea,2-0,2,0,2,2,2,2,H
1975-09-27,1975,Luton Town,Blackburn Rovers,1-1,1,1,2,2,2,0,D
1975-09-27,1975,Nottingham Forest,Bolton Wanderers,1-2,1,2,2,2,3,-1,A
1975-09-27,1975,Oldham Athletic,Plymouth Argyle,3-2,3,2,2,2,5,1,H
1975-09-27,1975,Southampton,Portsmouth,4-0,4,0,2,2,4,4,H
1975-09-27,1975,Sunderland,Notts County,4-0,4,0,2,2,4,4,H
1975-09-27,1975,York City,Oxford United,2-0,2,0,2,2,2,2,H
1975-10-04,1975,Blackburn Rovers,Fulham,0-1,0,1,2,2,1,-1,A
1975-10-04,1975,Blackpool,Luton Town,3-2,3,2,2,2,5,1,H
1975-10-04,1975,Bolton Wanderers,Charlton Athletic,5-0,5,0,2,2,5,5,H
1975-10-04,1975,Bristol Rovers,Nottingham Forest,4-2,4,2,2,2,6,2,H
1975-10-04,1975,Chelsea,York City,0-0,0,0,2,2,0,0,D
1975-10-04,1975,Hull City,Southampton,0-0,0,0,2,2,0,0,D
1975-10-04,1975,Notts County,Bristol City,1-1,1,1,2,2,2,0,D
1975-10-04,1975,Oxford United,Leyton Orient,2-1,2,1,2,2,3,1,H
1975-10-04,1975,Plymouth Argyle,Carlisle United,2-1,2,1,2,2,3,1,H
1975-10-04,1975,Portsmouth,Sunderland,0-0,0,0,2,2,0,0,D
1975-10-04,1975,West Bromwich Albion,Oldham Athletic,1-1,1,1,2,2,2,0,D
1975-10-07,1975,Oldham Athletic,Bristol City,2-4,2,4,2,2,6,-2,A
1975-10-11,1975,Blackburn Rovers,West Bromwich Albion,0-0,0,0,2,2,0,0,D
1975-10-11,1975,Blackpool,Portsmouth,0-0,0,0,2,2,0,0,D
1975-10-11,1975,Bristol City,Charlton Athletic,4-0,4,0,2,2,4,4,H
1975-10-11,1975,Carlisle United,Luton Town,1-1,1,1,2,2,2,0,D
1975-10-11,1975,Fulham,Nottingham Forest,0-0,0,0,2,2,0,0,D
1975-10-11,1975,Hull City,Bristol Rovers,0-0,0,0,2,2,0,0,D
1975-10-11,1975,Notts County,Oxford United,0-1,0,1,2,2,1,-1,A
1975-10-11,1975,Oldham Athletic,York City,2-0,2,0,2,2,2,2,H
1975-10-11,1975,Plymouth Argyle,Bolton Wanderers,2-3,2,3,2,2,5,-1,A
1975-10-11,1975,Southampton,Chelsea,4-1,4,1,2,2,5,3,H
1975-10-11,1975,Sunderland,Leyton Orient,3-1,3,1,2,2,4,2,H
1975-10-18,1975,Bolton Wanderers,Notts County,2-1,2,1,2,2,3,1,H
1975-10-18,1975,Bristol Rovers,Sunderland,1-0,1,0,2,2,1,1,H
1975-10-18,1975,Charlton Athletic,Oldham Athletic,3-1,3,1,2,2,4,2,H
1975-10-18,1975,Chelsea,Blackpool,2-0,2,0,2,2,2,2,H
1975-10-18,1975,Leyton Orient,Carlisle United,1-0,1,0,2,2,1,1,H
1975-10-18,1975,Luton Town,Fulham,1-0,1,0,2,2,1,1,H
1975-10-18,1975,Nottingham Forest,Southampton,3-1,3,1,2,2,4,2,H
1975-10-18,1975,Oxford United,Blackburn Rovers,0-0,0,0,2,2,0,0,D
1975-10-18,1975,Portsmouth,Hull City,1-1,1,1,2,2,2,0,D
1975-10-18,1975,West Bromwich Albion,Plymouth Argyle,1-0,1,0,2,2,1,1,H
1975-10-18,1975,York City,Bristol City,1-4,1,4,2,2,5,-3,A
1975-10-21,1975,Nottingham Forest,Luton Town,0-0,0,0,2,2,0,0,D
1975-10-21,1975,Oldham Athletic,Southampton,3-2,3,2,2,2,5,1,H
1975-10-21,1975,Plymouth Argyle,Blackburn Rovers,2-2,2,2,2,2,4,0,D
1975-10-21,1975,Portsmouth,Bristol Rovers,1-2,1,2,2,2,3,-1,A
1975-10-21,1975,York City,Charlton Athletic,1-3,1,3,2,2,4,-2,A
1975-10-25,1975,Blackburn Rovers,Chelsea,1-1,1,1,2,2,2,0,D
1975-10-25,1975,Blackpool,Bristol Rovers,1-4,1,4,2,2,5,-3,A
1975-10-25,1975,Bristol City,West Bromwich Albion,0-2,0,2,2,2,2,-2,A
1975-10-25,1975,Carlisle United,Charlton Athletic,1-1,1,1,2,2,2,0,D
1975-10-25,1975,Fulham,Leyton Orient,1-1,1,1,2,2,2,0,D
1975-10-25,1975,Hull City,Bolton Wanderers,2-2,2,2,2,2,4,0,D
1975-10-25,1975,Notts County,Portsmouth,2-0,2,0,2,2,2,2,H
1975-10-25,1975,Oldham Athletic,Nottingham Forest,0-0,0,0,2,2,0,0,D
1975-10-25,1975,Plymouth Argyle,Oxford United,2-1,2,1,2,2,3,1,H
1975-10-25,1975,Southampton,York City,2-0,2,0,2,2,2,2,H
1975-10-25,1975,Sunderland,Luton Town,2-0,2,0,2,2,2,2,H
1975-10-31,1975,Charlton Athletic,Southampton,4-1,4,1,2,2,5,3,H
1975-11-01,1975,Bolton Wanderers,Blackpool,1-0,1,0,2,2,1,1,H
1975-11-01,1975,Bristol Rovers,Blackburn Rovers,1-1,1,1,2,2,2,0,D
1975-11-01,1975,Chelsea,Plymouth Argyle,2-2,2,2,2,2,4,0,D
1975-11-01,1975,Leyton Orient,Oldham Athletic,2-0,2,0,2,2,2,2,H
1975-11-01,1975,Luton Town,Bristol City,0-0,0,0,2,2,0,0,D
1975-11-01,1975,Nottingham Forest,Carlisle United,4-0,4,0,2,2,4,4,H
1975-11-01,1975,Oxford United,Hull City,2-3,2,3,2,2,5,-1,A
1975-11-01,1975,Portsmouth,Fulham,0-1,0,1,2,2,1,-1,A
1975-11-01,1975,West Bromwich Albion,Notts County,0-0,0,0,2,2,0,0,D
1975-11-01,1975,York City,Sunderland,1-4,1,4,2,2,5,-3,A
1975-11-04,1975,Blackburn Rovers,Hull City,1-0,1,0,2,2,1,1,H
1975-11-04,1975,Blackpool,Nottingham Forest,1-1,1,1,2,2,2,0,D
1975-11-04,1975,Bolton Wanderers,Portsmouth,4-1,4,1,2,2,5,3,H
1975-11-04,1975,Bristol Rovers,West Bromwich Albion,1-1,1,1,2,2,2,0,D
1975-11-04,1975,Carlisle United,Oldham Athletic,2-1,2,1,2,2,3,1,H
1975-11-04,1975,Luton Town,York City,4-0,4,0,2,2,4,4,H
1975-11-04,1975,Notts County,Plymouth Argyle,1-0,1,0,2,2,1,1,H
1975-11-07,1975,Bristol City,Leyton Orient,0-0,0,0,2,2,0,0,D
1975-11-08,1975,Blackburn Rovers,Bolton Wanderers,1-1,1,1,2,2,2,0,D
1975-11-08,1975,Blackpool,West Bromwich Albion,0-1,0,1,2,2,1,-1,A
1975-11-08,1975,Carlisle United,York City,1-0,1,0,2,2,1,1,H
1975-11-08,1975,Fulham,Charlton Athletic,1-1,1,1,2,2,2,0,D
1975-11-08,1975,Hull City,Chelsea,1-2,1,2,2,2,3,-1,A
1975-11-08,1975,Notts County,Bristol Rovers,1-1,1,1,2,2,2,0,D
1975-11-08,1975,Oldham Athletic,Oxford United,1-1,1,1,2,2,2,0,D
1975-11-08,1975,Plymouth Argyle,Portsmouth,3-1,3,1,2,2,4,2,H
1975-11-08,1975,Southampton,Luton Town,3-1,3,1,2,2,4,2,H
1975-11-08,1975,Sunderland,Nottingham Forest,3-0,3,0,2,2,3,3,H
1975-11-12,1975,Oxford United,West Bromwich Albion,0-1,0,1,2,2,1,-1,A
1975-11-15,1975,Bolton Wanderers,Carlisle United,0-0,0,0,2,2,0,0,D
1975-11-15,1975,Bristol Rovers,Plymouth Argyle,0-0,0,0,2,2,0,0,D
1975-11-15,1975,Charlton Athletic,Sunderland,1-2,1,2,2,2,3,-1,A
1975-11-15,1975,Chelsea,Notts County,2-0,2,0,2,2,2,2,H
1975-11-15,1975,Leyton Orient,Southampton,2-1,2,1,2,2,3,1,H
1975-11-15,1975,Luton Town,Oldham Athletic,2-3,2,3,2,2,5,-1,A
1975-11-15,1975,Nottingham Forest,Bristol City,1-0,1,0,2,2,1,1,H
1975-11-15,1975,Oxford United,Blackpool,1-3,1,3,2,2,4,-2,A
1975-11-15,1975,Portsmouth,Blackburn Rovers,0-1,0,1,2,2,1,-1,A
1975-11-15,1975,West Bromwich Albion,Hull City,2-0,2,0,2,2,2,2,H
1975-11-15,1975,York City,Fulham,1-0,1,0,2,2,1,1,H
1975-11-22,1975,Blackburn Rovers,Oxford United,0-0,0,0,2,2,0,0,D
1975-11-22,1975,Blackpool,Chelsea,0-2,0,2,2,2,2,-2,A
1975-11-22,1975,Bristol City,York City,4-1,4,1,2,2,5,3,H
1975-11-22,1975,Carlisle United,Leyton Orient,1-2,1,2,2,2,3,-1,A
1975-11-22,1975,Fulham,Luton Town,2-0,2,0,2,2,2,2,H
1975-11-22,1975,Hull City,Portsmouth,1-0,1,0,2,2,1,1,H
1975-11-22,1975,Notts County,Bolton Wanderers,1-1,1,1,2,2,2,0,D
1975-11-22,1975,Oldham Athletic,Charlton Athletic,2-0,2,0,2,2,2,2,H
1975-11-22,1975,Plymouth Argyle,West Bromwich Albion,2-1,2,1,2,2,3,1,H
1975-11-22,1975,Southampton,Nottingham Forest,0-3,0,3,2,2,3,-3,A
1975-11-22,1975,Sunderland,Bristol Rovers,1-1,1,1,2,2,2,0,D
1975-11-29,1975,Blackburn Rovers,Charlton Athletic,2-0,2,0,2,2,2,2,H
1975-11-29,1975,Blackpool,Notts County,1-0,1,0,2,2,1,1,H
1975-11-29,1975,Bolton Wanderers,West Bromwich Albion,1-2,1,2,2,2,3,-1,A
1975-11-29,1975,Bristol Rovers,Chelsea,1-2,1,2,2,2,3,-1,A
1975-11-29,1975,Carlisle United,Southampton,1-0,1,0,2,2,1,1,H
1975-11-29,1975,Fulham,Bristol City,1-2,1,2,2,2,3,-1,A
1975-11-29,1975,Hull City,Plymouth Argyle,4-0,4,0,2,2,4,4,H
1975-11-29,1975,Luton Town,Leyton Orient,1-0,1,0,2,2,1,1,H
1975-11-29,1975,Nottingham Forest,York City,1-0,1,0,2,2,1,1,H
1975-11-29,1975,Portsmouth,Oxford United,0-2,0,2,2,2,2,-2,A
1975-11-29,1975,Sunderland,Oldham Athletic,2-0,2,0,2,2,2,2,H
1975-12-03,1975,Charlton Athletic,Luton Town,1-5,1,5,2,2,6,-4,A
1975-12-06,1975,Bristol City,Carlisle United,0-0,0,0,2,2,0,0,D
1975-12-06,1975,Chelsea,Bolton Wanderers,0-1,0,1,2,2,1,-1,A
1975-12-06,1975,Leyton Orient,Nottingham Forest,1-1,1,1,2,2,2,0,D
1975-12-06,1975,Notts County,Blackburn Rovers,3-0,3,0,2,2,3,3,H
1975-12-06,1975,Oldham Athletic,Fulham,2-2,2,2,2,2,4,0,D
1975-12-06,1975,Oxford United,Bristol Rovers,2-1,2,1,2,2,3,1,H
1975-12-06,1975,Plymouth Argyle,Blackpool,1-2,1,2,2,2,3,-1,A
1975-12-06,1975,Southampton,Sunderland,4-0,4,0,2,2,4,4,H
1975-12-06,1975,West Bromwich Albion,Portsmouth,3-1,3,1,2,2,4,2,H
1975-12-06,1975,York City,Hull City,1-2,1,2,2,2,3,-1,A
1975-12-12,1975,Charlton Athletic,Plymouth Argyle,2-0,2,0,2,2,2,2,H
1975-12-12,1975,Leyton Orient,Blackpool,0-1,0,1,2,2,1,-1,A
1975-12-13,1975,Bristol City,Hull City,3-0,3,0,2,2,3,3,H
1975-12-13,1975,Carlisle United,Chelsea,2-1,2,1,2,2,3,1,H
1975-12-13,1975,Fulham,Bolton Wanderers,1-2,1,2,2,2,3,-1,A
1975-12-13,1975,Luton Town,West Bromwich Albion,2-1,2,1,2,2,3,1,H
1975-12-13,1975,Nottingham Forest,Portsmouth,0-1,0,1,2,2,1,-1,A
1975-12-13,1975,Oldham Athletic,Blackburn Rovers,2-1,2,1,2,2,3,1,H
1975-12-13,1975,Southampton,Notts County,2-1,2,1,2,2,3,1,H
1975-12-13,1975,Sunderland,Oxford United,1-0,1,0,2,2,1,1,H
1975-12-13,1975,York City,Bristol Rovers,0-0,0,0,2,2,0,0,D
1975-12-19,1975,West Bromwich Albion,Southampton,0-2,0,2,2,2,2,-2,A
1975-12-20,1975,Blackburn Rovers,Leyton Orient,1-1,1,1,2,2,2,0,D
1975-12-20,1975,Blackpool,Fulham,1-1,1,1,2,2,2,0,D
1975-12-20,1975,Bolton Wanderers,Bristol City,1-0,1,0,2,2,1,1,H
1975-12-20,1975,Bristol Rovers,Oldham Athletic,1-0,1,0,2,2,1,1,H
1975-12-20,1975,Chelsea,Sunderland,1-0,1,0,2,2,1,1,H
1975-12-20,1975,Hull City,Luton Town,1-2,1,2,2,2,3,-1,A
1975-12-20,1975,Notts County,Charlton Athletic,2-0,2,0,2,2,2,2,H
1975-12-20,1975,Oxford United,Carlisle United,0-0,0,0,2,2,0,0,D
1975-12-20,1975,Plymouth Argyle,Nottingham Forest,1-0,1,0,2,2,1,1,H
1975-12-20,1975,Portsmouth,York City,0-1,0,1,2,2,1,-1,A
1975-12-26,1975,Bristol City,Plymouth Argyle,2-2,2,2,2,2,4,0,D
1975-12-26,1975,Carlisle United,Blackpool,1-0,1,0,2,2,1,1,H
1975-12-26,1975,Charlton Athletic,Portsmouth,1-3,1,3,2,2,4,-2,A
1975-12-26,1975,Fulham,Notts County,3-2,3,2,2,2,5,1,H
1975-12-26,1975,Leyton Orient,Chelsea,3-1,3,1,2,2,4,2,H
1975-12-26,1975,Luton Town,Oxford United,3-2,3,2,2,2,5,1,H
1975-12-26,1975,Nottingham Forest,West Bromwich Albion,0-2,0,2,2,2,2,-2,A
1975-12-26,1975,Oldham Athletic,Bolton Wanderers,2-1,2,1,2,2,3,1,H
1975-12-26,1975,Southampton,Bristol Rovers,3-0,3,0,2,2,3,3,H
1975-12-26,1975,Sunderland,Hull City,3-1,3,1,2,2,4,2,H
1975-12-26,1975,York City,Blackburn Rovers,2-1,2,1,2,2,3,1,H
1975-12-27,1975,Blackburn Rovers,Nottingham Forest,1-4,1,4,2,2,5,-3,A
1975-12-27,1975,Blackpool,York City,0-0,0,0,2,2,0,0,D
1975-12-27,1975,Bolton Wanderers,Sunderland,2-1,2,1,2,2,3,1,H
1975-12-27,1975,Bristol Rovers,Luton Town,0-1,0,1,2,2,1,-1,A
1975-12-27,1975,Chelsea,Charlton Athletic,2-3,2,3,2,2,5,-1,A
1975-12-27,1975,Hull City,Carlisle United,2-3,2,3,2,2,5,-1,A
1975-12-27,1975,Notts County,Oldham Athletic,5-1,5,1,2,2,6,4,H
1975-12-27,1975,Oxford United,Southampton,1-2,1,2,2,2,3,-1,A
1975-12-27,1975,Plymouth Argyle,Fulham,4-0,4,0,2,2,4,4,H
1975-12-27,1975,Portsmouth,Bristol City,0-1,0,1,2,2,1,-1,A
1975-12-27,1975,West Bromwich Albion,Leyton Orient,1-1,1,1,2,2,2,0,D
1976-01-10,1975,Blackpool,Charlton Athletic,2-1,2,1,2,2,3,1,H
1976-01-10,1975,Bristol Rovers,Fulham,1-0,1,0,2,2,1,1,H
1976-01-10,1975,Chelsea,Oldham Athletic,0-3,0,3,2,2,3,-3,A
1976-01-10,1975,Hull City,Nottingham Forest,1-0,1,0,2,2,1,1,H
1976-01-10,1975,Notts County,York City,4-0,4,0,2,2,4,4,H
1976-01-10,1975,Oxford United,Bristol City,1-1,1,1,2,2,2,0,D
1976-01-10,1975,Plymouth Argyle,Leyton Orient,3-0,3,0,2,2,3,3,H
1976-01-10,1975,Portsmouth,Carlisle United,1-0,1,0,2,2,1,1,H
1976-01-10,1975,West Bromwich Albion,Sunderland,0-0,0,0,2,2,0,0,D
1976-01-17,1975,Bristol City,Blackburn Rovers,1-0,1,0,2,2,1,1,H
1976-01-17,1975,Carlisle United,Notts County,1-2,1,2,2,2,3,-1,A
1976-01-17,1975,Charlton Athletic,Bristol Rovers,3-0,3,0,2,2,3,3,H
1976-01-17,1975,Fulham,Oxford United,1-1,1,1,2,2,2,0,D
1976-01-17,1975,Leyton Orient,Hull City,1-0,1,0,2,2,1,1,H
1976-01-17,1975,Luton Town,Portsmouth,3-1,3,1,2,2,4,2,H
1976-01-17,1975,Nottingham Forest,Chelsea,1-3,1,3,2,2,4,-2,A
1976-01-17,1975,Oldham Athletic,Blackpool,1-0,1,0,2,2,1,1,H
1976-01-17,1975,Southampton,Bolton Wanderers,0-0,0,0,2,2,0,0,D
1976-01-17,1975,Sunderland,Plymouth Argyle,2-1,2,1,2,2,3,1,H
1976-01-17,1975,York City,West Bromwich Albion,0-1,0,1,2,2,1,-1,A
1976-01-24,1975,Plymouth Argyle,Bristol City,0-0,0,0,2,2,0,0,D
1976-01-27,1975,Bolton Wanderers,Luton Town,3-0,3,0,2,2,3,3,H
1976-01-28,1975,Blackburn Rovers,Southampton,1-1,1,1,2,2,2,0,D
1976-01-31,1975,Blackburn Rovers,Plymouth Argyle,3-1,3,1,2,2,4,2,H
1976-01-31,1975,Blackpool,Hull City,2-2,2,2,2,2,4,0,D
1976-01-31,1975,Bristol Rovers,Portsmouth,2-0,2,0,2,2,2,2,H
1976-01-31,1975,Carlisle United,Fulham,2-2,2,2,2,2,4,0,D
1976-01-31,1975,Charlton Athletic,York City,3-2,3,2,2,2,5,1,H
1976-01-31,1975,Chelsea,West Bromwich Albion,1-2,1,2,2,2,3,-1,A
1976-01-31,1975,Luton Town,Nottingham Forest,1-1,1,1,2,2,2,0,D
1976-01-31,1975,Southampton,Oldham Athletic,3-2,3,2,2,2,5,1,H
1976-02-06,1975,Hull City,Blackburn Rovers,0-1,0,1,2,2,1,-1,A
1976-02-07,1975,Bristol City,Southampton,1-1,1,1,2,2,2,0,D
1976-02-07,1975,Fulham,Sunderland,2-0,2,0,2,2,2,2,H
1976-02-07,1975,Nottingham Forest,Blackpool,3-0,3,0,2,2,3,3,H
1976-02-07,1975,Oldham Athletic,Carlisle United,2-2,2,2,2,2,4,0,D
1976-02-07,1975,Oxford United,Chelsea,1-1,1,1,2,2,2,0,D
1976-02-07,1975,Plymouth Argyle,Notts County,1-3,1,3,2,2,4,-2,A
1976-02-07,1975,Portsmouth,Bolton Wanderers,0-1,0,1,2,2,1,-1,A
1976-02-07,1975,West Bromwich Albion,Bristol Rovers,3-0,3,0,2,2,3,3,H
1976-02-07,1975,York City,Luton Town,2-3,2,3,2,2,5,-1,A
1976-02-14,1975,Bristol Rovers,Notts County,0-0,0,0,2,2,0,0,D
1976-02-14,1975,Leyton Orient,Bristol City,0-1,0,1,2,2,1,-1,A
1976-02-14,1975,Oxford United,Oldham Athletic,1-1,1,1,2,2,2,0,D
1976-02-14,1975,Portsmouth,Plymouth Argyle,2-0,2,0,2,2,2,2,H
1976-02-14,1975,York City,Carlisle United,1-2,1,2,2,2,3,-1,A
1976-02-17,1975,Charlton Athletic,Fulham,3-2,3,2,2,2,5,1,H
1976-02-18,1975,Chelsea,Hull City,0-0,0,0,2,2,0,0,D
1976-02-21,1975,Blackburn Rovers,Portsmouth,0-3,0,3,2,2,3,-3,A
1976-02-21,1975,Blackpool,Oxford United,2-0,2,0,2,2,2,2,H
1976-02-21,1975,Bristol City,Nottingham Forest,0-2,0,2,2,2,2,-2,A
1976-02-21,1975,Carlisle United,Bolton Wanderers,3-2,3,2,2,2,5,1,H
1976-02-21,1975,Fulham,York City,2-0,2,0,2,2,2,2,H
1976-02-21,1975,Hull City,West Bromwich Albion,2-1,2,1,2,2,3,1,H
1976-02-21,1975,Notts County,Chelsea,3-2,3,2,2,2,5,1,H
1976-02-21,1975,Oldham Athletic,Luton Town,1-1,1,1,2,2,2,0,D
1976-02-21,1975,Plymouth Argyle,Bristol Rovers,3-0,3,0,2,2,3,3,H
1976-02-21,1975,Southampton,Leyton Orient,3-0,3,0,2,2,3,3,H
1976-02-21,1975,Sunderland,Charlton Athletic,4-1,4,1,2,2,5,3,H
1976-02-24,1975,Blackpool,Blackburn Rovers,1-1,1,1,2,2,2,0,D
1976-02-24,1975,Bristol City,Oldham Athletic,1-0,1,0,2,2,1,1,H
1976-02-24,1975,Carlisle United,Sunderland,2-2,2,2,2,2,4,0,D
1976-02-24,1975,Charlton Athletic,Nottingham Forest,2-2,2,2,2,2,4,0,D
1976-02-24,1975,Notts County,Hull City,1-2,1,2,2,2,3,-1,A
1976-02-24,1975,Plymouth Argyle,Luton Town,3-0,3,0,2,2,3,3,H
1976-02-24,1975,Southampton,Fulham,2-1,2,1,2,2,3,1,H
1976-02-24,1975,York City,Leyton Orient,0-2,0,2,2,2,2,-2,A
1976-02-25,1975,Chelsea,Portsmouth,2-0,2,0,2,2,2,2,H
1976-02-25,1975,West Bromwich Albion,Oxford United,2-0,2,0,2,2,2,2,H
1976-02-27,1975,Charlton Athletic,Carlisle United,4-2,4,2,2,2,6,2,H
1976-02-28,1975,Bolton Wanderers,Hull City,1-0,1,0,2,2,1,1,H
1976-02-28,1975,Bristol Rovers,Blackpool,1-1,1,1,2,2,2,0,D
1976-02-28,1975,Chelsea,Blackburn Rovers,3-1,3,1,2,2,4,2,H
1976-02-28,1975,Leyton Orient,Fulham,2-0,2,0,2,2,2,2,H
1976-02-28,1975,Luton Town,Sunderland,2-0,2,0,2,2,2,2,H
1976-02-28,1975,Nottingham Forest,Oldham Athletic,4-3,4,3,2,2,7,1,H
1976-02-28,1975,Oxford United,Plymouth Argyle,2-2,2,2,2,2,4,0,D
1976-02-28,1975,Portsmouth,Notts County,1-3,1,3,2,2,4,-2,A
1976-02-28,1975,York City,Southampton,2-1,2,1,2,2,3,1,H
1976-03-02,1975,Bolton Wanderers,Oxford United,0-1,0,1,2,2,1,-1,A
1976-03-02,1975,Leyton Orient,Charlton Athletic,0-1,0,1,2,2,1,-1,A
1976-03-02,1975,Luton Town,Southampton,1-0,1,0,2,2,1,1,H
1976-03-06,1975,Blackburn Rovers,Bristol Rovers,1-2,1,2,2,2,3,-1,A
1976-03-06,1975,Blackpool,Bolton Wanderers,1-1,1,1,2,2,2,0,D
1976-03-06,1975,Bristol City,Luton Town,3-0,3,0,2,2,3,3,H
1976-03-06,1975,Carlisle United,Nottingham Forest,1-1,1,1,2,2,2,0,D
1976-03-06,1975,Fulham,Portsmouth,0-1,0,1,2,2,1,-1,A
1976-03-06,1975,Hull City,Oxford United,2-0,2,0,2,2,2,2,H
1976-03-06,1975,Notts County,West Bromwich Albion,0-2,0,2,2,2,2,-2,A
1976-03-06,1975,Oldham Athletic,Leyton Orient,1-1,1,1,2,2,2,0,D
1976-03-06,1975,Plymouth Argyle,Chelsea,0-3,0,3,2,2,3,-3,A
1976-03-09,1975,Fulham,Southampton,1-0,1,0,2,2,1,1,H
1976-03-12,1975,Charlton Athletic,Bristol City,2-2,2,2,2,2,4,0,D
1976-03-13,1975,Bolton Wanderers,Plymouth Argyle,0-0,0,0,2,2,0,0,D
1976-03-13,1975,Bristol Rovers,Hull City,0-1,0,1,2,2,1,-1,A
1976-03-13,1975,Chelsea,Southampton,1-1,1,1,2,2,2,0,D
1976-03-13,1975,Leyton Orient,Sunderland,0-2,0,2,2,2,2,-2,A
1976-03-13,1975,Luton Town,Carlisle United,3-0,3,0,2,2,3,3,H
1976-03-13,1975,Nottingham Forest,Fulham,1-0,1,0,2,2,1,1,H
1976-03-13,1975,Oxford United,Notts County,2-1,2,1,2,2,3,1,H
1976-03-13,1975,Portsmouth,Blackpool,2-0,2,0,2,2,2,2,H
1976-03-13,1975,West Bromwich Albion,Blackburn Rovers,2-2,2,2,2,2,4,0,D
1976-03-13,1975,York City,Oldham Athletic,1-0,1,0,2,2,1,1,H
1976-03-17,1975,Nottingham Forest,Sunderland,2-1,2,1,2,2,3,1,H
1976-03-17,1975,West Bromwich Albion,Bristol City,0-1,0,1,2,2,1,-1,A
1976-03-20,1975,Bristol City,Fulham,0-0,0,0,2,2,0,0,D
1976-03-20,1975,Charlton Athletic,Blackburn Rovers,2-1,2,1,2,2,3,1,H
1976-03-20,1975,Chelsea,Bristol Rovers,0-0,0,0,2,2,0,0,D
1976-03-20,1975,Leyton Orient,Luton Town,3-0,3,0,2,2,3,3,H
1976-03-20,1975,Notts County,Blackpool,1-2,1,2,2,2,3,-1,A
1976-03-20,1975,Oldham Athletic,Sunderland,1-1,1,1,2,2,2,0,D
1976-03-20,1975,Oxford United,Portsmouth,1-0,1,0,2,2,1,1,H
1976-03-20,1975,Plymouth Argyle,Hull City,1-1,1,1,2,2,2,0,D
1976-03-20,1975,Southampton,Carlisle United,1-1,1,1,2,2,2,0,D
1976-03-20,1975,West Bromwich Albion,Bolton Wanderers,2-0,2,0,2,2,2,2,H
1976-03-20,1975,York City,Nottingham Forest,3-2,3,2,2,2,5,1,H
1976-03-23,1975,Bolton Wanderers,Blackburn Rovers,0-1,0,1,2,2,1,-1,A
1976-03-23,1975,Charlton Athletic,Leyton Orient,1-1,1,1,2,2,2,0,D
1976-03-23,1975,Sunderland,Bristol City,1-1,1,1,2,2,2,0,D
1976-03-27,1975,Blackburn Rovers,Notts County,2-1,2,1,2,2,3,1,H
1976-03-27,1975,Blackpool,Plymouth Argyle,0-0,0,0,2,2,0,0,D
1976-03-27,1975,Bolton Wanderers,Chelsea,2-1,2,1,2,2,3,1,H
1976-03-27,1975,Bristol Rovers,Oxford United,0-1,0,1,2,2,1,-1,A
1976-03-27,1975,Carlisle United,Bristol City,0-1,0,1,2,2,1,-1,A
1976-03-27,1975,Fulham,Oldham Athletic,1-0,1,0,2,2,1,1,H
1976-03-27,1975,Hull City,York City,1-1,1,1,2,2,2,0,D
1976-03-27,1975,Luton Town,Charlton Athletic,1-1,1,1,2,2,2,0,D
1976-03-27,1975,Nottingham Forest,Leyton Orient,1-0,1,0,2,2,1,1,H
1976-03-27,1975,Portsmouth,West Bromwich Albion,0-1,0,1,2,2,1,-1,A
1976-03-27,1975,Sunderland,Southampton,3-0,3,0,2,2,3,3,H
1976-03-30,1975,Sunderland,York City,1-0,1,0,2,2,1,1,H
1976-03-31,1975,West Bromwich Albion,Blackpool,0-0,0,0,2,2,0,0,D
1976-04-03,1975,Blackburn Rovers,Luton Town,3-0,3,0,2,2,3,3,H
1976-04-03,1975,Blackpool,Bristol City,2-1,2,1,2,2,3,1,H
1976-04-03,1975,Bolton Wanderers,Nottingham Forest,0-0,0,0,2,2,0,0,D
1976-04-03,1975,Bristol Rovers,Leyton Orient,1-1,1,1,2,2,2,0,D
1976-04-03,1975,Hull City,Charlton Athletic,2-2,2,2,2,2,4,0,D
1976-04-03,1975,Notts County,Sunderland,0-0,0,0,2,2,0,0,D
1976-04-03,1975,Oxford United,York City,1-0,1,0,2,2,1,1,H
1976-04-03,1975,Plymouth Argyle,Oldham Athletic,2-1,2,1,2,2,3,1,H
1976-04-03,1975,West Bromwich Albion,Carlisle United,3-0,3,0,2,2,3,3,H
1976-04-06,1975,Chelsea,Fulham,0-0,0,0,2,2,0,0,D
1976-04-06,1975,Portsmouth,Southampton,0-1,0,1,2,2,1,-1,A
1976-04-09,1975,Charlton Athletic,West Bromwich Albion,2-1,2,1,2,2,3,1,H
1976-04-10,1975,Bristol City,Chelsea,2-2,2,2,2,2,4,0,D
1976-04-10,1975,Carlisle United,Bristol Rovers,4-2,4,2,2,2,6,2,H
1976-04-10,1975,Fulham,Hull City,1-1,1,1,2,2,2,0,D
1976-04-10,1975,Leyton Orient,Bolton Wanderers,0-0,0,0,2,2,0,0,D
1976-04-10,1975,Luton Town,Notts County,1-1,1,1,2,2,2,0,D
1976-04-10,1975,Nottingham Forest,Oxford United,4-0,4,0,2,2,4,4,H
1976-04-10,1975,Oldham Athletic,Portsmouth,5-2,5,2,2,2,7,3,H
1976-04-10,1975,Southampton,Blackpool,3-1,3,1,2,2,4,2,H
1976-04-10,1975,Sunderland,Blackburn Rovers,3-0,3,0,2,2,3,3,H
1976-04-10,1975,York City,Plymouth Argyle,3-1,3,1,2,2,4,2,H
1976-04-12,1975,Southampton,Charlton Athletic,3-2,3,2,2,2,5,1,H
1976-04-13,1975,Bolton Wanderers,York City,1-2,1,2,2,2,3,-1,A
1976-04-13,1975,Notts County,Nottingham Forest,0-0,0,0,2,2,0,0,D
1976-04-13,1975,Portsmouth,Leyton Orient,2-1,2,1,2,2,3,1,H
1976-04-14,1975,West Bromwich Albion,Fulham,3-1,3,1,2,2,4,2,H
1976-04-16,1975,Blackburn Rovers,Carlisle United,1-0,1,0,2,2,1,1,H
1976-04-16,1975,Bristol Rovers,Bristol City,0-0,0,0,2,2,0,0,D
1976-04-16,1975,Chelsea,Luton Town,2-2,2,2,2,2,4,0,D
1976-04-16,1975,Hull City,Oldham Athletic,3-0,3,0,2,2,3,3,H
1976-04-16,1975,Oxford United,Charlton Athletic,1-0,1,0,2,2,1,1,H
1976-04-16,1975,Plymouth Argyle,Southampton,1-0,1,0,2,2,1,1,H
1976-04-17,1975,Blackburn Rovers,York City,4-0,4,0,2,2,4,4,H
1976-04-17,1975,Blackpool,Carlisle United,2-1,2,1,2,2,3,1,H
1976-04-17,1975,Bolton Wanderers,Oldham Athletic,4-0,4,0,2,2,4,4,H
1976-04-17,1975,Bristol Rovers,Southampton,2-0,2,0,2,2,2,2,H
1976-04-17,1975,Chelsea,Leyton Orient,0-2,0,2,2,2,2,-2,A
1976-04-17,1975,Hull City,Sunderland,1-4,1,4,2,2,5,-3,A
1976-04-17,1975,Notts County,Fulham,4-0,4,0,2,2,4,4,H
1976-04-17,1975,Oxford United,Luton Town,1-3,1,3,2,2,4,-2,A
1976-04-17,1975,Portsmouth,Charlton Athletic,2-2,2,2,2,2,4,0,D
1976-04-17,1975,West Bromwich Albion,Nottingham Forest,2-0,2,0,2,2,2,2,H
1976-04-19,1975,Charlton Athletic,Chelsea,1-1,1,1,2,2,2,0,D
1976-04-19,1975,Fulham,Plymouth Argyle,0-0,0,0,2,2,0,0,D
1976-04-19,1975,Luton Town,Bristol Rovers,3-1,3,1,2,2,4,2,H
1976-04-19,1975,Oldham Athletic,Notts County,2-2,2,2,2,2,4,0,D
1976-04-19,1975,Southampton,Oxford United,2-1,2,1,2,2,3,1,H
1976-04-19,1975,Sunderland,Bolton Wanderers,2-1,2,1,2,2,3,1,H
1976-04-19,1975,York City,Blackpool,1-1,1,1,2,2,2,0,D
1976-04-20,1975,Blackpool,Sunderland,1-0,1,0,2,2,1,1,H
1976-04-20,1975,Bristol City,Portsmouth,1-0,1,0,2,2,1,1,H
1976-04-20,1975,Carlisle United,Hull City,0-0,0,0,2,2,0,0,D
1976-04-20,1975,Leyton Orient,West Bromwich Albion,0-0,0,0,2,2,0,0,D
1976-04-20,1975,Nottingham Forest,Blackburn Rovers,1-0,1,0,2,2,1,1,H
1976-04-24,1975,Bristol City,Notts County,1-2,1,2,2,2,3,-1,A
1976-04-24,1975,Carlisle United,Plymouth Argyle,2-0,2,0,2,2,2,2,H
1976-04-24,1975,Charlton Athletic,Bolton Wanderers,0-4,0,4,2,2,4,-4,A
1976-04-24,1975,Fulham,Blackburn Rovers,1-1,1,1,2,2,2,0,D
1976-04-24,1975,Leyton Orient,Oxford United,2-1,2,1,2,2,3,1,H
1976-04-24,1975,Luton Town,Blackpool,3-0,3,0,2,2,3,3,H
1976-04-24,1975,Nottingham Forest,Bristol Rovers,3-0,3,0,2,2,3,3,H
1976-04-24,1975,Oldham Athletic,West Bromwich Albion,0-1,0,1,2,2,1,-1,A
1976-04-24,1975,Southampton,Hull City,1-0,1,0,2,2,1,1,H
1976-04-24,1975,Sunderland,Portsmouth,2-0,2,0,2,2,2,2,H
1976-04-24,1975,York City,Chelsea,2-2,2,2,2,2,4,0,D
1976-04-27,1975,Notts County,Leyton Orient,2-0,2,0,2,2,2,2,H
1976-04-28,1975,Bolton Wanderers,Bristol Rovers,3-1,3,1,2,2,4,2,H
1976-08-21,1976,Blackburn Rovers,Bolton Wanderers,3-1,3,1,2,2,4,2,H
1976-08-21,1976,Bristol Rovers,Blackpool,1-4,1,4,2,2,5,-3,A
1976-08-21,1976,Charlton Athletic,Cardiff City,0-2,0,2,2,2,2,-2,A
1976-08-21,1976,Fulham,Nottingham Forest,2-2,2,2,2,2,4,0,D
1976-08-21,1976,Hereford United,Hull City,1-0,1,0,2,2,1,1,H
1976-08-21,1976,Leyton Orient,Chelsea,0-1,0,1,2,2,1,-1,A
1976-08-21,1976,Luton Town,Sheffield United,2-0,2,0,2,2,2,2,H
1976-08-21,1976,Notts County,Millwall,1-2,1,2,2,2,3,-1,A
1976-08-21,1976,Oldham Athletic,Plymouth Argyle,2-2,2,2,2,2,4,0,D
1976-08-21,1976,Southampton,Carlisle United,1-2,1,2,2,2,3,-1,A
1976-08-21,1976,Wolverhampton Wanderers,Burnley,0-0,0,0,2,2,0,0,D
1976-08-24,1976,Blackpool,Oldham Athletic,0-2,0,2,2,2,2,-2,A
1976-08-24,1976,Bolton Wanderers,Leyton Orient,2-0,2,0,2,2,2,2,H
1976-08-24,1976,Burnley,Fulham,3-1,3,1,2,2,4,2,H
1976-08-24,1976,Hull City,Luton Town,3-1,3,1,2,2,4,2,H
1976-08-24,1976,Plymouth Argyle,Blackburn Rovers,4-0,4,0,2,2,4,4,H
1976-08-24,1976,Sheffield United,Wolverhampton Wanderers,2-2,2,2,2,2,4,0,D
1976-08-25,1976,Cardiff City,Bristol Rovers,1-2,1,2,2,2,3,-1,A
1976-08-25,1976,Chelsea,Notts County,1-1,1,1,2,2,2,0,D
1976-08-25,1976,Millwall,Southampton,0-0,0,0,2,2,0,0,D
1976-08-25,1976,Nottingham Forest,Charlton Athletic,1-1,1,1,2,2,2,0,D
1976-08-28,1976,Blackpool,Leyton Orient,3-0,3,0,2,2,3,3,H
1976-08-28,1976,Bolton Wanderers,Millwall,3-1,3,1,2,2,4,2,H
1976-08-28,1976,Bristol Rovers,Oldham Athletic,0-0,0,0,2,2,0,0,D
1976-08-28,1976,Burnley,Luton Town,1-2,1,2,2,2,3,-1,A
1976-08-28,1976,Cardiff City,Blackburn Rovers,2-1,2,1,2,2,3,1,H
1976-08-28,1976,Charlton Athletic,Fulham,1-1,1,1,2,2,2,0,D
1976-08-28,1976,Chelsea,Carlisle United,2-1,2,1,2,2,3,1,H
1976-08-28,1976,Hull City,Southampton,4-0,4,0,2,2,4,4,H
1976-08-28,1976,Nottingham Forest,Wolverhampton Wanderers,1-3,1,3,2,2,4,-2,A
1976-08-28,1976,Plymouth Argyle,Notts County,1-2,1,2,2,2,3,-1,A
1976-08-28,1976,Sheffield United,Hereford United,1-1,1,1,2,2,2,0,D
1976-09-04,1976,Blackburn Rovers,Blackpool,0-1,0,1,2,2,1,-1,A
1976-09-04,1976,Carlisle United,Hull City,1-1,1,1,2,2,2,0,D
1976-09-04,1976,Fulham,Bristol Rovers,1-0,1,0,2,2,1,1,H
1976-09-04,1976,Hereford United,Burnley,3-0,3,0,2,2,3,3,H
1976-09-04,1976,Leyton Orient,Plymouth Argyle,2-2,2,2,2,2,4,0,D
1976-09-04,1976,Luton Town,Nottingham Forest,1-1,1,1,2,2,2,0,D
1976-09-04,1976,Millwall,Chelsea,3-0,3,0,2,2,3,3,H
1976-09-04,1976,Notts County,Bolton Wanderers,0-1,0,1,2,2,1,-1,A
1976-09-04,1976,Oldham Athletic,Cardiff City,3-2,3,2,2,2,5,1,H
1976-09-04,1976,Southampton,Sheffield United,1-1,1,1,2,2,2,0,D
1976-09-04,1976,Wolverhampton Wanderers,Charlton Athletic,3-0,3,0,2,2,3,3,H
1976-09-10,1976,Charlton Athletic,Luton Town,4-3,4,3,2,2,7,1,H
1976-09-11,1976,Blackpool,Millwall,4-2,4,2,2,2,6,2,H
1976-09-11,1976,Bolton Wanderers,Hull City,5-1,5,1,2,2,6,4,H
1976-09-11,1976,Bristol Rovers,Leyton Orient,1-0,1,0,2,2,1,1,H
1976-09-11,1976,Burnley,Southampton,2-0,2,0,2,2,2,2,H
1976-09-11,1976,Cardiff City,Notts County,2-3,2,3,2,2,5,-1,A
1976-09-11,1976,Fulham,Wolverhampton Wanderers,0-0,0,0,2,2,0,0,D
1976-09-11,1976,Nottingham Forest,Hereford United,4-3,4,3,2,2,7,1,H
1976-09-11,1976,Oldham Athletic,Blackburn Rovers,2-0,2,0,2,2,2,2,H
1976-09-11,1976,Plymouth Argyle,Chelsea,2-3,2,3,2,2,5,-1,A
1976-09-11,1976,Sheffield United,Carlisle United,3-0,3,0,2,2,3,3,H
1976-09-14,1976,Carlisle United,Hereford United,2-2,2,2,2,2,4,0,D
1976-09-17,1976,Hull City,Sheffield United,1-1,1,1,2,2,2,0,D
1976-09-18,1976,Blackburn Rovers,Bristol Rovers,0-0,0,0,2,2,0,0,D
1976-09-18,1976,Carlisle United,Burnley,2-1,2,1,2,2,3,1,H
1976-09-18,1976,Chelsea,Bolton Wanderers,2-1,2,1,2,2,3,1,H
1976-09-18,1976,Hereford United,Charlton Athletic,1-2,1,2,2,2,3,-1,A
1976-09-18,1976,Leyton Orient,Cardiff City,3-0,3,0,2,2,3,3,H
1976-09-18,1976,Luton Town,Fulham,0-2,0,2,2,2,2,-2,A
1976-09-18,1976,Millwall,Plymouth Argyle,3-0,3,0,2,2,3,3,H
1976-09-18,1976,Notts County,Blackpool,2-0,2,0,2,2,2,2,H
1976-09-18,1976,Southampton,Nottingham Forest,1-1,1,1,2,2,2,0,D
1976-09-18,1976,Wolverhampton Wanderers,Oldham Athletic,5-0,5,0,2,2,5,5,H
1976-09-24,1976,Cardiff City,Millwall,0-0,0,0,2,2,0,0,D
1976-09-24,1976,Charlton Athletic,Southampton,6-2,6,2,2,2,8,4,H
1976-09-25,1976,Blackpool,Chelsea,0-1,0,1,2,2,1,-1,A
1976-09-25,1976,Bristol Rovers,Notts County,5-1,5,1,2,2,6,4,H
1976-09-25,1976,Burnley,Hull City,0-0,0,0,2,2,0,0,D
1976-09-25,1976,Fulham,Hereford United,4-1,4,1,2,2,5,3,H
1976-09-25,1976,Nottingham Forest,Carlisle United,5-1,5,1,2,2,6,4,H
1976-09-25,1976,Oldham Athletic,Leyton Orient,0-0,0,0,2,2,0,0,D
1976-09-25,1976,Plymouth Argyle,Bolton Wanderers,1-1,1,1,2,2,2,0,D
1976-09-25,1976,Sheffield United,Blackburn Rovers,1-1,1,1,2,2,2,0,D
1976-09-25,1976,Wolverhampton Wanderers,Luton Town,1-2,1,2,2,2,3,-1,A
1976-10-02,1976,Bolton Wanderers,Blackpool,0-3,0,3,2,2,3,-3,A
1976-10-02,1976,Carlisle United,Charlton Athletic,4-2,4,2,2,2,6,2,H
1976-10-02,1976,Chelsea,Cardiff City,2-1,2,1,2,2,3,1,H
1976-10-02,1976,Hereford United,Wolverhampton Wanderers,1-6,1,6,2,2,7,-5,A
1976-10-02,1976,Hull City,Nottingham Forest,1-0,1,0,2,2,1,1,H
1976-10-02,1976,Leyton Orient,Blackburn Rovers,0-1,0,1,2,2,1,-1,A
1976-10-02,1976,Millwall,Bristol Rovers,2-0,2,0,2,2,2,2,H
1976-10-02,1976,Notts County,Oldham Athletic,1-0,1,0,2,2,1,1,H
1976-10-02,1976,Plymouth Argyle,Luton Town,1-0,1,0,2,2,1,1,H
1976-10-02,1976,Sheffield United,Burnley,1-0,1,0,2,2,1,1,H
1976-10-02,1976,Southampton,Fulham,4-1,4,1,2,2,5,3,H
1976-10-05,1976,Bristol Rovers,Chelsea,2-1,2,1,2,2,3,1,H
1976-10-05,1976,Wolverhampton Wanderers,Southampton,2-6,2,6,2,2,8,-4,A
1976-10-09,1976,Blackburn Rovers,Notts County,6-1,6,1,2,2,7,5,H
1976-10-09,1976,Blackpool,Plymouth Argyle,0-2,0,2,2,2,2,-2,A
1976-10-09,1976,Burnley,Leyton Orient,3-3,3,3,2,2,6,0,D
1976-10-09,1976,Cardiff City,Bolton Wanderers,3-2,3,2,2,2,5,1,H
1976-10-09,1976,Charlton Athletic,Hull City,3-1,3,1,2,2,4,2,H
1976-10-09,1976,Luton Town,Hereford United,2-0,2,0,2,2,2,2,H
1976-10-09,1976,Nottingham Forest,Sheffield United,6-1,6,1,2,2,7,5,H
1976-10-09,1976,Oldham Athletic,Millwall,2-1,2,1,2,2,3,1,H
1976-10-12,1976,Carlisle United,Blackpool,1-1,1,1,2,2,2,0,D
1976-10-16,1976,Blackpool,Nottingham Forest,1-0,1,0,2,2,1,1,H
1976-10-16,1976,Bolton Wanderers,Bristol Rovers,1-0,1,0,2,2,1,1,H
1976-10-16,1976,Burnley,Charlton Athletic,4-4,4,4,2,2,8,0,D
1976-10-16,1976,Carlisle United,Luton Town,1-1,1,1,2,2,2,0,D
1976-10-16,1976,Chelsea,Oldham Athletic,4-3,4,3,2,2,7,1,H
1976-10-16,1976,Hull City,Wolverhampton Wanderers,2-0,2,0,2,2,2,2,H
1976-10-16,1976,Millwall,Blackburn Rovers,0-1,0,1,2,2,1,-1,A
1976-10-16,1976,Notts County,Leyton Orient,0-1,0,1,2,2,1,-1,A
1976-10-16,1976,Plymouth Argyle,Cardiff City,2-2,2,2,2,2,4,0,D
1976-10-16,1976,Sheffield United,Fulham,1-1,1,1,2,2,2,0,D
1976-10-16,1976,Southampton,Hereford United,1-0,1,0,2,2,1,1,H
1976-10-23,1976,Blackburn Rovers,Chelsea,0-2,0,2,2,2,2,-2,A
1976-10-23,1976,Bristol Rovers,Plymouth Argyle,1-1,1,1,2,2,2,0,D
1976-10-23,1976,Cardiff City,Blackpool,2-2,2,2,2,2,4,0,D
1976-10-23,1976,Charlton Athletic,Sheffield United,3-2,3,2,2,2,5,1,H
1976-10-23,1976,Fulham,Hull City,0-0,0,0,2,2,0,0,D
1976-10-23,1976,Hereford United,Notts County,1-4,1,4,2,2,5,-3,A
1976-10-23,1976,Luton Town,Southampton,1-4,1,4,2,2,5,-3,A
1976-10-23,1976,Nottingham Forest,Burnley,5-2,5,2,2,2,7,3,H
1976-10-23,1976,Oldham Athletic,Bolton Wanderers,2-2,2,2,2,2,4,0,D
1976-10-23,1976,Wolverhampton Wanderers,Carlisle United,4-0,4,0,2,2,4,4,H
1976-10-30,1976,Blackburn Rovers,Luton Town,1-0,1,0,2,2,1,1,H
1976-10-30,1976,Blackpool,Wolverhampton Wanderers,2-2,2,2,2,2,4,0,D
1976-10-30,1976,Bolton Wanderers,Fulham,2-1,2,1,2,2,3,1,H
1976-10-30,1976,Bristol Rovers,Charlton Athletic,1-1,1,1,2,2,2,0,D
1976-10-30,1976,Cardiff City,Sheffield United,0-2,0,2,2,2,2,-2,A
1976-10-30,1976,Chelsea,Southampton,3-1,3,1,2,2,4,2,H
1976-10-30,1976,Millwall,Hereford United,4-2,4,2,2,2,6,2,H
1976-10-30,1976,Notts County,Carlisle United,2-1,2,1,2,2,3,1,H
1976-10-30,1976,Oldham Athletic,Nottingham Forest,1-0,1,0,2,2,1,1,H
1976-10-30,1976,Plymouth Argyle,Burnley,0-1,0,1,2,2,1,-1,A
1976-11-05,1976,Charlton Athletic,Plymouth Argyle,3-1,3,1,2,2,4,2,H
1976-11-06,1976,Burnley,Oldham Athletic,1-0,1,0,2,2,1,1,H
1976-11-06,1976,Carlisle United,Bolton Wanderers,0-1,0,1,2,2,1,-1,A
1976-11-06,1976,Fulham,Cardiff City,1-2,1,2,2,2,3,-1,A
1976-11-06,1976,Hereford United,Chelsea,2-2,2,2,2,2,4,0,D
1976-11-06,1976,Hull City,Blackpool,2-2,2,2,2,2,4,0,D
1976-11-06,1976,Luton Town,Bristol Rovers,4-2,4,2,2,2,6,2,H
1976-11-06,1976,Nottingham Forest,Blackburn Rovers,3-0,3,0,2,2,3,3,H
1976-11-06,1976,Sheffield United,Notts County,1-0,1,0,2,2,1,1,H
1976-11-06,1976,Southampton,Leyton Orient,2-2,2,2,2,2,4,0,D
1976-11-06,1976,Wolverhampton Wanderers,Millwall,3-1,3,1,2,2,4,2,H
1976-11-09,1976,Bolton Wanderers,Burnley,2-1,2,1,2,2,3,1,H
1976-11-10,1976,Cardiff City,Southampton,1-0,1,0,2,2,1,1,H
1976-11-10,1976,Chelsea,Charlton Athletic,2-1,2,1,2,2,3,1,H
1976-11-13,1976,Blackburn Rovers,Hull City,1-0,1,0,2,2,1,1,H
1976-11-13,1976,Blackpool,Sheffield United,1-0,1,0,2,2,1,1,H
1976-11-13,1976,Bristol Rovers,Hereford United,2-3,2,3,2,2,5,-1,A
1976-11-13,1976,Leyton Orient,Nottingham Forest,0-1,0,1,2,2,1,-1,A
1976-11-13,1976,Millwall,Luton Town,4-2,4,2,2,2,6,2,H
1976-11-13,1976,Notts County,Wolverhampton Wanderers,1-1,1,1,2,2,2,0,D
1976-11-13,1976,Oldham Athletic,Carlisle United,4-1,4,1,2,2,5,3,H
1976-11-13,1976,Plymouth Argyle,Fulham,2-2,2,2,2,2,4,0,D
1976-11-16,1976,Fulham,Carlisle United,2-0,2,0,2,2,2,2,H
1976-11-20,1976,Burnley,Bristol Rovers,1-1,1,1,2,2,2,0,D
1976-11-20,1976,Carlisle United,Millwall,0-1,0,1,2,2,1,-1,A
1976-11-20,1976,Charlton Athletic,Blackpool,1-2,1,2,2,2,3,-1,A
1976-11-20,1976,Fulham,Notts County,1-5,1,5,2,2,6,-4,A
1976-11-20,1976,Hereford United,Oldham Athletic,0-0,0,0,2,2,0,0,D
1976-11-20,1976,Hull City,Plymouth Argyle,3-1,3,1,2,2,4,2,H
1976-11-20,1976,Luton Town,Cardiff City,2-1,2,1,2,2,3,1,H
1976-11-20,1976,Nottingham Forest,Chelsea,1-1,1,1,2,2,2,0,D
1976-11-20,1976,Sheffield United,Leyton Orient,1-1,1,1,2,2,2,0,D
1976-11-20,1976,Southampton,Bolton Wanderers,1-3,1,3,2,2,4,-2,A
1976-11-20,1976,Wolverhampton Wanderers,Blackburn Rovers,1-2,1,2,2,2,3,-1,A
1976-11-27,1976,Blackburn Rovers,Hereford United,1-0,1,0,2,2,1,1,H
1976-11-27,1976,Blackpool,Fulham,3-2,3,2,2,2,5,1,H
1976-11-27,1976,Bolton Wanderers,Charlton Athletic,1-0,1,0,2,2,1,1,H
1976-11-27,1976,Bristol Rovers,Hull City,3-0,3,0,2,2,3,3,H
1976-11-27,1976,Cardiff City,Nottingham Forest,0-3,0,3,2,2,3,-3,A
1976-11-27,1976,Chelsea,Burnley,2-1,2,1,2,2,3,1,H
1976-11-27,1976,Leyton Orient,Wolverhampton Wanderers,2-4,2,4,2,2,6,-2,A
1976-11-27,1976,Millwall,Sheffield United,0-1,0,1,2,2,1,-1,A
1976-11-27,1976,Notts County,Luton Town,0-4,0,4,2,2,4,-4,A
1976-11-27,1976,Oldham Athletic,Southampton,2-1,2,1,2,2,3,1,H
1976-11-27,1976,Plymouth Argyle,Carlisle United,0-1,0,1,2,2,1,-1,A
1976-12-03,1976,Sheffield United,Chelsea,1-0,1,0,2,2,1,1,H
1976-12-04,1976,Burnley,Cardiff City,0-0,0,0,2,2,0,0,D
1976-12-04,1976,Carlisle United,Leyton Orient,1-0,1,0,2,2,1,1,H
1976-12-04,1976,Charlton Athletic,Blackburn Rovers,4-0,4,0,2,2,4,4,H
1976-12-04,1976,Fulham,Oldham Athletic,5-0,5,0,2,2,5,5,H
1976-12-04,1976,Luton Town,Blackpool,0-0,0,0,2,2,0,0,D
1976-12-04,1976,Nottingham Forest,Bristol Rovers,4-2,4,2,2,2,6,2,H
1976-12-04,1976,Southampton,Notts County,2-1,2,1,2,2,3,1,H
1976-12-04,1976,Wolverhampton Wanderers,Plymouth Argyle,4-0,4,0,2,2,4,4,H
1976-12-07,1976,Southampton,Chelsea,1-1,1,1,2,2,2,0,D
1976-12-11,1976,Bristol Rovers,Carlisle United,2-1,2,1,2,2,3,1,H
1976-12-11,1976,Cardiff City,Hull City,1-1,1,1,2,2,2,0,D
1976-12-11,1976,Chelsea,Wolverhampton Wanderers,3-3,3,3,2,2,6,0,D
1976-12-11,1976,Leyton Orient,Fulham,0-0,0,0,2,2,0,0,D
1976-12-11,1976,Millwall,Nottingham Forest,0-2,0,2,2,2,2,-2,A
1976-12-11,1976,Plymouth Argyle,Sheffield United,0-0,0,0,2,2,0,0,D
1976-12-14,1976,Fulham,Blackburn Rovers,2-0,2,0,2,2,2,2,H
1976-12-15,1976,Hereford United,Bolton Wanderers,3-3,3,3,2,2,6,0,D
1976-12-18,1976,Burnley,Millwall,1-3,1,3,2,2,4,-2,A
1976-12-18,1976,Carlisle United,Cardiff City,4-3,4,3,2,2,7,1,H
1976-12-18,1976,Hereford United,Leyton Orient,2-3,2,3,2,2,5,-1,A
1976-12-18,1976,Hull City,Chelsea,1-1,1,1,2,2,2,0,D
1976-12-18,1976,Nottingham Forest,Plymouth Argyle,1-1,1,1,2,2,2,0,D
1976-12-18,1976,Sheffield United,Bristol Rovers,2-3,2,3,2,2,5,-1,A
1976-12-18,1976,Southampton,Blackpool,3-3,3,3,2,2,6,0,D
1976-12-18,1976,Wolverhampton Wanderers,Bolton Wanderers,1-0,1,0,2,2,1,1,H
1976-12-21,1976,Bolton Wanderers,Luton Town,2-1,2,1,2,2,3,1,H
1976-12-27,1976,Blackburn Rovers,Burnley,2-2,2,2,2,2,4,0,D
1976-12-27,1976,Blackpool,Carlisle United,0-0,0,0,2,2,0,0,D
1976-12-27,1976,Bolton Wanderers,Nottingham Forest,1-1,1,1,2,2,2,0,D
1976-12-27,1976,Bristol Rovers,Wolverhampton Wanderers,1-5,1,5,2,2,6,-4,A
1976-12-27,1976,Cardiff City,Hereford United,3-1,3,1,2,2,4,2,H
1976-12-27,1976,Chelsea,Fulham,2-0,2,0,2,2,2,2,H
1976-12-27,1976,Leyton Orient,Luton Town,1-0,1,0,2,2,1,1,H
1976-12-27,1976,Millwall,Charlton Athletic,1-1,1,1,2,2,2,0,D
1976-12-27,1976,Notts County,Hull City,1-1,1,1,2,2,2,0,D
1976-12-27,1976,Oldham Athletic,Sheffield United,1-2,1,2,2,2,3,-1,A
1976-12-27,1976,Plymouth Argyle,Southampton,1-1,1,1,2,2,2,0,D
1976-12-28,1976,Burnley,Blackpool,0-0,0,0,2,2,0,0,D
1976-12-28,1976,Fulham,Millwall,2-3,2,3,2,2,5,-1,A
1976-12-28,1976,Hull City,Oldham Athletic,0-1,0,1,2,2,1,-1,A
1976-12-28,1976,Sheffield United,Bolton Wanderers,2-3,2,3,2,2,5,-1,A
1976-12-29,1976,Carlisle United,Blackburn Rovers,1-1,1,1,2,2,2,0,D
1976-12-29,1976,Luton Town,Chelsea,4-0,4,0,2,2,4,4,H
1976-12-29,1976,Southampton,Bristol Rovers,2-1,2,1,2,2,3,1,H
1977-01-01,1976,Blackburn Rovers,Nottingham Forest,1-3,1,3,2,2,4,-2,A
1977-01-01,1976,Blackpool,Hull City,0-0,0,0,2,2,0,0,D
1977-01-01,1976,Bristol Rovers,Luton Town,1-0,1,0,2,2,1,1,H
1977-01-01,1976,Cardiff City,Fulham,3-0,3,0,2,2,3,3,H
1977-01-01,1976,Chelsea,Hereford United,5-1,5,1,2,2,6,4,H
1977-01-01,1976,Millwall,Wolverhampton Wanderers,1-1,1,1,2,2,2,0,D
1977-01-01,1976,Plymouth Argyle,Charlton Athletic,1-0,1,0,2,2,1,1,H
1977-01-03,1976,Burnley,Plymouth Argyle,0-2,0,2,2,2,2,-2,A
1977-01-03,1976,Carlisle United,Notts County,0-2,0,2,2,2,2,-2,A
1977-01-03,1976,Charlton Athletic,Bristol Rovers,4-3,4,3,2,2,7,1,H
1977-01-03,1976,Fulham,Bolton Wanderers,0-2,0,2,2,2,2,-2,A
1977-01-14,1976,Charlton Athletic,Nottingham Forest,2-1,2,1,2,2,3,1,H
1977-01-15,1976,Bristol Rovers,Cardiff City,1-1,1,1,2,2,2,0,D
1977-01-15,1976,Fulham,Burnley,2-2,2,2,2,2,4,0,D
1977-01-15,1976,Oldham Athletic,Blackpool,1-0,1,0,2,2,1,1,H
1977-01-15,1976,Southampton,Millwall,0-2,0,2,2,2,2,-2,A
1977-01-22,1976,Blackpool,Bristol Rovers,4-0,4,0,2,2,4,4,H
1977-01-22,1976,Bolton Wanderers,Blackburn Rovers,3-1,3,1,2,2,4,2,H
1977-01-22,1976,Burnley,Wolverhampton Wanderers,0-0,0,0,2,2,0,0,D
1977-01-22,1976,Cardiff City,Charlton Athletic,1-1,1,1,2,2,2,0,D
1977-01-22,1976,Carlisle United,Southampton,0-6,0,6,2,2,6,-6,A
1977-01-22,1976,Chelsea,Leyton Orient,1-1,1,1,2,2,2,0,D
1977-01-22,1976,Hull City,Hereford United,1-1,1,1,2,2,2,0,D
1977-01-22,1976,Millwall,Notts County,2-5,2,5,2,2,7,-3,A
1977-01-22,1976,Nottingham Forest,Fulham,3-0,3,0,2,2,3,3,H
1977-01-22,1976,Plymouth Argyle,Oldham Athletic,2-2,2,2,2,2,4,0,D
1977-01-22,1976,Sheffield United,Luton Town,0-3,0,3,2,2,3,-3,A
1977-01-24,1976,Luton Town,Hull City,2-1,2,1,2,2,3,1,H
1977-01-29,1976,Charlton Athletic,Notts County,1-1,1,1,2,2,2,0,D
1977-02-05,1976,Blackburn Rovers,Cardiff City,2-1,2,1,2,2,3,1,H
1977-02-05,1976,Carlisle United,Chelsea,0-1,0,1,2,2,1,-1,A
1977-02-05,1976,Fulham,Charlton Athletic,1-1,1,1,2,2,2,0,D
1977-02-05,1976,Luton Town,Burnley,2-0,2,0,2,2,2,2,H
1977-02-05,1976,Millwall,Bolton Wanderers,3-0,3,0,2,2,3,3,H
1977-02-05,1976,Notts County,Plymouth Argyle,2-0,2,0,2,2,2,2,H
1977-02-05,1976,Oldham Athletic,Bristol Rovers,4-0,4,0,2,2,4,4,H
1977-02-05,1976,Southampton,Hull City,2-2,2,2,2,2,4,0,D
1977-02-05,1976,Wolverhampton Wanderers,Nottingham Forest,2-1,2,1,2,2,3,1,H
1977-02-09,1976,Hereford United,Plymouth Argyle,1-1,1,1,2,2,2,0,D
1977-02-09,1976,Wolverhampton Wanderers,Sheffield United,2-1,2,1,2,2,3,1,H
1977-02-12,1976,Blackpool,Blackburn Rovers,1-1,1,1,2,2,2,0,D
1977-02-12,1976,Bolton Wanderers,Notts County,4-0,4,0,2,2,4,4,H
1977-02-12,1976,Bristol Rovers,Fulham,2-1,2,1,2,2,3,1,H
1977-02-12,1976,Burnley,Hereford United,1-1,1,1,2,2,2,0,D
1977-02-12,1976,Cardiff City,Oldham Athletic,3-1,3,1,2,2,4,2,H
1977-02-12,1976,Charlton Athletic,Wolverhampton Wanderers,1-1,1,1,2,2,2,0,D
1977-02-12,1976,Chelsea,Millwall,1-1,1,1,2,2,2,0,D
1977-02-12,1976,Hull City,Carlisle United,3-1,3,1,2,2,4,2,H
1977-02-12,1976,Nottingham Forest,Luton Town,1-2,1,2,2,2,3,-1,A
1977-02-12,1976,Plymouth Argyle,Leyton Orient,1-2,1,2,2,2,3,-1,A
1977-02-12,1976,Sheffield United,Southampton,2-2,2,2,2,2,4,0,D
1977-02-14,1976,Blackpool,Hereford United,2-1,2,1,2,2,3,1,H
1977-02-15,1976,Charlton Athletic,Leyton Orient,2-0,2,0,2,2,2,2,H
1977-02-15,1976,Hull City,Millwall,0-0,0,0,2,2,0,0,D
1977-02-15,1976,Luton Town,Blackburn Rovers,2-0,2,0,2,2,2,2,H
1977-02-15,1976,Notts County,Chelsea,2-1,2,1,2,2,3,1,H
1977-02-15,1976,Oldham Athletic,Burnley,3-1,3,1,2,2,4,2,H
1977-02-19,1976,Blackburn Rovers,Oldham Athletic,2-0,2,0,2,2,2,2,H
1977-02-19,1976,Carlisle United,Sheffield United,4-1,4,1,2,2,5,3,H
1977-02-19,1976,Chelsea,Plymouth Argyle,2-2,2,2,2,2,4,0,D
1977-02-19,1976,Hull City,Bolton Wanderers,2-2,2,2,2,2,4,0,D
1977-02-19,1976,Leyton Orient,Bristol Rovers,2-0,2,0,2,2,2,2,H
1977-02-19,1976,Luton Town,Charlton Athletic,2-0,2,0,2,2,2,2,H
1977-02-19,1976,Millwall,Blackpool,1-1,1,1,2,2,2,0,D
1977-02-19,1976,Notts County,Cardiff City,1-0,1,0,2,2,1,1,H
1977-02-19,1976,Southampton,Burnley,2-0,2,0,2,2,2,2,H
1977-02-19,1976,Wolverhampton Wanderers,Fulham,5-1,5,1,2,2,6,4,H
1977-02-25,1976,Charlton Athletic,Hereford United,1-1,1,1,2,2,2,0,D
1977-02-26,1976,Blackpool,Notts County,1-1,1,1,2,2,2,0,D
1977-02-26,1976,Bolton Wanderers,Chelsea,2-2,2,2,2,2,4,0,D
1977-02-26,1976,Burnley,Carlisle United,2-0,2,0,2,2,2,2,H
1977-02-26,1976,Fulham,Luton Town,1-2,1,2,2,2,3,-1,A
1977-02-26,1976,Plymouth Argyle,Millwall,2-2,2,2,2,2,4,0,D
1977-02-26,1976,Sheffield United,Hull City,1-1,1,1,2,2,2,0,D
1977-03-01,1976,Wolverhampton Wanderers,Blackpool,2-1,2,1,2,2,3,1,H
1977-03-02,1976,Blackburn Rovers,Plymouth Argyle,2-0,2,0,2,2,2,2,H
1977-03-02,1976,Cardiff City,Leyton Orient,0-1,0,1,2,2,1,-1,A
1977-03-02,1976,Hereford United,Nottingham Forest,0-1,0,1,2,2,1,-1,A
1977-03-02,1976,Notts County,Burnley,5-1,5,1,2,2,6,4,H
1977-03-05,1976,Blackburn Rovers,Sheffield United,1-0,1,0,2,2,1,1,H
1977-03-05,1976,Bolton Wanderers,Plymouth Argyle,3-0,3,0,2,2,3,3,H
1977-03-05,1976,Carlisle United,Nottingham Forest,1-1,1,1,2,2,2,0,D
1977-03-05,1976,Chelsea,Blackpool,2-2,2,2,2,2,4,0,D
1977-03-05,1976,Hereford United,Fulham,1-0,1,0,2,2,1,1,H
1977-03-05,1976,Hull City,Burnley,4-1,4,1,2,2,5,3,H
1977-03-05,1976,Leyton Orient,Oldham Athletic,0-2,0,2,2,2,2,-2,A
1977-03-05,1976,Luton Town,Wolverhampton Wanderers,2-0,2,0,2,2,2,2,H
1977-03-05,1976,Millwall,Cardiff City,0-2,0,2,2,2,2,-2,A
1977-03-05,1976,Notts County,Bristol Rovers,2-1,2,1,2,2,3,1,H
1977-03-05,1976,Southampton,Charlton Athletic,2-1,2,1,2,2,3,1,H
1977-03-08,1976,Bristol Rovers,Blackburn Rovers,0-0,0,0,2,2,0,0,D
1977-03-08,1976,Leyton Orient,Millwall,1-1,1,1,2,2,2,0,D
1977-03-08,1976,Luton Town,Oldham Athletic,1-0,1,0,2,2,1,1,H
1977-03-08,1976,Nottingham Forest,Notts County,1-2,1,2,2,2,3,-1,A
1977-03-08,1976,Sheffield United,Cardiff City,3-0,3,0,2,2,3,3,H
1977-03-11,1976,Charlton Athletic,Carlisle United,1-0,1,0,2,2,1,1,H
1977-03-11,1976,Fulham,Southampton,1-1,1,1,2,2,2,0,D
1977-03-12,1976,Blackburn Rovers,Leyton Orient,2-2,2,2,2,2,4,0,D
1977-03-12,1976,Blackpool,Bolton Wanderers,1-0,1,0,2,2,1,1,H
1977-03-12,1976,Bristol Rovers,Millwall,0-0,0,0,2,2,0,0,D
1977-03-12,1976,Burnley,Sheffield United,1-0,1,0,2,2,1,1,H
1977-03-12,1976,Cardiff City,Chelsea,1-3,1,3,2,2,4,-2,A
1977-03-12,1976,Luton Town,Plymouth Argyle,1-1,1,1,2,2,2,0,D
1977-03-12,1976,Nottingham Forest,Hull City,2-0,2,0,2,2,2,2,H
1977-03-12,1976,Oldham Athletic,Notts County,1-1,1,1,2,2,2,0,D
1977-03-12,1976,Wolverhampton Wanderers,Hereford United,2-1,2,1,2,2,3,1,H
1977-03-15,1976,Leyton Orient,Bolton Wanderers,2-2,2,2,2,2,4,0,D
1977-03-15,1976,Oldham Athletic,Wolverhampton Wanderers,0-2,0,2,2,2,2,-2,A
1977-03-19,1976,Carlisle United,Fulham,1-2,1,2,2,2,3,-1,A
1977-03-19,1976,Chelsea,Bristol Rovers,2-0,2,0,2,2,2,2,H
1977-03-19,1976,Hereford United,Luton Town,0-1,0,1,2,2,1,-1,A
1977-03-19,1976,Hull City,Charlton Athletic,0-0,0,0,2,2,0,0,D
1977-03-19,1976,Leyton Orient,Burnley,0-1,0,1,2,2,1,-1,A
1977-03-19,1976,Millwall,Oldham Athletic,2-1,2,1,2,2,3,1,H
1977-03-19,1976,Notts County,Blackburn Rovers,0-0,0,0,2,2,0,0,D
1977-03-19,1976,Plymouth Argyle,Blackpool,2-0,2,0,2,2,2,2,H
1977-03-19,1976,Sheffield United,Nottingham Forest,2-0,2,0,2,2,2,2,H
1977-03-22,1976,Bolton Wanderers,Carlisle United,3-4,3,4,2,2,7,-1,A
1977-03-22,1976,Nottingham Forest,Southampton,2-1,2,1,2,2,3,1,H
1977-03-22,1976,Oldham Athletic,Charlton Athletic,1-1,1,1,2,2,2,0,D
1977-03-23,1976,Hereford United,Sheffield United,2-2,2,2,2,2,4,0,D
1977-03-26,1976,Blackburn Rovers,Millwall,2-0,2,0,2,2,2,2,H
1977-03-26,1976,Cardiff City,Plymouth Argyle,0-1,0,1,2,2,1,-1,A
1977-03-26,1976,Fulham,Sheffield United,3-2,3,2,2,2,5,1,H
1977-03-26,1976,Leyton Orient,Notts County,1-0,1,0,2,2,1,1,H
1977-03-26,1976,Luton Town,Carlisle United,5-0,5,0,2,2,5,5,H
1977-03-26,1976,Nottingham Forest,Blackpool,3-0,3,0,2,2,3,3,H
1977-03-26,1976,Wolverhampton Wanderers,Hull City,2-1,2,1,2,2,3,1,H
1977-03-28,1976,Notts County,Sheffield United,2-1,2,1,2,2,3,1,H
1977-03-29,1976,Nottingham Forest,Leyton Orient,3-0,3,0,2,2,3,3,H
1977-04-01,1976,Notts County,Hereford United,3-2,3,2,2,2,5,1,H
1977-04-02,1976,Blackpool,Cardiff City,1-0,1,0,2,2,1,1,H
1977-04-02,1976,Bolton Wanderers,Oldham Athletic,3-0,3,0,2,2,3,3,H
1977-04-02,1976,Burnley,Nottingham Forest,0-1,0,1,2,2,1,-1,A
1977-04-02,1976,Chelsea,Blackburn Rovers,3-1,3,1,2,2,4,2,H
1977-04-02,1976,Hull City,Fulham,1-0,1,0,2,2,1,1,H
1977-04-02,1976,Millwall,Leyton Orient,0-1,0,1,2,2,1,-1,A
1977-04-02,1976,Plymouth Argyle,Bristol Rovers,1-1,1,1,2,2,2,0,D
1977-04-02,1976,Sheffield United,Charlton Athletic,3-0,3,0,2,2,3,3,H
1977-04-02,1976,Southampton,Luton Town,1-0,1,0,2,2,1,1,H
1977-04-05,1976,Sheffield United,Oldham Athletic,2-1,2,1,2,2,3,1,H
1977-04-05,1976,Wolverhampton Wanderers,Bristol Rovers,1-0,1,0,2,2,1,1,H
1977-04-06,1976,Blackburn Rovers,Carlisle United,1-3,1,3,2,2,4,-2,A
1977-04-06,1976,Hereford United,Cardiff City,2-2,2,2,2,2,4,0,D
1977-04-06,1976,Nottingham Forest,Bolton Wanderers,3-1,3,1,2,2,4,2,H
1977-04-08,1976,Burnley,Blackburn Rovers,3-1,3,1,2,2,4,2,H
1977-04-08,1976,Charlton Athletic,Millwall,3-2,3,2,2,2,5,1,H
1977-04-08,1976,Fulham,Chelsea,3-1,3,1,2,2,4,2,H
1977-04-08,1976,Hull City,Notts County,0-1,0,1,2,2,1,-1,A
1977-04-08,1976,Southampton,Plymouth Argyle,4-1,4,1,2,2,5,3,H
1977-04-09,1976,Blackpool,Burnley,1-1,1,1,2,2,2,0,D
1977-04-09,1976,Bolton Wanderers,Sheffield United,1-2,1,2,2,2,3,-1,A
1977-04-09,1976,Bristol Rovers,Southampton,2-3,2,3,2,2,5,-1,A
1977-04-09,1976,Cardiff City,Wolverhampton Wanderers,2-2,2,2,2,2,4,0,D
1977-04-09,1976,Chelsea,Luton Town,2-0,2,0,2,2,2,2,H
1977-04-09,1976,Leyton Orient,Charlton Athletic,0-0,0,0,2,2,0,0,D
1977-04-09,1976,Millwall,Fulham,0-0,0,0,2,2,0,0,D
1977-04-09,1976,Notts County,Nottingham Forest,1-1,1,1,2,2,2,0,D
1977-04-09,1976,Oldham Athletic,Hull City,3-0,3,0,2,2,3,3,H
1977-04-09,1976,Plymouth Argyle,Hereford United,2-1,2,1,2,2,3,1,H
1977-04-11,1976,Charlton Athletic,Chelsea,4-0,4,0,2,2,4,4,H
1977-04-11,1976,Fulham,Plymouth Argyle,2-0,2,0,2,2,2,2,H
1977-04-11,1976,Hereford United,Bristol Rovers,1-1,1,1,2,2,2,0,D
1977-04-11,1976,Luton Town,Leyton Orient,0-0,0,0,2,2,0,0,D
1977-04-11,1976,Southampton,Cardiff City,3-2,3,2,2,2,5,1,H
1977-04-11,1976,Wolverhampton Wanderers,Notts County,2-2,2,2,2,2,4,0,D
1977-04-12,1976,Burnley,Bolton Wanderers,0-0,0,0,2,2,0,0,D
1977-04-12,1976,Carlisle United,Oldham Athletic,1-1,1,1,2,2,2,0,D
1977-04-12,1976,Hull City,Blackburn Rovers,1-0,1,0,2,2,1,1,H
1977-04-12,1976,Luton Town,Millwall,1-2,1,2,2,2,3,-1,A
1977-04-12,1976,Sheffield United,Blackpool,1-5,1,5,2,2,6,-4,A
1977-04-16,1976,Blackburn Rovers,Wolverhampton Wanderers,0-2,0,2,2,2,2,-2,A
1977-04-16,1976,Blackpool,Charlton Athletic,2-2,2,2,2,2,4,0,D
1977-04-16,1976,Bolton Wanderers,Southampton,3-0,3,0,2,2,3,3,H
1977-04-16,1976,Bristol Rovers,Burnley,1-1,1,1,2,2,2,0,D
1977-04-16,1976,Cardiff City,Luton Town,4-2,4,2,2,2,6,2,H
1977-04-16,1976,Chelsea,Nottingham Forest,2-1,2,1,2,2,3,1,H
1977-04-16,1976,Leyton Orient,Sheffield United,0-2,0,2,2,2,2,-2,A
1977-04-16,1976,Millwall,Carlisle United,1-1,1,1,2,2,2,0,D
1977-04-16,1976,Notts County,Fulham,0-0,0,0,2,2,0,0,D
1977-04-16,1976,Oldham Athletic,Hereford United,3-5,3,5,2,2,8,-2,A
1977-04-16,1976,Plymouth Argyle,Hull City,1-2,1,2,2,2,3,-1,A
1977-04-19,1976,Carlisle United,Wolverhampton Wanderers,2-1,2,1,2,2,3,1,H
1977-04-19,1976,Hull City,Leyton Orient,1-1,1,1,2,2,2,0,D
1977-04-19,1976,Oldham Athletic,Chelsea,0-0,0,0,2,2,0,0,D
1977-04-20,1976,Blackburn Rovers,Southampton,3-0,3,0,2,2,3,3,H
1977-04-20,1976,Hereford United,Millwall,3-1,3,1,2,2,4,2,H
1977-04-22,1976,Charlton Athletic,Bolton Wanderers,1-1,1,1,2,2,2,0,D
1977-04-23,1976,Burnley,Chelsea,1-0,1,0,2,2,1,1,H
1977-04-23,1976,Carlisle United,Plymouth Argyle,3-1,3,1,2,2,4,2,H
1977-04-23,1976,Fulham,Blackpool,0-0,0,0,2,2,0,0,D
1977-04-23,1976,Hereford United,Blackburn Rovers,1-0,1,0,2,2,1,1,H
1977-04-23,1976,Hull City,Bristol Rovers,0-1,0,1,2,2,1,-1,A
1977-04-23,1976,Luton Town,Notts County,4-2,4,2,2,2,6,2,H
1977-04-23,1976,Nottingham Forest,Cardiff City,0-1,0,1,2,2,1,-1,A
1977-04-23,1976,Southampton,Oldham Athletic,4-0,4,0,2,2,4,4,H
1977-04-23,1976,Wolverhampton Wanderers,Leyton Orient,1-0,1,0,2,2,1,1,H
1977-04-26,1976,Charlton Athletic,Burnley,5-2,5,2,2,2,7,3,H
1977-04-26,1976,Leyton Orient,Southampton,2-3,2,3,2,2,5,-1,A
1977-04-26,1976,Wolverhampton Wanderers,Cardiff City,4-1,4,1,2,2,5,3,H
1977-04-27,1976,Nottingham Forest,Oldham Athletic,3-0,3,0,2,2,3,3,H
1977-04-30,1976,Blackburn Rovers,Charlton Athletic,0-0,0,0,2,2,0,0,D
1977-04-30,1976,Blackpool,Luton Town,1-0,1,0,2,2,1,1,H
1977-04-30,1976,Bolton Wanderers,Hereford United,3-1,3,1,2,2,4,2,H
1977-04-30,1976,Bristol Rovers,Nottingham Forest,1-1,1,1,2,2,2,0,D
1977-04-30,1976,Cardiff City,Burnley,0-1,0,1,2,2,1,-1,A
1977-04-30,1976,Chelsea,Sheffield United,4-0,4,0,2,2,4,4,H
1977-04-30,1976,Leyton Orient,Carlisle United,0-0,0,0,2,2,0,0,D
1977-04-30,1976,Millwall,Hull City,2-1,2,1,2,2,3,1,H
1977-04-30,1976,Notts County,Southampton,3-1,3,1,2,2,4,2,H
1977-04-30,1976,Oldham Athletic,Fulham,1-0,1,0,2,2,1,1,H
1977-04-30,1976,Plymouth Argyle,Wolverhampton Wanderers,0-0,0,0,2,2,0,0,D
1977-05-02,1976,Plymouth Argyle,Nottingham Forest,1-2,1,2,2,2,3,-1,A
1977-05-03,1976,Sheffield United,Millwall,1-1,1,1,2,2,2,0,D
1977-05-03,1976,Southampton,Wolverhampton Wanderers,1-0,1,0,2,2,1,1,H
1977-05-04,1976,Hereford United,Carlisle United,0-0,0,0,2,2,0,0,D
1977-05-07,1976,Burnley,Notts County,3-1,3,1,2,2,4,2,H
1977-05-07,1976,Carlisle United,Bristol Rovers,2-3,2,3,2,2,5,-1,A
1977-05-07,1976,Charlton Athletic,Oldham Athletic,2-1,2,1,2,2,3,1,H
1977-05-07,1976,Fulham,Leyton Orient,6-1,6,1,2,2,7,5,H
1977-05-07,1976,Hereford United,Blackpool,1-1,1,1,2,2,2,0,D
1977-05-07,1976,Hull City,Cardiff City,1-2,1,2,2,2,3,-1,A
1977-05-07,1976,Luton Town,Bolton Wanderers,1-1,1,1,2,2,2,0,D
1977-05-07,1976,Nottingham Forest,Millwall,1-0,1,0,2,2,1,1,H
1977-05-07,1976,Sheffield United,Plymouth Argyle,1-0,1,0,2,2,1,1,H
1977-05-07,1976,Southampton,Blackburn Rovers,2-0,2,0,2,2,2,2,H
1977-05-07,1976,Wolverhampton Wanderers,Chelsea,1-1,1,1,2,2,2,0,D
1977-05-10,1976,Bolton Wanderers,Cardiff City,2-1,2,1,2,2,3,1,H
1977-05-10,1976,Leyton Orient,Blackpool,0-1,0,1,2,2,1,-1,A
1977-05-11,1976,Hereford United,Southampton,2-0,2,0,2,2,2,2,H
1977-05-14,1976,Blackburn Rovers,Fulham,1-0,1,0,2,2,1,1,H
1977-05-14,1976,Blackpool,Southampton,1-0,1,0,2,2,1,1,H
1977-05-14,1976,Bolton Wanderers,Wolverhampton Wanderers,0-1,0,1,2,2,1,-1,A
1977-05-14,1976,Bristol Rovers,Sheffield United,3-1,3,1,2,2,4,2,H
1977-05-14,1976,Cardiff City,Carlisle United,1-1,1,1,2,2,2,0,D
1977-05-14,1976,Chelsea,Hull City,4-0,4,0,2,2,4,4,H
1977-05-14,1976,Leyton Orient,Hereford United,1-1,1,1,2,2,2,0,D
1977-05-14,1976,Millwall,Burnley,2-0,2,0,2,2,2,2,H
1977-05-14,1976,Notts County,Charlton Athletic,0-1,0,1,2,2,1,-1,A
1977-05-14,1976,Oldham Athletic,Luton Town,1-2,1,2,2,2,3,-1,A
1977-05-17,1976,Bristol Rovers,Bolton Wanderers,2-2,2,2,2,2,4,0,D
1977-05-17,1976,Leyton Orient,Hull City,1-1,1,1,2,2,2,0,D
1977-08-20,1977,Blackpool,Oldham Athletic,1-1,1,1,2,2,2,0,D
1977-08-20,1977,Burnley,Bolton Wanderers,0-1,0,1,2,2,1,-1,A
1977-08-20,1977,Cardiff City,Bristol Rovers,1-1,1,1,2,2,2,0,D
1977-08-20,1977,Fulham,Charlton Athletic,1-1,1,1,2,2,2,0,D
1977-08-20,1977,Hull City,Sunderland,3-0,3,0,2,2,3,3,H
1977-08-20,1977,Luton Town,Leyton Orient,1-0,1,0,2,2,1,1,H
1977-08-20,1977,Mansfield Town,Stoke City,2-1,2,1,2,2,3,1,H
1977-08-20,1977,Millwall,Crystal Palace,0-3,0,3,2,2,3,-3,A
1977-08-20,1977,Notts County,Blackburn Rovers,1-1,1,1,2,2,2,0,D
1977-08-20,1977,Southampton,Brighton & Hove Albion,1-1,1,1,2,2,2,0,D
1977-08-20,1977,Tottenham Hotspur,Sheffield United,4-2,4,2,2,2,6,2,H
1977-08-23,1977,Bolton Wanderers,Millwall,2-1,2,1,2,2,3,1,H
1977-08-23,1977,Bristol Rovers,Notts County,2-2,2,2,2,2,4,0,D
1977-08-23,1977,Crystal Palace,Mansfield Town,3-1,3,1,2,2,4,2,H
1977-08-23,1977,Leyton Orient,Blackpool,1-4,1,4,2,2,5,-3,A
1977-08-23,1977,Oldham Athletic,Fulham,2-0,2,0,2,2,2,2,H
1977-08-23,1977,Sheffield United,Hull City,2-0,2,0,2,2,2,2,H
1977-08-23,1977,Sunderland,Burnley,3-0,3,0,2,2,3,3,H
1977-08-24,1977,Blackburn Rovers,Tottenham Hotspur,0-0,0,0,2,2,0,0,D
1977-08-24,1977,Stoke City,Southampton,1-0,1,0,2,2,1,1,H
1977-08-27,1977,Blackburn Rovers,Cardiff City,3-0,3,0,2,2,3,3,H
1977-08-27,1977,Bolton Wanderers,Sheffield United,2-1,2,1,2,2,3,1,H
1977-08-27,1977,Brighton & Hove Albion,Millwall,3-2,3,2,2,2,5,1,H
1977-08-27,1977,Bristol Rovers,Fulham,0-0,0,0,2,2,0,0,D
1977-08-27,1977,Charlton Athletic,Blackpool,3-1,3,1,2,2,4,2,H
1977-08-27,1977,Crystal Palace,Hull City,0-1,0,1,2,2,1,-1,A
1977-08-27,1977,Oldham Athletic,Luton Town,1-0,1,0,2,2,1,1,H
1977-08-27,1977,Southampton,Mansfield Town,1-0,1,0,2,2,1,1,H
1977-08-27,1977,Stoke City,Burnley,2-1,2,1,2,2,3,1,H
1977-08-27,1977,Sunderland,Leyton Orient,1-1,1,1,2,2,2,0,D
1977-08-27,1977,Tottenham Hotspur,Notts County,2-1,2,1,2,2,3,1,H
1977-09-03,1977,Blackpool,Bristol Rovers,3-1,3,1,2,2,4,2,H
1977-09-03,1977,Burnley,Crystal Palace,1-1,1,1,2,2,2,0,D
1977-09-03,1977,Cardiff City,Tottenham Hotspur,0-0,0,0,2,2,0,0,D
1977-09-03,1977,Fulham,Blackburn Rovers,0-0,0,0,2,2,0,0,D
1977-09-03,1977,Hull City,Bolton Wanderers,0-0,0,0,2,2,0,0,D
1977-09-03,1977,Leyton Orient,Oldham Athletic,5-3,5,3,2,2,8,2,H
1977-09-03,1977,Luton Town,Charlton Athletic,7-1,7,1,2,2,8,6,H
1977-09-03,1977,Mansfield Town,Brighton & Hove Albion,1-2,1,2,2,2,3,-1,A
1977-09-03,1977,Millwall,Stoke City,0-0,0,0,2,2,0,0,D
1977-09-03,1977,Notts County,Southampton,2-3,2,3,2,2,5,-1,A
1977-09-03,1977,Sheffield United,Sunderland,1-1,1,1,2,2,2,0,D
1977-09-10,1977,Blackburn Rovers,Blackpool,1-2,1,2,2,2,3,-1,A
1977-09-10,1977,Bolton Wanderers,Oldham Athletic,1-0,1,0,2,2,1,1,H
1977-09-10,1977,Brighton & Hove Albion,Hull City,2-1,2,1,2,2,3,1,H
1977-09-10,1977,Bristol Rovers,Luton Town,1-2,1,2,2,2,3,-1,A
1977-09-10,1977,Charlton Athletic,Leyton Orient,2-1,2,1,2,2,3,1,H
1977-09-10,1977,Crystal Palace,Sunderland,2-2,2,2,2,2,4,0,D
1977-09-10,1977,Mansfield Town,Millwall,0-0,0,0,2,2,0,0,D
1977-09-10,1977,Notts County,Cardiff City,1-1,1,1,2,2,2,0,D
1977-09-10,1977,Southampton,Burnley,3-0,3,0,2,2,3,3,H
1977-09-10,1977,Stoke City,Sheffield United,4-0,4,0,2,2,4,4,H
1977-09-10,1977,Tottenham Hotspur,Fulham,1-0,1,0,2,2,1,1,H
1977-09-17,1977,Blackpool,Tottenham Hotspur,0-2,0,2,2,2,2,-2,A
1977-09-17,1977,Burnley,Brighton & Hove Albion,0-0,0,0,2,2,0,0,D
1977-09-17,1977,Cardiff City,Mansfield Town,1-1,1,1,2,2,2,0,D
1977-09-17,1977,Fulham,Notts County,5-1,5,1,2,2,6,4,H
1977-09-17,1977,Hull City,Stoke City,0-0,0,0,2,2,0,0,D
1977-09-17,1977,Leyton Orient,Bristol Rovers,2-1,2,1,2,2,3,1,H
1977-09-17,1977,Luton Town,Blackburn Rovers,0-0,0,0,2,2,0,0,D
1977-09-17,1977,Millwall,Southampton,3-0,3,0,2,2,3,3,H
1977-09-17,1977,Oldham Athletic,Charlton Athletic,1-1,1,1,2,2,2,0,D
1977-09-17,1977,Sheffield United,Crystal Palace,0-2,0,2,2,2,2,-2,A
1977-09-17,1977,Sunderland,Bolton Wanderers,0-2,0,2,2,2,2,-2,A
1977-09-24,1977,Blackburn Rovers,Leyton Orient,1-0,1,0,2,2,1,1,H
1977-09-24,1977,Brighton & Hove Albion,Sheffield United,2-1,2,1,2,2,3,1,H
1977-09-24,1977,Bristol Rovers,Oldham Athletic,0-0,0,0,2,2,0,0,D
1977-09-24,1977,Cardiff City,Fulham,3-1,3,1,2,2,4,2,H
1977-09-24,1977,Crystal Palace,Bolton Wanderers,2-1,2,1,2,2,3,1,H
1977-09-24,1977,Mansfield Town,Burnley,4-1,4,1,2,2,5,3,H
1977-09-24,1977,Millwall,Charlton Athletic,1-1,1,1,2,2,2,0,D
1977-09-24,1977,Notts County,Blackpool,1-1,1,1,2,2,2,0,D
1977-09-24,1977,Southampton,Hull City,1-0,1,0,2,2,1,1,H
1977-09-24,1977,Stoke City,Sunderland,0-0,0,0,2,2,0,0,D
1977-09-24,1977,Tottenham Hotspur,Luton Town,2-0,2,0,2,2,2,2,H
1977-09-27,1977,Brighton & Hove Albion,Luton Town,3-2,3,2,2,2,5,1,H
1977-09-30,1977,Charlton Athletic,Bristol Rovers,3-1,3,1,2,2,4,2,H
1977-10-01,1977,Blackpool,Cardiff City,3-0,3,0,2,2,3,3,H
1977-10-01,1977,Bolton Wanderers,Stoke City,1-1,1,1,2,2,2,0,D
1977-10-01,1977,Burnley,Millwall,0-2,0,2,2,2,2,-2,A
1977-10-01,1977,Crystal Palace,Fulham,2-3,2,3,2,2,5,-1,A
1977-10-01,1977,Hull City,Mansfield Town,0-2,0,2,2,2,2,-2,A
1977-10-01,1977,Leyton Orient,Tottenham Hotspur,1-1,1,1,2,2,2,0,D
1977-10-01,1977,Luton Town,Notts County,2-0,2,0,2,2,2,2,H
1977-10-01,1977,Oldham Athletic,Blackburn Rovers,0-2,0,2,2,2,2,-2,A
1977-10-01,1977,Sheffield United,Southampton,3-2,3,2,2,2,5,1,H
1977-10-01,1977,Sunderland,Brighton & Hove Albion,0-2,0,2,2,2,2,-2,A
1977-10-03,1977,Bolton Wanderers,Blackburn Rovers,4-2,4,2,2,2,6,2,H
1977-10-04,1977,Blackpool,Crystal Palace,3-1,3,1,2,2,4,2,H
1977-10-04,1977,Bristol Rovers,Mansfield Town,3-1,3,1,2,2,4,2,H
1977-10-04,1977,Charlton Athletic,Brighton & Hove Albion,4-3,4,3,2,2,7,1,H
1977-10-04,1977,Fulham,Burnley,4-1,4,1,2,2,5,3,H
1977-10-04,1977,Hull City,Tottenham Hotspur,2-0,2,0,2,2,2,2,H
1977-10-04,1977,Luton Town,Millwall,1-0,1,0,2,2,1,1,H
1977-10-04,1977,Oldham Athletic,Stoke City,1-1,1,1,2,2,2,0,D
1977-10-04,1977,Sheffield United,Notts County,4-1,4,1,2,2,5,3,H
1977-10-04,1977,Southampton,Leyton Orient,1-0,1,0,2,2,1,1,H
1977-10-04,1977,Sunderland,Cardiff City,1-1,1,1,2,2,2,0,D
1977-10-08,1977,Blackburn Rovers,Charlton Athletic,2-1,2,1,2,2,3,1,H
1977-10-08,1977,Brighton & Hove Albion,Bolton Wanderers,1-2,1,2,2,2,3,-1,A
1977-10-08,1977,Burnley,Bristol Rovers,3-1,3,1,2,2,4,2,H
1977-10-08,1977,Cardiff City,Luton Town,1-4,1,4,2,2,5,-3,A
1977-10-08,1977,Fulham,Blackpool,1-1,1,1,2,2,2,0,D
1977-10-08,1977,Mansfield Town,Sheffield United,1-1,1,1,2,2,2,0,D
1977-10-08,1977,Millwall,Hull City,1-1,1,1,2,2,2,0,D
1977-10-08,1977,Notts County,Leyton Orient,1-1,1,1,2,2,2,0,D
1977-10-08,1977,Southampton,Sunderland,4-2,4,2,2,2,6,2,H
1977-10-08,1977,Stoke City,Crystal Palace,0-2,0,2,2,2,2,-2,A
1977-10-08,1977,Tottenham Hotspur,Oldham Athletic,5-1,5,1,2,2,6,4,H
1977-10-15,1977,Bolton Wanderers,Mansfield Town,2-0,2,0,2,2,2,2,H
1977-10-15,1977,Bristol Rovers,Blackburn Rovers,4-1,4,1,2,2,5,3,H
1977-10-15,1977,Charlton Athletic,Tottenham Hotspur,4-1,4,1,2,2,5,3,H
1977-10-15,1977,Crystal Palace,Southampton,1-2,1,2,2,2,3,-1,A
1977-10-15,1977,Hull City,Blackpool,2-0,2,0,2,2,2,2,H
1977-10-15,1977,Leyton Orient,Cardiff City,2-1,2,1,2,2,3,1,H
1977-10-15,1977,Luton Town,Fulham,1-0,1,0,2,2,1,1,H
1977-10-15,1977,Oldham Athletic,Notts County,2-1,2,1,2,2,3,1,H
1977-10-15,1977,Sheffield United,Burnley,2-1,2,1,2,2,3,1,H
1977-10-15,1977,Stoke City,Brighton & Hove Albion,1-0,1,0,2,2,1,1,H
1977-10-15,1977,Sunderland,Millwall,2-0,2,0,2,2,2,2,H
1977-10-22,1977,Blackburn Rovers,Stoke City,2-1,2,1,2,2,3,1,H
1977-10-22,1977,Blackpool,Luton Town,2-1,2,1,2,2,3,1,H
1977-10-22,1977,Brighton & Hove Albion,Crystal Palace,1-1,1,1,2,2,2,0,D
1977-10-22,1977,Burnley,Hull City,1-1,1,1,2,2,2,0,D
1977-10-22,1977,Cardiff City,Oldham Athletic,1-0,1,0,2,2,1,1,H
1977-10-22,1977,Fulham,Leyton Orient,1-2,1,2,2,2,3,-1,A
1977-10-22,1977,Mansfield Town,Sunderland,1-2,1,2,2,2,3,-1,A
1977-10-22,1977,Millwall,Sheffield United,1-1,1,1,2,2,2,0,D
1977-10-22,1977,Notts County,Charlton Athletic,2-0,2,0,2,2,2,2,H
1977-10-22,1977,Southampton,Bolton Wanderers,2-2,2,2,2,2,4,0,D
1977-10-22,1977,Tottenham Hotspur,Bristol Rovers,9-0,9,0,2,2,9,9,H
1977-10-29,1977,Bolton Wanderers,Luton Town,2-1,2,1,2,2,3,1,H
1977-10-29,1977,Brighton & Hove Albion,Cardiff City,4-0,4,0,2,2,4,4,H
1977-10-29,1977,Bristol Rovers,Southampton,0-0,0,0,2,2,0,0,D
1977-10-29,1977,Burnley,Blackpool,0-1,0,1,2,2,1,-1,A
1977-10-29,1977,Crystal Palace,Charlton Athletic,1-1,1,1,2,2,2,0,D
1977-10-29,1977,Hull City,Blackburn Rovers,0-1,0,1,2,2,1,-1,A
1977-10-29,1977,Leyton Orient,Millwall,0-0,0,0,2,2,0,0,D
1977-10-29,1977,Mansfield Town,Notts County,1-3,1,3,2,2,4,-2,A
1977-10-29,1977,Sheffield United,Fulham,2-1,2,1,2,2,3,1,H
1977-10-29,1977,Stoke City,Tottenham Hotspur,1-3,1,3,2,2,4,-2,A
1977-10-29,1977,Sunderland,Oldham Athletic,3-1,3,1,2,2,4,2,H
1977-11-05,1977,Blackburn Rovers,Southampton,2-1,2,1,2,2,3,1,H
1977-11-05,1977,Blackpool,Sheffield United,1-1,1,1,2,2,2,0,D
1977-11-05,1977,Bristol Rovers,Millwall,2-0,2,0,2,2,2,2,H
1977-11-05,1977,Cardiff City,Stoke City,2-0,2,0,2,2,2,2,H
1977-11-05,1977,Charlton Athletic,Mansfield Town,2-2,2,2,2,2,4,0,D
1977-11-05,1977,Fulham,Sunderland,3-3,3,3,2,2,6,0,D
1977-11-05,1977,Leyton Orient,Bolton Wanderers,1-1,1,1,2,2,2,0,D
1977-11-05,1977,Luton Town,Hull City,1-1,1,1,2,2,2,0,D
1977-11-05,1977,Notts County,Brighton & Hove Albion,1-0,1,0,2,2,1,1,H
1977-11-05,1977,Oldham Athletic,Crystal Palace,1-1,1,1,2,2,2,0,D
1977-11-05,1977,Tottenham Hotspur,Burnley,3-0,3,0,2,2,3,3,H
1977-11-12,1977,Bolton Wanderers,Charlton Athletic,2-1,2,1,2,2,3,1,H
1977-11-12,1977,Brighton & Hove Albion,Leyton Orient,1-0,1,0,2,2,1,1,H
1977-11-12,1977,Burnley,Notts County,3-1,3,1,2,2,4,2,H
1977-11-12,1977,Crystal Palace,Tottenham Hotspur,1-2,1,2,2,2,3,-1,A
1977-11-12,1977,Hull City,Cardiff City,4-1,4,1,2,2,5,3,H
1977-11-12,1977,Mansfield Town,Luton Town,3-1,3,1,2,2,4,2,H
1977-11-12,1977,Millwall,Blackburn Rovers,1-1,1,1,2,2,2,0,D
1977-11-12,1977,Sheffield United,Oldham Athletic,1-0,1,0,2,2,1,1,H
1977-11-12,1977,Southampton,Blackpool,2-0,2,0,2,2,2,2,H
1977-11-12,1977,Stoke City,Fulham,2-0,2,0,2,2,2,2,H
1977-11-12,1977,Sunderland,Bristol Rovers,5-1,5,1,2,2,6,4,H
1977-11-19,1977,Blackburn Rovers,Mansfield Town,3-1,3,1,2,2,4,2,H
1977-11-19,1977,Blackpool,Millwall,2-2,2,2,2,2,4,0,D
1977-11-19,1977,Bristol Rovers,Bolton Wanderers,0-1,0,1,2,2,1,-1,A
1977-11-19,1977,Cardiff City,Burnley,2-1,2,1,2,2,3,1,H
1977-11-19,1977,Charlton Athletic,Sheffield United,3-0,3,0,2,2,3,3,H
1977-11-19,1977,Fulham,Hull City,2-0,2,0,2,2,2,2,H
1977-11-19,1977,Leyton Orient,Crystal Palace,0-0,0,0,2,2,0,0,D
1977-11-19,1977,Luton Town,Stoke City,1-2,1,2,2,2,3,-1,A
1977-11-19,1977,Notts County,Sunderland,2-2,2,2,2,2,4,0,D
1977-11-19,1977,Oldham Athletic,Southampton,1-1,1,1,2,2,2,0,D
1977-11-19,1977,Tottenham Hotspur,Brighton & Hove Albion,0-0,0,0,2,2,0,0,D
1977-11-26,1977,Bolton Wanderers,Tottenham Hotspur,1-0,1,0,2,2,1,1,H
1977-11-26,1977,Brighton & Hove Albion,Blackburn Rovers,2-2,2,2,2,2,4,0,D
1977-11-26,1977,Burnley,Leyton Orient,0-0,0,0,2,2,0,0,D
1977-11-26,1977,Crystal Palace,Cardiff City,2-0,2,0,2,2,2,2,H
1977-11-26,1977,Hull City,Charlton Athletic,0-2,0,2,2,2,2,-2,A
1977-11-26,1977,Mansfield Town,Oldham Athletic,0-2,0,2,2,2,2,-2,A
1977-11-26,1977,Millwall,Notts County,0-0,0,0,2,2,0,0,D
1977-11-26,1977,Sheffield United,Bristol Rovers,1-1,1,1,2,2,2,0,D
1977-11-26,1977,Southampton,Fulham,2-0,2,0,2,2,2,2,H
1977-11-26,1977,Stoke City,Blackpool,1-2,1,2,2,2,3,-1,A
1977-11-26,1977,Sunderland,Luton Town,1-1,1,1,2,2,2,0,D
1977-12-03,1977,Blackburn Rovers,Crystal Palace,3-0,3,0,2,2,3,3,H
1977-12-03,1977,Blackpool,Brighton & Hove Albion,0-1,0,1,2,2,1,-1,A
1977-12-03,1977,Bristol Rovers,Hull City,1-1,1,1,2,2,2,0,D
1977-12-03,1977,Cardiff City,Sheffield United,1-6,1,6,2,2,7,-5,A
1977-12-03,1977,Charlton Athletic,Sunderland,3-2,3,2,2,2,5,1,H
1977-12-03,1977,Fulham,Bolton Wanderers,2-0,2,0,2,2,2,2,H
1977-12-03,1977,Leyton Orient,Mansfield Town,4-2,4,2,2,2,6,2,H
1977-12-03,1977,Luton Town,Burnley,1-2,1,2,2,2,3,-1,A
1977-12-03,1977,Notts County,Stoke City,2-0,2,0,2,2,2,2,H
1977-12-03,1977,Oldham Athletic,Millwall,2-2,2,2,2,2,4,0,D
1977-12-03,1977,Tottenham Hotspur,Southampton,0-0,0,0,2,2,0,0,D
1977-12-10,1977,Bolton Wanderers,Cardiff City,6-3,6,3,2,2,9,3,H
1977-12-10,1977,Brighton & Hove Albion,Oldham Athletic,1-1,1,1,2,2,2,0,D
1977-12-10,1977,Burnley,Charlton Athletic,1-0,1,0,2,2,1,1,H
1977-12-10,1977,Crystal Palace,Notts County,2-0,2,0,2,2,2,2,H
1977-12-10,1977,Hull City,Leyton Orient,2-2,2,2,2,2,4,0,D
1977-12-10,1977,Mansfield Town,Blackpool,1-3,1,3,2,2,4,-2,A
1977-12-10,1977,Millwall,Fulham,0-3,0,3,2,2,3,-3,A
1977-12-10,1977,Sheffield United,Blackburn Rovers,2-0,2,0,2,2,2,2,H
1977-12-10,1977,Southampton,Luton Town,0-1,0,1,2,2,1,-1,A
1977-12-10,1977,Stoke City,Bristol Rovers,3-2,3,2,2,2,5,1,H
1977-12-10,1977,Sunderland,Tottenham Hotspur,1-2,1,2,2,2,3,-1,A
1977-12-17,1977,Blackburn Rovers,Millwall,2-1,2,1,2,2,3,1,H
1977-12-17,1977,Blackpool,Southampton,0-1,0,1,2,2,1,-1,A
1977-12-17,1977,Bristol Rovers,Sunderland,3-2,3,2,2,2,5,1,H
1977-12-17,1977,Cardiff City,Hull City,0-0,0,0,2,2,0,0,D
1977-12-17,1977,Charlton Athletic,Bolton Wanderers,2-1,2,1,2,2,3,1,H
1977-12-17,1977,Fulham,Stoke City,3-0,3,0,2,2,3,3,H
1977-12-17,1977,Leyton Orient,Brighton & Hove Albion,0-1,0,1,2,2,1,-1,A
1977-12-17,1977,Luton Town,Mansfield Town,1-1,1,1,2,2,2,0,D
1977-12-17,1977,Notts County,Burnley,3-0,3,0,2,2,3,3,H
1977-12-17,1977,Oldham Athletic,Sheffield United,3-0,3,0,2,2,3,3,H
1977-12-17,1977,Tottenham Hotspur,Crystal Palace,2-2,2,2,2,2,4,0,D
1977-12-26,1977,Bolton Wanderers,Notts County,2-0,2,0,2,2,2,2,H
1977-12-26,1977,Brighton & Hove Albion,Bristol Rovers,1-1,1,1,2,2,2,0,D
1977-12-26,1977,Burnley,Blackburn Rovers,2-3,2,3,2,2,5,-1,A
1977-12-26,1977,Crystal Palace,Luton Town,3-3,3,3,2,2,6,0,D
1977-12-26,1977,Hull City,Oldham Athletic,0-1,0,1,2,2,1,-1,A
1977-12-26,1977,Mansfield Town,Fulham,2-1,2,1,2,2,3,1,H
1977-12-26,1977,Millwall,Tottenham Hotspur,1-3,1,3,2,2,4,-2,A
1977-12-26,1977,Sheffield United,Leyton Orient,2-0,2,0,2,2,2,2,H
1977-12-26,1977,Southampton,Cardiff City,3-1,3,1,2,2,4,2,H
1977-12-26,1977,Stoke City,Charlton Athletic,4-0,4,0,2,2,4,4,H
1977-12-26,1977,Sunderland,Blackpool,2-1,2,1,2,2,3,1,H
1977-12-27,1977,Blackburn Rovers,Sunderland,1-1,1,1,2,2,2,0,D
1977-12-27,1977,Blackpool,Bolton Wanderers,0-2,0,2,2,2,2,-2,A
1977-12-27,1977,Bristol Rovers,Crystal Palace,3-0,3,0,2,2,3,3,H
1977-12-27,1977,Charlton Athletic,Southampton,1-3,1,3,2,2,4,-2,A
1977-12-27,1977,Leyton Orient,Stoke City,2-0,2,0,2,2,2,2,H
1977-12-27,1977,Luton Town,Sheffield United,4-0,4,0,2,2,4,4,H
1977-12-27,1977,Notts County,Hull City,2-1,2,1,2,2,3,1,H
1977-12-27,1977,Oldham Athletic,Burnley,2-0,2,0,2,2,2,2,H
1977-12-27,1977,Tottenham Hotspur,Mansfield Town,1-1,1,1,2,2,2,0,D
1977-12-28,1977,Cardiff City,Millwall,4-1,4,1,2,2,5,3,H
1977-12-28,1977,Fulham,Brighton & Hove Albion,2-1,2,1,2,2,3,1,H
1977-12-30,1977,Fulham,Oldham Athletic,0-2,0,2,2,2,2,-2,A
1977-12-31,1977,Blackpool,Leyton Orient,0-0,0,0,2,2,0,0,D
1977-12-31,1977,Burnley,Sunderland,0-0,0,0,2,2,0,0,D
1977-12-31,1977,Cardiff City,Charlton Athletic,1-0,1,0,2,2,1,1,H
1977-12-31,1977,Hull City,Sheffield United,2-3,2,3,2,2,5,-1,A
1977-12-31,1977,Luton Town,Brighton & Hove Albion,1-0,1,0,2,2,1,1,H
1977-12-31,1977,Mansfield Town,Crystal Palace,1-3,1,3,2,2,4,-2,A
1977-12-31,1977,Millwall,Bolton Wanderers,1-0,1,0,2,2,1,1,H
1977-12-31,1977,Notts County,Bristol Rovers,3-2,3,2,2,2,5,1,H
1977-12-31,1977,Southampton,Stoke City,1-0,1,0,2,2,1,1,H
1977-12-31,1977,Tottenham Hotspur,Blackburn Rovers,4-0,4,0,2,2,4,4,H
1978-01-02,1977,Blackburn Rovers,Notts County,1-0,1,0,2,2,1,1,H
1978-01-02,1977,Bolton Wanderers,Burnley,1-2,1,2,2,2,3,-1,A
1978-01-02,1977,Brighton & Hove Albion,Southampton,1-1,1,1,2,2,2,0,D
1978-01-02,1977,Bristol Rovers,Cardiff City,3-2,3,2,2,2,5,1,H
1978-01-02,1977,Charlton Athletic,Fulham,0-1,0,1,2,2,1,-1,A
1978-01-02,1977,Crystal Palace,Millwall,1-0,1,0,2,2,1,1,H
1978-01-02,1977,Leyton Orient,Luton Town,0-0,0,0,2,2,0,0,D
1978-01-02,1977,Oldham Athletic,Blackpool,2-1,2,1,2,2,3,1,H
1978-01-02,1977,Sheffield United,Tottenham Hotspur,2-2,2,2,2,2,4,0,D
1978-01-02,1977,Stoke City,Mansfield Town,1-1,1,1,2,2,2,0,D
1978-01-02,1977,Sunderland,Hull City,2-0,2,0,2,2,2,2,H
1978-01-14,1977,Blackpool,Charlton Athletic,5-1,5,1,2,2,6,4,H
1978-01-14,1977,Burnley,Stoke City,1-0,1,0,2,2,1,1,H
1978-01-14,1977,Cardiff City,Blackburn Rovers,1-1,1,1,2,2,2,0,D
1978-01-14,1977,Fulham,Bristol Rovers,1-1,1,1,2,2,2,0,D
1978-01-14,1977,Hull City,Crystal Palace,1-0,1,0,2,2,1,1,H
1978-01-14,1977,Leyton Orient,Sunderland,2-2,2,2,2,2,4,0,D
1978-01-14,1977,Luton Town,Oldham Athletic,0-1,0,1,2,2,1,-1,A
1978-01-14,1977,Mansfield Town,Southampton,1-2,1,2,2,2,3,-1,A
1978-01-14,1977,Millwall,Brighton & Hove Albion,0-1,0,1,2,2,1,-1,A
1978-01-14,1977,Notts County,Tottenham Hotspur,3-3,3,3,2,2,6,0,D
1978-01-14,1977,Sheffield United,Bolton Wanderers,1-5,1,5,2,2,6,-4,A
1978-01-21,1977,Bolton Wanderers,Hull City,1-0,1,0,2,2,1,1,H
1978-01-21,1977,Brighton & Hove Albion,Mansfield Town,5-1,5,1,2,2,6,4,H
1978-01-21,1977,Bristol Rovers,Blackpool,2-0,2,0,2,2,2,2,H
1978-01-21,1977,Charlton Athletic,Luton Town,0-0,0,0,2,2,0,0,D
1978-01-21,1977,Crystal Palace,Burnley,1-1,1,1,2,2,2,0,D
1978-01-21,1977,Oldham Athletic,Leyton Orient,2-1,2,1,2,2,3,1,H
1978-01-21,1977,Southampton,Notts County,3-1,3,1,2,2,4,2,H
1978-01-21,1977,Sunderland,Sheffield United,5-1,5,1,2,2,6,4,H
1978-01-21,1977,Tottenham Hotspur,Cardiff City,2-1,2,1,2,2,3,1,H
1978-01-28,1977,Cardiff City,Sunderland,5-2,5,2,2,2,7,3,H
1978-02-04,1977,Blackpool,Blackburn Rovers,5-2,5,2,2,2,7,3,H
1978-02-04,1977,Burnley,Southampton,3-3,3,3,2,2,6,0,D
1978-02-04,1977,Fulham,Tottenham Hotspur,1-1,1,1,2,2,2,0,D
1978-02-04,1977,Hull City,Brighton & Hove Albion,1-1,1,1,2,2,2,0,D
1978-02-08,1977,Luton Town,Bristol Rovers,1-1,1,1,2,2,2,0,D
1978-02-10,1977,Charlton Athletic,Oldham Athletic,2-2,2,2,2,2,4,0,D
1978-02-11,1977,Blackburn Rovers,Luton Town,2-0,2,0,2,2,2,2,H
1978-02-11,1977,Brighton & Hove Albion,Burnley,2-1,2,1,2,2,3,1,H
1978-02-11,1977,Bristol Rovers,Leyton Orient,2-1,2,1,2,2,3,1,H
1978-02-11,1977,Crystal Palace,Sheffield United,1-0,1,0,2,2,1,1,H
1978-02-11,1977,Mansfield Town,Cardiff City,2-2,2,2,2,2,4,0,D
1978-02-11,1977,Southampton,Millwall,2-3,2,3,2,2,5,-1,A
1978-02-11,1977,Tottenham Hotspur,Blackpool,2-2,2,2,2,2,4,0,D
1978-02-18,1977,Oldham Athletic,Bolton Wanderers,2-2,2,2,2,2,4,0,D
1978-02-22,1977,Luton Town,Tottenham Hotspur,1-4,1,4,2,2,5,-3,A
1978-02-25,1977,Blackburn Rovers,Oldham Athletic,4-2,4,2,2,2,6,2,H
1978-02-25,1977,Brighton & Hove Albion,Sunderland,2-1,2,1,2,2,3,1,H
1978-02-25,1977,Bristol Rovers,Charlton Athletic,2-2,2,2,2,2,4,0,D
1978-02-25,1977,Cardiff City,Blackpool,2-1,2,1,2,2,3,1,H
1978-02-25,1977,Fulham,Crystal Palace,1-1,1,1,2,2,2,0,D
1978-02-25,1977,Mansfield Town,Hull City,1-0,1,0,2,2,1,1,H
1978-02-25,1977,Millwall,Burnley,1-1,1,1,2,2,2,0,D
1978-02-25,1977,Notts County,Luton Town,2-0,2,0,2,2,2,2,H
1978-02-25,1977,Southampton,Sheffield United,2-1,2,1,2,2,3,1,H
1978-02-25,1977,Stoke City,Bolton Wanderers,0-0,0,0,2,2,0,0,D
1978-02-25,1977,Tottenham Hotspur,Leyton Orient,1-1,1,1,2,2,2,0,D
1978-02-28,1977,Charlton Athletic,Millwall,0-2,0,2,2,2,2,-2,A
1978-03-04,1977,Bolton Wanderers,Brighton & Hove Albion,1-1,1,1,2,2,2,0,D
1978-03-04,1977,Bristol Rovers,Burnley,2-2,2,2,2,2,4,0,D
1978-03-04,1977,Charlton Athletic,Blackburn Rovers,2-2,2,2,2,2,4,0,D
1978-03-04,1977,Crystal Palace,Stoke City,0-1,0,1,2,2,1,-1,A
1978-03-04,1977,Hull City,Millwall,3-2,3,2,2,2,5,1,H
1978-03-04,1977,Leyton Orient,Notts County,0-0,0,0,2,2,0,0,D
1978-03-04,1977,Luton Town,Cardiff City,3-1,3,1,2,2,4,2,H
1978-03-04,1977,Oldham Athletic,Tottenham Hotspur,1-1,1,1,2,2,2,0,D
1978-03-04,1977,Sheffield United,Mansfield Town,2-0,2,0,2,2,2,2,H
1978-03-04,1977,Sunderland,Southampton,0-0,0,0,2,2,0,0,D
1978-03-07,1977,Blackpool,Notts County,2-2,2,2,2,2,4,0,D
1978-03-07,1977,Bolton Wanderers,Sunderland,2-0,2,0,2,2,2,2,H
1978-03-07,1977,Fulham,Cardiff City,1-0,1,0,2,2,1,1,H
1978-03-08,1977,Stoke City,Hull City,1-0,1,0,2,2,1,1,H
1978-03-10,1977,Fulham,Luton Town,1-0,1,0,2,2,1,1,H
1978-03-11,1977,Blackburn Rovers,Bristol Rovers,0-1,0,1,2,2,1,-1,A
1978-03-11,1977,Blackpool,Hull City,3-0,3,0,2,2,3,3,H
1978-03-11,1977,Brighton & Hove Albion,Stoke City,2-1,2,1,2,2,3,1,H
1978-03-11,1977,Burnley,Sheffield United,4-1,4,1,2,2,5,3,H
1978-03-11,1977,Mansfield Town,Bolton Wanderers,0-1,0,1,2,2,1,-1,A
1978-03-11,1977,Notts County,Oldham Athletic,3-2,3,2,2,2,5,1,H
1978-03-11,1977,Southampton,Crystal Palace,2-0,2,0,2,2,2,2,H
1978-03-11,1977,Tottenham Hotspur,Charlton Athletic,2-1,2,1,2,2,3,1,H
1978-03-14,1977,Burnley,Mansfield Town,2-0,2,0,2,2,2,2,H
1978-03-14,1977,Sheffield United,Stoke City,1-2,1,2,2,2,3,-1,A
1978-03-14,1977,Sunderland,Crystal Palace,0-0,0,0,2,2,0,0,D
1978-03-15,1977,Blackburn Rovers,Fulham,4-0,4,0,2,2,4,4,H
1978-03-17,1977,Charlton Athletic,Notts County,0-0,0,0,2,2,0,0,D
1978-03-17,1977,Leyton Orient,Fulham,1-1,1,1,2,2,2,0,D
1978-03-18,1977,Bolton Wanderers,Southampton,0-0,0,0,2,2,0,0,D
1978-03-18,1977,Bristol Rovers,Tottenham Hotspur,2-3,2,3,2,2,5,-1,A
1978-03-18,1977,Crystal Palace,Brighton & Hove Albion,0-0,0,0,2,2,0,0,D
1978-03-18,1977,Hull City,Burnley,1-3,1,3,2,2,4,-2,A
1978-03-18,1977,Luton Town,Blackpool,4-0,4,0,2,2,4,4,H
1978-03-18,1977,Oldham Athletic,Cardiff City,1-1,1,1,2,2,2,0,D
1978-03-18,1977,Sheffield United,Millwall,5-2,5,2,2,2,7,3,H
1978-03-18,1977,Stoke City,Blackburn Rovers,4-2,4,2,2,2,6,2,H
1978-03-18,1977,Sunderland,Mansfield Town,1-0,1,0,2,2,1,1,H
1978-03-21,1977,Luton Town,Bolton Wanderers,2-1,2,1,2,2,3,1,H
1978-03-21,1977,Millwall,Leyton Orient,2-0,2,0,2,2,2,2,H
1978-03-21,1977,Notts County,Mansfield Town,1-0,1,0,2,2,1,1,H
1978-03-22,1977,Tottenham Hotspur,Stoke City,3-1,3,1,2,2,4,2,H
1978-03-24,1977,Blackburn Rovers,Hull City,1-1,1,1,2,2,2,0,D
1978-03-24,1977,Cardiff City,Brighton & Hove Albion,1-0,1,0,2,2,1,1,H
1978-03-24,1977,Charlton Athletic,Crystal Palace,1-0,1,0,2,2,1,1,H
1978-03-24,1977,Fulham,Sheffield United,2-0,2,0,2,2,2,2,H
1978-03-24,1977,Oldham Athletic,Sunderland,1-1,1,1,2,2,2,0,D
1978-03-25,1977,Bolton Wanderers,Blackpool,2-1,2,1,2,2,3,1,H
1978-03-25,1977,Brighton & Hove Albion,Fulham,2-0,2,0,2,2,2,2,H
1978-03-25,1977,Burnley,Oldham Athletic,4-1,4,1,2,2,5,3,H
1978-03-25,1977,Crystal Palace,Bristol Rovers,1-0,1,0,2,2,1,1,H
1978-03-25,1977,Hull City,Notts County,1-1,1,1,2,2,2,0,D
1978-03-25,1977,Mansfield Town,Tottenham Hotspur,3-3,3,3,2,2,6,0,D
1978-03-25,1977,Millwall,Cardiff City,1-1,1,1,2,2,2,0,D
1978-03-25,1977,Sheffield United,Luton Town,4-1,4,1,2,2,5,3,H
1978-03-25,1977,Southampton,Charlton Athletic,4-1,4,1,2,2,5,3,H
1978-03-25,1977,Stoke City,Leyton Orient,5-1,5,1,2,2,6,4,H
1978-03-25,1977,Sunderland,Blackburn Rovers,0-1,0,1,2,2,1,-1,A
1978-03-27,1977,Blackburn Rovers,Burnley,0-1,0,1,2,2,1,-1,A
1978-03-27,1977,Blackpool,Sunderland,1-1,1,1,2,2,2,0,D
1978-03-27,1977,Fulham,Mansfield Town,0-2,0,2,2,2,2,-2,A
1978-03-27,1977,Leyton Orient,Sheffield United,3-1,3,1,2,2,4,2,H
1978-03-27,1977,Luton Town,Crystal Palace,1-0,1,0,2,2,1,1,H
1978-03-27,1977,Notts County,Bolton Wanderers,1-1,1,1,2,2,2,0,D
1978-03-27,1977,Oldham Athletic,Hull City,2-1,2,1,2,2,3,1,H
1978-03-27,1977,Southampton,Bristol Rovers,3-1,3,1,2,2,4,2,H
1978-03-27,1977,Tottenham Hotspur,Millwall,3-3,3,3,2,2,6,0,D
1978-03-28,1977,Blackpool,Burnley,1-1,1,1,2,2,2,0,D
1978-03-28,1977,Charlton Athletic,Stoke City,3-2,3,2,2,2,5,1,H
1978-03-29,1977,Cardiff City,Southampton,1-0,1,0,2,2,1,1,H
1978-04-01,1977,Bolton Wanderers,Leyton Orient,2-0,2,0,2,2,2,2,H
1978-04-01,1977,Brighton & Hove Albion,Notts County,2-1,2,1,2,2,3,1,H
1978-04-01,1977,Burnley,Tottenham Hotspur,2-1,2,1,2,2,3,1,H
1978-04-01,1977,Crystal Palace,Oldham Athletic,0-0,0,0,2,2,0,0,D
1978-04-01,1977,Hull City,Luton Town,1-1,1,1,2,2,2,0,D
1978-04-01,1977,Mansfield Town,Charlton Athletic,0-3,0,3,2,2,3,-3,A
1978-04-01,1977,Millwall,Bristol Rovers,1-3,1,3,2,2,4,-2,A
1978-04-01,1977,Sheffield United,Blackpool,0-0,0,0,2,2,0,0,D
1978-04-01,1977,Southampton,Blackburn Rovers,5-0,5,0,2,2,5,5,H
1978-04-01,1977,Stoke City,Cardiff City,2-0,2,0,2,2,2,2,H
1978-04-01,1977,Sunderland,Fulham,2-2,2,2,2,2,4,0,D
1978-04-04,1977,Charlton Athletic,Cardiff City,0-0,0,0,2,2,0,0,D
1978-04-04,1977,Leyton Orient,Blackburn Rovers,0-0,0,0,2,2,0,0,D
1978-04-04,1977,Notts County,Fulham,1-1,1,1,2,2,2,0,D
1978-04-04,1977,Oldham Athletic,Bristol Rovers,4-1,4,1,2,2,5,3,H
1978-04-04,1977,Sheffield United,Brighton & Hove Albion,2-0,2,0,2,2,2,2,H
1978-04-04,1977,Sunderland,Stoke City,1-0,1,0,2,2,1,1,H
1978-04-07,1977,Fulham,Southampton,1-1,1,1,2,2,2,0,D
1978-04-08,1977,Blackburn Rovers,Brighton & Hove Albion,0-1,0,1,2,2,1,-1,A
1978-04-08,1977,Blackpool,Stoke City,1-1,1,1,2,2,2,0,D
1978-04-08,1977,Bristol Rovers,Sheffield United,4-1,4,1,2,2,5,3,H
1978-04-08,1977,Cardiff City,Crystal Palace,2-2,2,2,2,2,4,0,D
1978-04-08,1977,Charlton Athletic,Hull City,0-1,0,1,2,2,1,-1,A
1978-04-08,1977,Luton Town,Sunderland,1-3,1,3,2,2,4,-2,A
1978-04-08,1977,Notts County,Millwall,1-1,1,1,2,2,2,0,D
1978-04-08,1977,Oldham Athletic,Mansfield Town,0-1,0,1,2,2,1,-1,A
1978-04-08,1977,Tottenham Hotspur,Bolton Wanderers,1-0,1,0,2,2,1,1,H
1978-04-11,1977,Hull City,Southampton,0-3,0,3,2,2,3,-3,A
1978-04-12,1977,Stoke City,Millwall,2-1,2,1,2,2,3,1,H
1978-04-15,1977,Bolton Wanderers,Bristol Rovers,3-0,3,0,2,2,3,3,H
1978-04-15,1977,Brighton & Hove Albion,Tottenham Hotspur,3-1,3,1,2,2,4,2,H
1978-04-15,1977,Burnley,Cardiff City,4-2,4,2,2,2,6,2,H
1978-04-15,1977,Crystal Palace,Leyton Orient,1-0,1,0,2,2,1,1,H
1978-04-15,1977,Hull City,Fulham,0-1,0,1,2,2,1,-1,A
1978-04-15,1977,Mansfield Town,Blackburn Rovers,2-2,2,2,2,2,4,0,D
1978-04-15,1977,Millwall,Blackpool,2-0,2,0,2,2,2,2,H
1978-04-15,1977,Sheffield United,Charlton Athletic,1-0,1,0,2,2,1,1,H
1978-04-15,1977,Southampton,Oldham Athletic,2-2,2,2,2,2,4,0,D
1978-04-15,1977,Stoke City,Luton Town,0-0,0,0,2,2,0,0,D
1978-04-15,1977,Sunderland,Notts County,3-1,3,1,2,2,4,2,H
1978-04-18,1977,Blackpool,Fulham,1-2,1,2,2,2,3,-1,A
1978-04-18,1977,Bolton Wanderers,Crystal Palace,2-0,2,0,2,2,2,2,H
1978-04-18,1977,Bristol Rovers,Brighton & Hove Albion,0-4,0,4,2,2,4,-4,A
1978-04-18,1977,Leyton Orient,Burnley,3-0,3,0,2,2,3,3,H
1978-04-18,1977,Millwall,Sunderland,3-1,3,1,2,2,4,2,H
1978-04-22,1977,Blackburn Rovers,Sheffield United,1-1,1,1,2,2,2,0,D
1978-04-22,1977,Blackpool,Mansfield Town,1-2,1,2,2,2,3,-1,A
1978-04-22,1977,Bristol Rovers,Stoke City,4-1,4,1,2,2,5,3,H
1978-04-22,1977,Cardiff City,Bolton Wanderers,1-0,1,0,2,2,1,1,H
1978-04-22,1977,Charlton Athletic,Burnley,3-2,3,2,2,2,5,1,H
1978-04-22,1977,Fulham,Millwall,0-1,0,1,2,2,1,-1,A
1978-04-22,1977,Leyton Orient,Hull City,2-1,2,1,2,2,3,1,H
1978-04-22,1977,Luton Town,Southampton,1-2,1,2,2,2,3,-1,A
1978-04-22,1977,Notts County,Crystal Palace,2-0,2,0,2,2,2,2,H
1978-04-22,1977,Oldham Athletic,Brighton & Hove Albion,1-1,1,1,2,2,2,0,D
1978-04-22,1977,Tottenham Hotspur,Sunderland,2-3,2,3,2,2,5,-1,A
1978-04-24,1977,Mansfield Town,Bristol Rovers,3-0,3,0,2,2,3,3,H
1978-04-25,1977,Brighton & Hove Albion,Charlton Athletic,1-0,1,0,2,2,1,1,H
1978-04-25,1977,Burnley,Fulham,2-0,2,0,2,2,2,2,H
1978-04-25,1977,Crystal Palace,Blackpool,2-2,2,2,2,2,4,0,D
1978-04-25,1977,Leyton Orient,Southampton,1-1,1,1,2,2,2,0,D
1978-04-25,1977,Millwall,Luton Town,1-0,1,0,2,2,1,1,H
1978-04-25,1977,Notts County,Sheffield United,1-2,1,2,2,2,3,-1,A
1978-04-26,1977,Blackburn Rovers,Bolton Wanderers,0-1,0,1,2,2,1,-1,A
1978-04-26,1977,Stoke City,Oldham Athletic,3-0,3,0,2,2,3,3,H
1978-04-26,1977,Tottenham Hotspur,Hull City,1-0,1,0,2,2,1,1,H
1978-04-29,1977,Bolton Wanderers,Fulham,0-0,0,0,2,2,0,0,D
1978-04-29,1977,Brighton & Hove Albion,Blackpool,2-1,2,1,2,2,3,1,H
1978-04-29,1977,Burnley,Luton Town,2-1,2,1,2,2,3,1,H
1978-04-29,1977,Crystal Palace,Blackburn Rovers,5-0,5,0,2,2,5,5,H
1978-04-29,1977,Hull City,Bristol Rovers,0-1,0,1,2,2,1,-1,A
1978-04-29,1977,Mansfield Town,Leyton Orient,1-1,1,1,2,2,2,0,D
1978-04-29,1977,Millwall,Oldham Athletic,2-0,2,0,2,2,2,2,H
1978-04-29,1977,Sheffield United,Cardiff City,0-1,0,1,2,2,1,-1,A
1978-04-29,1977,Southampton,Tottenham Hotspur,0-0,0,0,2,2,0,0,D
1978-04-29,1977,Stoke City,Notts County,1-1,1,1,2,2,2,0,D
1978-04-29,1977,Sunderland,Charlton Athletic,3-0,3,0,2,2,3,3,H
1978-05-02,1977,Millwall,Mansfield Town,1-0,1,0,2,2,1,1,H
1978-05-03,1977,Cardiff City,Notts County,2-1,2,1,2,2,3,1,H
1978-05-03,1977,Leyton Orient,Charlton Athletic,0-0,0,0,2,2,0,0,D
1978-05-09,1977,Cardiff City,Leyton Orient,0-1,0,1,2,2,1,-1,A