Date,Season,home,visitor,FT,hgoal,vgoal,division,tier,totgoal,goaldif,result
1913-09-01,1913,Aston Villa,Manchester City,1-1,1,1,1,1,2,0,D
1913-09-01,1913,Blackburn Rovers,Newcastle United,3-0,3,0,1,1,3,3,H
1913-09-01,1913,Bolton Wanderers,Sheffield Wednesday,0-1,0,1,1,1,1,-1,A
1913-09-01,1913,Derby County,Liverpool,1-1,1,1,1,1,2,0,D
1913-09-01,1913,Everton,Burnley,1-1,1,1,1,1,2,0,D
1913-09-01,1913,Preston North End,Sunderland,2-2,2,2,1,1,4,0,D
1913-09-01,1913,Sheffield United,Tottenham Hotspur,1-4,1,4,1,1,5,-3,A
1913-09-06,1913,Blackburn Rovers,Liverpool,6-2,6,2,1,1,8,4,H
1913-09-06,1913,Bolton Wanderers,Oldham Athletic,6-2,6,2,1,1,8,4,H
1913-09-06,1913,Bradford City,Aston Villa,0-0,0,0,1,1,0,0,D
1913-09-06,1913,Chelsea,Tottenham Hotspur,1-3,1,3,1,1,4,-2,A
1913-09-06,1913,Derby County,Sheffield United,3-5,3,5,1,1,8,-2,A
1913-09-06,1913,Everton,Preston North End,2-0,2,0,1,1,2,2,H
1913-09-06,1913,Manchester City,Middlesbrough,1-1,1,1,1,1,2,0,D
1913-09-06,1913,Sheffield Wednesday,Manchester United,1-3,1,3,1,1,4,-2,A
1913-09-06,1913,Sunderland,Newcastle United,1-2,1,2,1,1,3,-1,A
1913-09-06,1913,West Bromwich Albion,Burnley,4-1,4,1,1,1,5,3,H
1913-09-08,1913,Burnley,Blackburn Rovers,1-2,1,2,1,1,3,-1,A
1913-09-08,1913,Chelsea,West Bromwich Albion,1-1,1,1,1,1,2,0,D
1913-09-08,1913,Manchester United,Sunderland,3-1,3,1,1,1,4,2,H
1913-09-08,1913,Tottenham Hotspur,Sheffield United,2-1,2,1,1,1,3,1,H
1913-09-10,1913,Derby County,Middlesbrough,2-2,2,2,1,1,4,0,D
1913-09-13,1913,Aston Villa,Blackburn Rovers,1-3,1,3,1,1,4,-2,A
1913-09-13,1913,Burnley,Sheffield Wednesday,3-0,3,0,1,1,3,3,H
1913-09-13,1913,Liverpool,Sunderland,1-3,1,3,1,1,4,-2,A
1913-09-13,1913,Manchester United,Bolton Wanderers,0-1,0,1,1,1,1,-1,A
1913-09-13,1913,Middlesbrough,Bradford City,1-1,1,1,1,1,2,0,D
1913-09-13,1913,Newcastle United,Everton,0-1,0,1,1,1,1,-1,A
1913-09-13,1913,Oldham Athletic,Chelsea,3-2,3,2,1,1,5,1,H
1913-09-13,1913,Preston North End,West Bromwich Albion,0-2,0,2,1,1,2,-2,A
1913-09-13,1913,Sheffield United,Manchester City,1-3,1,3,1,1,4,-2,A
1913-09-13,1913,Tottenham Hotspur,Derby County,1-1,1,1,1,1,2,0,D
1913-09-17,1913,Bradford City,Preston North End,0-0,0,0,1,1,0,0,D
1913-09-20,1913,Blackburn Rovers,Middlesbrough,6-0,6,0,1,1,6,6,H
1913-09-20,1913,Bolton Wanderers,Burnley,0-0,0,0,1,1,0,0,D
1913-09-20,1913,Bradford City,Sheffield United,2-1,2,1,1,1,3,1,H
1913-09-20,1913,Chelsea,Manchester United,0-2,0,2,1,1,2,-2,A
1913-09-20,1913,Everton,Liverpool,1-2,1,2,1,1,3,-1,A
1913-09-20,1913,Manchester City,Derby County,1-2,1,2,1,1,3,-1,A
1913-09-20,1913,Oldham Athletic,Tottenham Hotspur,3-0,3,0,1,1,3,3,H
1913-09-20,1913,Sheffield Wednesday,Preston North End,2-1,2,1,1,1,3,1,H
1913-09-20,1913,Sunderland,Aston Villa,2-0,2,0,1,1,2,2,H
1913-09-20,1913,West Bromwich Albion,Newcastle United,1-1,1,1,1,1,2,0,D
1913-09-22,1913,Sheffield Wednesday,Oldham Athletic,1-2,1,2,1,1,3,-1,A
1913-09-27,1913,Aston Villa,Everton,3-1,3,1,1,1,4,2,H
1913-09-27,1913,Burnley,Chelsea,6-1,6,1,1,1,7,5,H
1913-09-27,1913,Derby County,Bradford City,3-1,3,1,1,1,4,2,H
1913-09-27,1913,Liverpool,West Bromwich Albion,0-0,0,0,1,1,0,0,D
1913-09-27,1913,Manchester United,Oldham Athletic,4-1,4,1,1,1,5,3,H
1913-09-27,1913,Middlesbrough,Sunderland,3-4,3,4,1,1,7,-1,A
1913-09-27,1913,Newcastle United,Sheffield Wednesday,3-1,3,1,1,1,4,2,H
1913-09-27,1913,Preston North End,Bolton Wanderers,1-1,1,1,1,1,2,0,D
1913-09-27,1913,Sheffield United,Blackburn Rovers,1-1,1,1,1,1,2,0,D
1913-09-27,1913,Tottenham Hotspur,Manchester City,3-1,3,1,1,1,4,2,H
1913-10-04,1913,Blackburn Rovers,Derby County,3-1,3,1,1,1,4,2,H
1913-10-04,1913,Bolton Wanderers,Newcastle United,3-1,3,1,1,1,4,2,H
1913-10-04,1913,Bradford City,Manchester City,3-2,3,2,1,1,5,1,H
1913-10-04,1913,Chelsea,Preston North End,2-0,2,0,1,1,2,2,H
1913-10-04,1913,Everton,Middlesbrough,2-0,2,0,1,1,2,2,H
1913-10-04,1913,Manchester United,Tottenham Hotspur,3-1,3,1,1,1,4,2,H
1913-10-04,1913,Oldham Athletic,Burnley,1-1,1,1,1,1,2,0,D
1913-10-04,1913,Sheffield Wednesday,Liverpool,4-1,4,1,1,1,5,3,H
1913-10-04,1913,Sunderland,Sheffield United,1-2,1,2,1,1,3,-1,A
1913-10-04,1913,West Bromwich Albion,Aston Villa,1-0,1,0,1,1,1,1,H
1913-10-11,1913,Aston Villa,Sheffield Wednesday,2-0,2,0,1,1,2,2,H
1913-10-11,1913,Burnley,Manchester United,1-2,1,2,1,1,3,-1,A
1913-10-11,1913,Derby County,Sunderland,1-1,1,1,1,1,2,0,D
1913-10-11,1913,Liverpool,Bolton Wanderers,2-1,2,1,1,1,3,1,H
1913-10-11,1913,Manchester City,Blackburn Rovers,1-2,1,2,1,1,3,-1,A
1913-10-11,1913,Middlesbrough,West Bromwich Albion,3-0,3,0,1,1,3,3,H
1913-10-11,1913,Newcastle United,Chelsea,1-0,1,0,1,1,1,1,H
1913-10-11,1913,Preston North End,Oldham Athletic,0-1,0,1,1,1,1,-1,A
1913-10-11,1913,Sheffield United,Everton,4-1,4,1,1,1,5,3,H
1913-10-11,1913,Tottenham Hotspur,Bradford City,0-0,0,0,1,1,0,0,D
1913-10-18,1913,Blackburn Rovers,Bradford City,0-0,0,0,1,1,0,0,D
1913-10-18,1913,Bolton Wanderers,Aston Villa,3-0,3,0,1,1,3,3,H
1913-10-18,1913,Burnley,Tottenham Hotspur,3-1,3,1,1,1,4,2,H
1913-10-18,1913,Chelsea,Liverpool,3-0,3,0,1,1,3,3,H
1913-10-18,1913,Everton,Derby County,5-0,5,0,1,1,5,5,H
1913-10-18,1913,Manchester United,Preston North End,3-0,3,0,1,1,3,3,H
1913-10-18,1913,Oldham Athletic,Newcastle United,3-0,3,0,1,1,3,3,H
1913-10-18,1913,Sheffield Wednesday,Middlesbrough,2-0,2,0,1,1,2,2,H
1913-10-18,1913,Sunderland,Manchester City,0-0,0,0,1,1,0,0,D
1913-10-18,1913,West Bromwich Albion,Sheffield United,2-1,2,1,1,1,3,1,H
1913-10-25,1913,Aston Villa,Chelsea,1-2,1,2,1,1,3,-1,A
1913-10-25,1913,Bradford City,Sunderland,0-2,0,2,1,1,2,-2,A
1913-10-25,1913,Derby County,West Bromwich Albion,1-2,1,2,1,1,3,-1,A
1913-10-25,1913,Liverpool,Oldham Athletic,0-3,0,3,1,1,3,-3,A
1913-10-25,1913,Manchester City,Everton,1-1,1,1,1,1,2,0,D
1913-10-25,1913,Middlesbrough,Bolton Wanderers,2-3,2,3,1,1,5,-1,A
1913-10-25,1913,Newcastle United,Manchester United,0-1,0,1,1,1,1,-1,A
1913-10-25,1913,Preston North End,Burnley,2-1,2,1,1,1,3,1,H
1913-10-25,1913,Sheffield United,Sheffield Wednesday,0-1,0,1,1,1,1,-1,A
1913-10-25,1913,Tottenham Hotspur,Blackburn Rovers,3-3,3,3,1,1,6,0,D
1913-11-01,1913,Bolton Wanderers,Sheffield United,3-1,3,1,1,1,4,2,H
1913-11-01,1913,Burnley,Newcastle United,1-0,1,0,1,1,1,1,H
1913-11-01,1913,Chelsea,Middlesbrough,3-2,3,2,1,1,5,1,H
1913-11-01,1913,Everton,Bradford City,1-1,1,1,1,1,2,0,D
1913-11-01,1913,Manchester United,Liverpool,3-0,3,0,1,1,3,3,H
1913-11-01,1913,Oldham Athletic,Aston Villa,0-1,0,1,1,1,1,-1,A
1913-11-01,1913,Preston North End,Tottenham Hotspur,1-2,1,2,1,1,3,-1,A
1913-11-01,1913,Sheffield Wednesday,Derby County,1-3,1,3,1,1,4,-2,A
1913-11-01,1913,Sunderland,Blackburn Rovers,2-1,2,1,1,1,3,1,H
1913-11-01,1913,West Bromwich Albion,Manchester City,0-0,0,0,1,1,0,0,D
1913-11-08,1913,Aston Villa,Manchester United,3-1,3,1,1,1,4,2,H
1913-11-08,1913,Blackburn Rovers,Everton,6-0,6,0,1,1,6,6,H
1913-11-08,1913,Bradford City,West Bromwich Albion,1-0,1,0,1,1,1,1,H
1913-11-08,1913,Derby County,Bolton Wanderers,3-3,3,3,1,1,6,0,D
1913-11-08,1913,Liverpool,Burnley,1-1,1,1,1,1,2,0,D
1913-11-08,1913,Manchester City,Sheffield Wednesday,1-2,1,2,1,1,3,-1,A
1913-11-08,1913,Middlesbrough,Oldham Athletic,0-0,0,0,1,1,0,0,D
1913-11-08,1913,Newcastle United,Preston North End,2-0,2,0,1,1,2,2,H
1913-11-08,1913,Sheffield United,Chelsea,3-2,3,2,1,1,5,1,H
1913-11-08,1913,Tottenham Hotspur,Sunderland,1-4,1,4,1,1,5,-3,A
1913-11-15,1913,Bolton Wanderers,Manchester City,3-0,3,0,1,1,3,3,H
1913-11-15,1913,Burnley,Aston Villa,4-0,4,0,1,1,4,4,H
1913-11-15,1913,Chelsea,Derby County,2-1,2,1,1,1,3,1,H
1913-11-15,1913,Everton,Sunderland,1-5,1,5,1,1,6,-4,A
1913-11-15,1913,Manchester United,Middlesbrough,0-1,0,1,1,1,1,-1,A
1913-11-15,1913,Newcastle United,Tottenham Hotspur,2-0,2,0,1,1,2,2,H
1913-11-15,1913,Oldham Athletic,Sheffield United,1-2,1,2,1,1,3,-1,A
1913-11-15,1913,Preston North End,Liverpool,0-1,0,1,1,1,1,-1,A
1913-11-15,1913,Sheffield Wednesday,Bradford City,1-3,1,3,1,1,4,-2,A
1913-11-15,1913,West Bromwich Albion,Blackburn Rovers,2-0,2,0,1,1,2,2,H
1913-11-22,1913,Aston Villa,Preston North End,3-0,3,0,1,1,3,3,H
1913-11-22,1913,Blackburn Rovers,Sheffield Wednesday,3-2,3,2,1,1,5,1,H
1913-11-22,1913,Bradford City,Bolton Wanderers,5-1,5,1,1,1,6,4,H
1913-11-22,1913,Derby County,Oldham Athletic,1-2,1,2,1,1,3,-1,A
1913-11-22,1913,Liverpool,Newcastle United,0-0,0,0,1,1,0,0,D
1913-11-22,1913,Manchester City,Chelsea,2-1,2,1,1,1,3,1,H
1913-11-22,1913,Middlesbrough,Burnley,2-1,2,1,1,1,3,1,H
1913-11-22,1913,Sheffield United,Manchester United,2-0,2,0,1,1,2,2,H
1913-11-22,1913,Sunderland,West Bromwich Albion,0-0,0,0,1,1,0,0,D
1913-11-22,1913,Tottenham Hotspur,Everton,4-1,4,1,1,1,5,3,H
1913-11-29,1913,Bolton Wanderers,Blackburn Rovers,1-0,1,0,1,1,1,1,H
1913-11-29,1913,Burnley,Sheffield United,0-0,0,0,1,1,0,0,D
1913-11-29,1913,Chelsea,Bradford City,2-1,2,1,1,1,3,1,H
1913-11-29,1913,Liverpool,Tottenham Hotspur,2-1,2,1,1,1,3,1,H
1913-11-29,1913,Manchester United,Derby County,3-3,3,3,1,1,6,0,D
1913-11-29,1913,Newcastle United,Aston Villa,2-2,2,2,1,1,4,0,D
1913-11-29,1913,Oldham Athletic,Manchester City,1-3,1,3,1,1,4,-2,A
1913-11-29,1913,Preston North End,Middlesbrough,4-1,4,1,1,1,5,3,H
1913-11-29,1913,Sheffield Wednesday,Sunderland,2-1,2,1,1,1,3,1,H
1913-11-29,1913,West Bromwich Albion,Everton,1-1,1,1,1,1,2,0,D
1913-12-06,1913,Aston Villa,Liverpool,2-1,2,1,1,1,3,1,H
1913-12-06,1913,Blackburn Rovers,Chelsea,3-1,3,1,1,1,4,2,H
1913-12-06,1913,Bradford City,Oldham Athletic,0-1,0,1,1,1,1,-1,A
1913-12-06,1913,Derby County,Burnley,3-1,3,1,1,1,4,2,H
1913-12-06,1913,Everton,Sheffield Wednesday,1-1,1,1,1,1,2,0,D
1913-12-06,1913,Manchester City,Manchester United,0-2,0,2,1,1,2,-2,A
1913-12-06,1913,Middlesbrough,Newcastle United,3-0,3,0,1,1,3,3,H
1913-12-06,1913,Sheffield United,Preston North End,2-0,2,0,1,1,2,2,H
1913-12-06,1913,Sunderland,Bolton Wanderers,3-2,3,2,1,1,5,1,H
1913-12-06,1913,Tottenham Hotspur,West Bromwich Albion,3-0,3,0,1,1,3,3,H
1913-12-13,1913,Aston Villa,Tottenham Hotspur,3-3,3,3,1,1,6,0,D
1913-12-13,1913,Bolton Wanderers,Everton,0-0,0,0,1,1,0,0,D
1913-12-13,1913,Burnley,Manchester City,2-0,2,0,1,1,2,2,H
1913-12-13,1913,Chelsea,Sunderland,1-1,1,1,1,1,2,0,D
1913-12-13,1913,Liverpool,Middlesbrough,2-1,2,1,1,1,3,1,H
1913-12-13,1913,Manchester United,Bradford City,1-1,1,1,1,1,2,0,D
1913-12-13,1913,Newcastle United,Sheffield United,2-1,2,1,1,1,3,1,H
1913-12-13,1913,Oldham Athletic,Blackburn Rovers,1-1,1,1,1,1,2,0,D
1913-12-13,1913,Preston North End,Derby County,2-0,2,0,1,1,2,2,H
1913-12-13,1913,Sheffield Wednesday,West Bromwich Albion,1-4,1,4,1,1,5,-3,A
1913-12-20,1913,Blackburn Rovers,Manchester United,0-1,0,1,1,1,1,-1,A
1913-12-20,1913,Bradford City,Burnley,1-1,1,1,1,1,2,0,D
1913-12-20,1913,Derby County,Newcastle United,2-0,2,0,1,1,2,2,H
1913-12-20,1913,Everton,Chelsea,0-0,0,0,1,1,0,0,D
1913-12-20,1913,Manchester City,Preston North End,1-1,1,1,1,1,2,0,D
1913-12-20,1913,Middlesbrough,Aston Villa,5-2,5,2,1,1,7,3,H
1913-12-20,1913,Sheffield United,Liverpool,0-1,0,1,1,1,1,-1,A
1913-12-20,1913,Sunderland,Oldham Athletic,2-0,2,0,1,1,2,2,H
1913-12-20,1913,Tottenham Hotspur,Sheffield Wednesday,1-1,1,1,1,1,2,0,D
1913-12-20,1913,West Bromwich Albion,Bolton Wanderers,1-1,1,1,1,1,2,0,D
1913-12-25,1913,Blackburn Rovers,Preston North End,5-0,5,0,1,1,5,5,H
1913-12-25,1913,Burnley,Sunderland,0-1,0,1,1,1,1,-1,A
1913-12-25,1913,Chelsea,Sheffield Wednesday,2-1,2,1,1,1,3,1,H
1913-12-25,1913,Derby County,Aston Villa,0-2,0,2,1,1,2,-2,A
1913-12-25,1913,Liverpool,Manchester City,4-2,4,2,1,1,6,2,H
1913-12-25,1913,Manchester United,Everton,0-1,0,1,1,1,1,-1,A
1913-12-25,1913,Newcastle United,Bradford City,0-0,0,0,1,1,0,0,D
1913-12-25,1913,Oldham Athletic,West Bromwich Albion,2-0,2,0,1,1,2,2,H
1913-12-25,1913,Sheffield United,Middlesbrough,3-1,3,1,1,1,4,2,H
1913-12-26,1913,Aston Villa,Sheffield United,3-0,3,0,1,1,3,3,H
1913-12-26,1913,Bradford City,Newcastle United,2-0,2,0,1,1,2,2,H
1913-12-26,1913,Everton,Manchester United,5-0,5,0,1,1,5,5,H
1913-12-26,1913,Manchester City,Liverpool,1-0,1,0,1,1,1,1,H
1913-12-26,1913,Preston North End,Blackburn Rovers,1-5,1,5,1,1,6,-4,A
1913-12-26,1913,Sheffield Wednesday,Chelsea,3-0,3,0,1,1,3,3,H
1913-12-26,1913,Sunderland,Burnley,1-1,1,1,1,1,2,0,D
1913-12-26,1913,Tottenham Hotspur,Middlesbrough,0-1,0,1,1,1,1,-1,A
1913-12-26,1913,West Bromwich Albion,Oldham Athletic,2-2,2,2,1,1,4,0,D
1913-12-27,1913,Aston Villa,Bradford City,0-1,0,1,1,1,1,-1,A
1913-12-27,1913,Burnley,West Bromwich Albion,0-0,0,0,1,1,0,0,D
1913-12-27,1913,Liverpool,Blackburn Rovers,3-3,3,3,1,1,6,0,D
1913-12-27,1913,Manchester United,Sheffield Wednesday,2-1,2,1,1,1,3,1,H
1913-12-27,1913,Middlesbrough,Manchester City,2-0,2,0,1,1,2,2,H
1913-12-27,1913,Newcastle United,Sunderland,2-1,2,1,1,1,3,1,H
1913-12-27,1913,Oldham Athletic,Bolton Wanderers,2-0,2,0,1,1,2,2,H
1913-12-27,1913,Preston North End,Everton,1-0,1,0,1,1,1,1,H
1913-12-27,1913,Sheffield United,Derby County,2-2,2,2,1,1,4,0,D
1913-12-27,1913,Tottenham Hotspur,Chelsea,1-2,1,2,1,1,3,-1,A
1913-12-29,1913,Sheffield Wednesday,Bolton Wanderers,1-1,1,1,1,1,2,0,D
1914-01-01,1913,Blackburn Rovers,Burnley,0-0,0,0,1,1,0,0,D
1914-01-01,1913,Bolton Wanderers,Tottenham Hotspur,3-0,3,0,1,1,3,3,H
1914-01-01,1913,Liverpool,Bradford City,0-1,0,1,1,1,1,-1,A
1914-01-01,1913,Manchester United,West Bromwich Albion,1-0,1,0,1,1,1,1,H
1914-01-01,1913,Middlesbrough,Derby County,3-2,3,2,1,1,5,1,H
1914-01-01,1913,Newcastle United,Manchester City,0-1,0,1,1,1,1,-1,A
1914-01-01,1913,Oldham Athletic,Everton,2-0,2,0,1,1,2,2,H
1914-01-01,1913,Sheffield United,Aston Villa,3-0,3,0,1,1,3,3,H
1914-01-01,1913,Sunderland,Preston North End,3-1,3,1,1,1,4,2,H
1914-01-03,1913,Blackburn Rovers,Aston Villa,0-0,0,0,1,1,0,0,D
1914-01-03,1913,Bolton Wanderers,Manchester United,6-1,6,1,1,1,7,5,H
1914-01-03,1913,Bradford City,Middlesbrough,2-3,2,3,1,1,5,-1,A
1914-01-03,1913,Chelsea,Oldham Athletic,2-1,2,1,1,1,3,1,H
1914-01-03,1913,Derby County,Tottenham Hotspur,4-0,4,0,1,1,4,4,H
1914-01-03,1913,Everton,Newcastle United,2-0,2,0,1,1,2,2,H
1914-01-03,1913,Manchester City,Sheffield United,2-1,2,1,1,1,3,1,H
1914-01-03,1913,Sheffield Wednesday,Burnley,2-6,2,6,1,1,8,-4,A
1914-01-03,1913,Sunderland,Liverpool,1-2,1,2,1,1,3,-1,A
1914-01-03,1913,West Bromwich Albion,Preston North End,1-0,1,0,1,1,1,1,H
1914-01-17,1913,Aston Villa,Sunderland,5-0,5,0,1,1,5,5,H
1914-01-17,1913,Burnley,Bolton Wanderers,2-2,2,2,1,1,4,0,D
1914-01-17,1913,Derby County,Manchester City,2-4,2,4,1,1,6,-2,A
1914-01-17,1913,Liverpool,Everton,1-2,1,2,1,1,3,-1,A
1914-01-17,1913,Manchester United,Chelsea,0-1,0,1,1,1,1,-1,A
1914-01-17,1913,Middlesbrough,Blackburn Rovers,3-0,3,0,1,1,3,3,H
1914-01-17,1913,Newcastle United,West Bromwich Albion,3-3,3,3,1,1,6,0,D
1914-01-17,1913,Preston North End,Sheffield Wednesday,5-0,5,0,1,1,5,5,H
1914-01-17,1913,Sheffield United,Bradford City,1-1,1,1,1,1,2,0,D
1914-01-17,1913,Tottenham Hotspur,Oldham Athletic,3-1,3,1,1,1,4,2,H
1914-01-24,1913,Blackburn Rovers,Sheffield United,3-2,3,2,1,1,5,1,H
1914-01-24,1913,Bolton Wanderers,Preston North End,0-3,0,3,1,1,3,-3,A
1914-01-24,1913,Bradford City,Derby County,0-0,0,0,1,1,0,0,D
1914-01-24,1913,Chelsea,Burnley,0-0,0,0,1,1,0,0,D
1914-01-24,1913,Everton,Aston Villa,1-4,1,4,1,1,5,-3,A
1914-01-24,1913,Manchester City,Tottenham Hotspur,2-1,2,1,1,1,3,1,H
1914-01-24,1913,Oldham Athletic,Manchester United,2-2,2,2,1,1,4,0,D
1914-01-24,1913,Sheffield Wednesday,Newcastle United,0-0,0,0,1,1,0,0,D
1914-01-24,1913,Sunderland,Middlesbrough,4-2,4,2,1,1,6,2,H
1914-01-24,1913,West Bromwich Albion,Liverpool,0-1,0,1,1,1,1,-1,A
1914-02-07,1913,Aston Villa,West Bromwich Albion,2-0,2,0,1,1,2,2,H
1914-02-07,1913,Burnley,Oldham Athletic,2-0,2,0,1,1,2,2,H
1914-02-07,1913,Derby County,Blackburn Rovers,2-3,2,3,1,1,5,-1,A
1914-02-07,1913,Liverpool,Sheffield Wednesday,1-2,1,2,1,1,3,-1,A
1914-02-07,1913,Manchester City,Bradford City,1-0,1,0,1,1,1,1,H
1914-02-07,1913,Middlesbrough,Everton,2-0,2,0,1,1,2,2,H
1914-02-07,1913,Newcastle United,Bolton Wanderers,4-3,4,3,1,1,7,1,H
1914-02-07,1913,Preston North End,Chelsea,3-3,3,3,1,1,6,0,D
1914-02-07,1913,Sheffield United,Sunderland,1-0,1,0,1,1,1,1,H
1914-02-07,1913,Tottenham Hotspur,Manchester United,2-1,2,1,1,1,3,1,H
1914-02-11,1913,Bolton Wanderers,Chelsea,1-1,1,1,1,1,2,0,D
1914-02-14,1913,Blackburn Rovers,Manchester City,2-1,2,1,1,1,3,1,H
1914-02-14,1913,Bolton Wanderers,Liverpool,2-1,2,1,1,1,3,1,H
1914-02-14,1913,Bradford City,Tottenham Hotspur,2-1,2,1,1,1,3,1,H
1914-02-14,1913,Chelsea,Newcastle United,0-1,0,1,1,1,1,-1,A
1914-02-14,1913,Everton,Sheffield United,5-0,5,0,1,1,5,5,H
1914-02-14,1913,Manchester United,Burnley,0-1,0,1,1,1,1,-1,A
1914-02-14,1913,Oldham Athletic,Preston North End,1-0,1,0,1,1,1,1,H
1914-02-14,1913,Sheffield Wednesday,Aston Villa,2-3,2,3,1,1,5,-1,A
1914-02-14,1913,Sunderland,Derby County,1-0,1,0,1,1,1,1,H
1914-02-14,1913,West Bromwich Albion,Middlesbrough,2-1,2,1,1,1,3,1,H
1914-02-21,1913,Derby County,Everton,1-0,1,0,1,1,1,1,H
1914-02-21,1913,Middlesbrough,Manchester United,3-1,3,1,1,1,4,2,H
1914-02-21,1913,Newcastle United,Oldham Athletic,0-0,0,0,1,1,0,0,D
1914-02-23,1913,Tottenham Hotspur,Burnley,2-0,2,0,1,1,2,2,H
1914-02-25,1913,Aston Villa,Bolton Wanderers,1-0,1,0,1,1,1,1,H
1914-02-25,1913,Bradford City,Blackburn Rovers,0-2,0,2,1,1,2,-2,A
1914-02-28,1913,Blackburn Rovers,Tottenham Hotspur,1-1,1,1,1,1,2,0,D
1914-02-28,1913,Bolton Wanderers,Middlesbrough,1-1,1,1,1,1,2,0,D
1914-02-28,1913,Burnley,Preston North End,3-4,3,4,1,1,7,-1,A
1914-02-28,1913,Chelsea,Aston Villa,0-3,0,3,1,1,3,-3,A
1914-02-28,1913,Everton,Manchester City,1-0,1,0,1,1,1,1,H
1914-02-28,1913,Manchester United,Newcastle United,2-2,2,2,1,1,4,0,D
1914-02-28,1913,Oldham Athletic,Liverpool,2-2,2,2,1,1,4,0,D
1914-02-28,1913,Sheffield Wednesday,Sheffield United,2-1,2,1,1,1,3,1,H
1914-02-28,1913,Sunderland,Bradford City,0-1,0,1,1,1,1,-1,A
1914-02-28,1913,West Bromwich Albion,Derby County,2-1,2,1,1,1,3,1,H
1914-03-05,1913,Preston North End,Manchester United,4-2,4,2,1,1,6,2,H
1914-03-07,1913,Bolton Wanderers,West Bromwich Albion,1-0,1,0,1,1,1,1,H
1914-03-07,1913,Bradford City,Everton,0-1,0,1,1,1,1,-1,A
1914-03-07,1913,Middlesbrough,Chelsea,2-0,2,0,1,1,2,2,H
1914-03-07,1913,Tottenham Hotspur,Preston North End,1-0,1,0,1,1,1,1,H
1914-03-11,1913,Derby County,Sheffield Wednesday,1-1,1,1,1,1,2,0,D
1914-03-14,1913,Bolton Wanderers,Derby County,3-1,3,1,1,1,4,2,H
1914-03-14,1913,Burnley,Liverpool,5-2,5,2,1,1,7,3,H
1914-03-14,1913,Chelsea,Sheffield United,2-0,2,0,1,1,2,2,H
1914-03-14,1913,Everton,Blackburn Rovers,0-0,0,0,1,1,0,0,D
1914-03-14,1913,Manchester United,Aston Villa,0-6,0,6,1,1,6,-6,A
1914-03-14,1913,Oldham Athletic,Middlesbrough,3-0,3,0,1,1,3,3,H
1914-03-14,1913,Preston North End,Newcastle United,4-1,4,1,1,1,5,3,H
1914-03-14,1913,Sheffield Wednesday,Manchester City,2-2,2,2,1,1,4,0,D
1914-03-14,1913,Sunderland,Tottenham Hotspur,2-0,2,0,1,1,2,2,H
1914-03-14,1913,West Bromwich Albion,Bradford City,2-1,2,1,1,1,3,1,H
1914-03-18,1913,Aston Villa,Oldham Athletic,0-0,0,0,1,1,0,0,D
1914-03-18,1913,Liverpool,Chelsea,3-0,3,0,1,1,3,3,H
1914-03-18,1913,Manchester City,Sunderland,3-1,3,1,1,1,4,2,H
1914-03-18,1913,Middlesbrough,Sheffield Wednesday,5-2,5,2,1,1,7,3,H
1914-03-18,1913,Newcastle United,Burnley,3-1,3,1,1,1,4,2,H
1914-03-19,1913,Sheffield United,West Bromwich Albion,1-1,1,1,1,1,2,0,D
1914-03-21,1913,Aston Villa,Burnley,1-0,1,0,1,1,1,1,H
1914-03-21,1913,Blackburn Rovers,West Bromwich Albion,2-0,2,0,1,1,2,2,H
1914-03-21,1913,Bradford City,Sheffield Wednesday,3-1,3,1,1,1,4,2,H
1914-03-21,1913,Derby County,Chelsea,0-1,0,1,1,1,1,-1,A
1914-03-21,1913,Liverpool,Preston North End,3-1,3,1,1,1,4,2,H
1914-03-21,1913,Manchester City,Bolton Wanderers,0-1,0,1,1,1,1,-1,A
1914-03-21,1913,Sheffield United,Oldham Athletic,2-1,2,1,1,1,3,1,H
1914-03-21,1913,Sunderland,Everton,5-2,5,2,1,1,7,3,H
1914-03-21,1913,Tottenham Hotspur,Newcastle United,0-0,0,0,1,1,0,0,D
1914-03-23,1913,Blackburn Rovers,Sunderland,3-1,3,1,1,1,4,2,H
1914-03-25,1913,Manchester City,West Bromwich Albion,2-3,2,3,1,1,5,-1,A
1914-03-28,1913,Bolton Wanderers,Bradford City,3-0,3,0,1,1,3,3,H
1914-03-28,1913,Chelsea,Manchester City,1-0,1,0,1,1,1,1,H
1914-03-28,1913,Everton,Tottenham Hotspur,1-1,1,1,1,1,2,0,D
1914-03-28,1913,Oldham Athletic,Derby County,0-0,0,0,1,1,0,0,D
1914-03-28,1913,Sheffield Wednesday,Blackburn Rovers,3-1,3,1,1,1,4,2,H
1914-03-28,1913,West Bromwich Albion,Sunderland,2-1,2,1,1,1,3,1,H
1914-04-01,1913,Newcastle United,Liverpool,1-2,1,2,1,1,3,-1,A
1914-04-01,1913,Preston North End,Aston Villa,3-2,3,2,1,1,5,1,H
1914-04-04,1913,Aston Villa,Newcastle United,1-3,1,3,1,1,4,-2,A
1914-04-04,1913,Blackburn Rovers,Bolton Wanderers,3-2,3,2,1,1,5,1,H
1914-04-04,1913,Bradford City,Chelsea,0-0,0,0,1,1,0,0,D
1914-04-04,1913,Derby County,Manchester United,4-2,4,2,1,1,6,2,H
1914-04-04,1913,Everton,West Bromwich Albion,2-0,2,0,1,1,2,2,H
1914-04-04,1913,Manchester City,Oldham Athletic,2-1,2,1,1,1,3,1,H
1914-04-04,1913,Middlesbrough,Preston North End,4-1,4,1,1,1,5,3,H
1914-04-04,1913,Sheffield United,Burnley,5-0,5,0,1,1,5,5,H
1914-04-04,1913,Sunderland,Sheffield Wednesday,0-1,0,1,1,1,1,-1,A
1914-04-04,1913,Tottenham Hotspur,Liverpool,0-0,0,0,1,1,0,0,D
1914-04-06,1913,Burnley,Middlesbrough,1-2,1,2,1,1,3,-1,A
1914-04-06,1913,Sheffield United,Bolton Wanderers,2-0,2,0,1,1,2,2,H
1914-04-10,1913,Burnley,Everton,2-0,2,0,1,1,2,2,H
1914-04-10,1913,Liverpool,Derby County,1-0,1,0,1,1,1,1,H
1914-04-10,1913,Manchester City,Aston Villa,3-1,3,1,1,1,4,2,H
1914-04-10,1913,Middlesbrough,Sheffield United,2-3,2,3,1,1,5,-1,A
1914-04-10,1913,Newcastle United,Blackburn Rovers,0-0,0,0,1,1,0,0,D
1914-04-10,1913,Preston North End,Bradford City,2-1,2,1,1,1,3,1,H
1914-04-10,1913,Sunderland,Manchester United,2-0,2,0,1,1,2,2,H
1914-04-10,1913,Tottenham Hotspur,Bolton Wanderers,3-0,3,0,1,1,3,3,H
1914-04-11,1913,Bolton Wanderers,Sunderland,2-1,2,1,1,1,3,1,H
1914-04-11,1913,Burnley,Derby County,5-1,5,1,1,1,6,4,H
1914-04-11,1913,Chelsea,Blackburn Rovers,2-0,2,0,1,1,2,2,H
1914-04-11,1913,Liverpool,Aston Villa,0-1,0,1,1,1,1,-1,A
1914-04-11,1913,Manchester United,Manchester City,0-1,0,1,1,1,1,-1,A
1914-04-11,1913,Newcastle United,Middlesbrough,1-0,1,0,1,1,1,1,H
1914-04-11,1913,Oldham Athletic,Bradford City,3-1,3,1,1,1,4,2,H
1914-04-11,1913,Preston North End,Sheffield United,2-4,2,4,1,1,6,-2,A
1914-04-11,1913,Sheffield Wednesday,Everton,2-2,2,2,1,1,4,0,D
1914-04-11,1913,West Bromwich Albion,Tottenham Hotspur,1-1,1,1,1,1,2,0,D
1914-04-13,1913,Aston Villa,Derby County,3-2,3,2,1,1,5,1,H
1914-04-13,1913,Bradford City,Liverpool,1-0,1,0,1,1,1,1,H
1914-04-13,1913,Chelsea,Bolton Wanderers,2-1,2,1,1,1,3,1,H
1914-04-13,1913,Everton,Oldham Athletic,0-2,0,2,1,1,2,-2,A
1914-04-13,1913,Manchester City,Newcastle United,0-1,0,1,1,1,1,-1,A
1914-04-13,1913,Middlesbrough,Tottenham Hotspur,6-0,6,0,1,1,6,6,H
1914-04-13,1913,West Bromwich Albion,Manchester United,2-1,2,1,1,1,3,1,H
1914-04-14,1913,Oldham Athletic,Sheffield Wednesday,2-0,2,0,1,1,2,2,H
1914-04-14,1913,West Bromwich Albion,Chelsea,3-1,3,1,1,1,4,2,H
1914-04-15,1913,Liverpool,Manchester United,1-2,1,2,1,1,3,-1,A
1914-04-18,1913,Blackburn Rovers,Oldham Athletic,2-1,2,1,1,1,3,1,H
1914-04-18,1913,Bradford City,Manchester United,1-1,1,1,1,1,2,0,D
1914-04-18,1913,Derby County,Preston North End,0-1,0,1,1,1,1,-1,A
1914-04-18,1913,Everton,Bolton Wanderers,1-1,1,1,1,1,2,0,D
1914-04-18,1913,Manchester City,Burnley,4-1,4,1,1,1,5,3,H
1914-04-18,1913,Middlesbrough,Liverpool,4-0,4,0,1,1,4,4,H
1914-04-18,1913,Sheffield United,Newcastle United,2-0,2,0,1,1,2,2,H
1914-04-18,1913,Sunderland,Chelsea,2-0,2,0,1,1,2,2,H
1914-04-18,1913,Tottenham Hotspur,Aston Villa,0-2,0,2,1,1,2,-2,A
1914-04-18,1913,West Bromwich Albion,Sheffield Wednesday,1-1,1,1,1,1,2,0,D
1914-04-22,1913,Manchester United,Sheffield United,2-1,2,1,1,1,3,1,H
1914-04-25,1913,Aston Villa,Middlesbrough,1-3,1,3,1,1,4,-2,A
1914-04-25,1913,Chelsea,Everton,2-0,2,0,1,1,2,2,H
1914-04-25,1913,Manchester United,Blackburn Rovers,0-0,0,0,1,1,0,0,D
1914-04-25,1913,Newcastle United,Derby County,1-1,1,1,1,1,2,0,D
1914-04-25,1913,Oldham Athletic,Sunderland,2-1,2,1,1,1,3,1,H
1914-04-25,1913,Preston North End,Manchester City,2-2,2,2,1,1,4,0,D
1914-04-25,1913,Sheffield Wednesday,Tottenham Hotspur,2-0,2,0,1,1,2,2,H
1914-04-27,1913,Burnley,Bradford City,2-2,2,2,1,1,4,0,D
1914-04-27,1913,Liverpool,Sheffield United,2-1,2,1,1,1,3,1,H
1914-09-01,1914,Manchester City,Bradford City,4-1,4,1,1,1,5,3,H
1914-09-01,1914,Sheffield Wednesday,Middlesbrough,3-1,3,1,1,1,4,2,H
1914-09-02,1914,Aston Villa,Notts County,2-1,2,1,1,1,3,1,H
1914-09-02,1914,Liverpool,Bolton Wanderers,4-3,4,3,1,1,7,1,H
1914-09-02,1914,Manchester United,Oldham Athletic,1-3,1,3,1,1,4,-2,A
1914-09-02,1914,Newcastle United,West Bromwich Albion,1-2,1,2,1,1,3,-1,A
1914-09-02,1914,Sunderland,Sheffield United,3-2,3,2,1,1,5,1,H
1914-09-02,1914,Tottenham Hotspur,Everton,1-3,1,3,1,1,4,-2,A
1914-09-05,1914,Aston Villa,Sunderland,1-3,1,3,1,1,4,-2,A
1914-09-05,1914,Bradford Park Avenue,Blackburn Rovers,1-2,1,2,1,1,3,-1,A
1914-09-05,1914,Burnley,Bradford City,0-1,0,1,1,1,1,-1,A
1914-09-05,1914,Liverpool,Notts County,1-1,1,1,1,1,2,0,D
1914-09-05,1914,Manchester United,Manchester City,0-0,0,0,1,1,0,0,D
1914-09-05,1914,Middlesbrough,West Bromwich Albion,2-0,2,0,1,1,2,2,H
1914-09-05,1914,Newcastle United,Everton,0-1,0,1,1,1,1,-1,A
1914-09-05,1914,Oldham Athletic,Bolton Wanderers,5-3,5,3,1,1,8,2,H
1914-09-05,1914,Sheffield United,Sheffield Wednesday,0-1,0,1,1,1,1,-1,A
1914-09-05,1914,Tottenham Hotspur,Chelsea,1-1,1,1,1,1,2,0,D
1914-09-07,1914,Bolton Wanderers,Blackburn Rovers,3-2,3,2,1,1,5,1,H
1914-09-07,1914,Burnley,Everton,1-0,1,0,1,1,1,1,H
1914-09-09,1914,Bradford City,Chelsea,2-2,2,2,1,1,4,0,D
1914-09-09,1914,Newcastle United,Sheffield Wednesday,0-0,0,0,1,1,0,0,D
1914-09-12,1914,Blackburn Rovers,Oldham Athletic,4-1,4,1,1,1,5,3,H
1914-09-12,1914,Bolton Wanderers,Manchester United,3-0,3,0,1,1,3,3,H
1914-09-12,1914,Bradford City,Tottenham Hotspur,2-2,2,2,1,1,4,0,D
1914-09-12,1914,Chelsea,Newcastle United,0-3,0,3,1,1,3,-3,A
1914-09-12,1914,Everton,Middlesbrough,2-3,2,3,1,1,5,-1,A
1914-09-12,1914,Manchester City,Burnley,1-0,1,0,1,1,1,1,H
1914-09-12,1914,Notts County,Bradford Park Avenue,1-2,1,2,1,1,3,-1,A
1914-09-12,1914,Sheffield Wednesday,Aston Villa,5-2,5,2,1,1,7,3,H
1914-09-12,1914,Sunderland,Liverpool,2-2,2,2,1,1,4,0,D
1914-09-12,1914,West Bromwich Albion,Sheffield United,1-1,1,1,1,1,2,0,D
1914-09-19,1914,Aston Villa,West Bromwich Albion,2-1,2,1,1,1,3,1,H
1914-09-19,1914,Bolton Wanderers,Manchester City,2-3,2,3,1,1,5,-1,A
1914-09-19,1914,Bradford Park Avenue,Sunderland,2-1,2,1,1,1,3,1,H
1914-09-19,1914,Liverpool,Sheffield Wednesday,2-1,2,1,1,1,3,1,H
1914-09-19,1914,Manchester United,Blackburn Rovers,2-0,2,0,1,1,2,2,H
1914-09-19,1914,Middlesbrough,Chelsea,3-0,3,0,1,1,3,3,H
1914-09-19,1914,Newcastle United,Bradford City,1-0,1,0,1,1,1,1,H
1914-09-19,1914,Oldham Athletic,Notts County,2-0,2,0,1,1,2,2,H
1914-09-19,1914,Sheffield United,Everton,1-0,1,0,1,1,1,1,H
1914-09-19,1914,Tottenham Hotspur,Burnley,1-3,1,3,1,1,4,-2,A
1914-09-21,1914,Blackburn Rovers,Liverpool,4-2,4,2,1,1,6,2,H
1914-09-26,1914,Blackburn Rovers,Bolton Wanderers,2-2,2,2,1,1,4,0,D
1914-09-26,1914,Bradford City,Middlesbrough,1-1,1,1,1,1,2,0,D
1914-09-26,1914,Burnley,Newcastle United,2-0,2,0,1,1,2,2,H
1914-09-26,1914,Chelsea,Sheffield United,1-1,1,1,1,1,2,0,D
1914-09-26,1914,Everton,Aston Villa,0-0,0,0,1,1,0,0,D
1914-09-26,1914,Manchester City,Tottenham Hotspur,2-1,2,1,1,1,3,1,H
1914-09-26,1914,Notts County,Manchester United,4-2,4,2,1,1,6,2,H
1914-09-26,1914,Sheffield Wednesday,Bradford Park Avenue,6-0,6,0,1,1,6,6,H
1914-09-26,1914,Sunderland,Oldham Athletic,1-2,1,2,1,1,3,-1,A
1914-09-26,1914,West Bromwich Albion,Liverpool,4-0,4,0,1,1,4,4,H
1914-09-28,1914,Tottenham Hotspur,West Bromwich Albion,2-0,2,0,1,1,2,2,H
1914-10-03,1914,Aston Villa,Chelsea,2-1,2,1,1,1,3,1,H
1914-10-03,1914,Blackburn Rovers,Manchester City,0-1,0,1,1,1,1,-1,A
1914-10-03,1914,Bolton Wanderers,Notts County,1-2,1,2,1,1,3,-1,A
1914-10-03,1914,Bradford Park Avenue,West Bromwich Albion,1-4,1,4,1,1,5,-3,A
1914-10-03,1914,Liverpool,Everton,0-5,0,5,1,1,5,-5,A
1914-10-03,1914,Manchester United,Sunderland,3-0,3,0,1,1,3,3,H
1914-10-03,1914,Middlesbrough,Burnley,1-1,1,1,1,1,2,0,D
1914-10-03,1914,Newcastle United,Tottenham Hotspur,4-0,4,0,1,1,4,4,H
1914-10-03,1914,Oldham Athletic,Sheffield Wednesday,5-2,5,2,1,1,7,3,H
1914-10-03,1914,Sheffield United,Bradford City,1-1,1,1,1,1,2,0,D
1914-10-07,1914,Bradford Park Avenue,Bolton Wanderers,1-2,1,2,1,1,3,-1,A
1914-10-10,1914,Bradford City,Aston Villa,3-0,3,0,1,1,3,3,H
1914-10-10,1914,Burnley,Sheffield United,1-2,1,2,1,1,3,-1,A
1914-10-10,1914,Chelsea,Liverpool,3-1,3,1,1,1,4,2,H
1914-10-10,1914,Everton,Bradford Park Avenue,4-1,4,1,1,1,5,3,H
1914-10-10,1914,Manchester City,Newcastle United,1-1,1,1,1,1,2,0,D
1914-10-10,1914,Notts County,Blackburn Rovers,1-1,1,1,1,1,2,0,D
1914-10-10,1914,Sheffield Wednesday,Manchester United,1-0,1,0,1,1,1,1,H
1914-10-10,1914,Sunderland,Bolton Wanderers,4-3,4,3,1,1,7,1,H
1914-10-10,1914,Tottenham Hotspur,Middlesbrough,3-3,3,3,1,1,6,0,D
1914-10-10,1914,West Bromwich Albion,Oldham Athletic,0-0,0,0,1,1,0,0,D
1914-10-17,1914,Aston Villa,Burnley,3-3,3,3,1,1,6,0,D
1914-10-17,1914,Blackburn Rovers,Sunderland,3-1,3,1,1,1,4,2,H
1914-10-17,1914,Bolton Wanderers,Sheffield Wednesday,0-3,0,3,1,1,3,-3,A
1914-10-17,1914,Bradford Park Avenue,Chelsea,3-0,3,0,1,1,3,3,H
1914-10-17,1914,Liverpool,Bradford City,2-1,2,1,1,1,3,1,H
1914-10-17,1914,Manchester United,West Bromwich Albion,0-0,0,0,1,1,0,0,D
1914-10-17,1914,Middlesbrough,Newcastle United,1-1,1,1,1,1,2,0,D
1914-10-17,1914,Notts County,Manchester City,0-2,0,2,1,1,2,-2,A
1914-10-17,1914,Oldham Athletic,Everton,1-1,1,1,1,1,2,0,D
1914-10-17,1914,Sheffield United,Tottenham Hotspur,1-1,1,1,1,1,2,0,D
1914-10-24,1914,Bradford City,Bradford Park Avenue,3-2,3,2,1,1,5,1,H
1914-10-24,1914,Burnley,Liverpool,3-0,3,0,1,1,3,3,H
1914-10-24,1914,Chelsea,Oldham Athletic,2-2,2,2,1,1,4,0,D
1914-10-24,1914,Everton,Manchester United,4-2,4,2,1,1,6,2,H
1914-10-24,1914,Manchester City,Middlesbrough,1-1,1,1,1,1,2,0,D
1914-10-24,1914,Newcastle United,Sheffield United,4-3,4,3,1,1,7,1,H
1914-10-24,1914,Sheffield Wednesday,Blackburn Rovers,1-1,1,1,1,1,2,0,D
1914-10-24,1914,Sunderland,Notts County,3-1,3,1,1,1,4,2,H
1914-10-24,1914,Tottenham Hotspur,Aston Villa,0-2,0,2,1,1,2,-2,A
1914-10-24,1914,West Bromwich Albion,Bolton Wanderers,3-0,3,0,1,1,3,3,H
1914-10-31,1914,Aston Villa,Newcastle United,2-1,2,1,1,1,3,1,H
1914-10-31,1914,Blackburn Rovers,West Bromwich Albion,2-1,2,1,1,1,3,1,H
1914-10-31,1914,Bolton Wanderers,Everton,0-0,0,0,1,1,0,0,D
1914-10-31,1914,Bradford Park Avenue,Burnley,2-2,2,2,1,1,4,0,D
1914-10-31,1914,Liverpool,Tottenham Hotspur,7-2,7,2,1,1,9,5,H
1914-10-31,1914,Manchester United,Chelsea,2-2,2,2,1,1,4,0,D
1914-10-31,1914,Notts County,Sheffield Wednesday,1-2,1,2,1,1,3,-1,A
1914-10-31,1914,Oldham Athletic,Bradford City,1-0,1,0,1,1,1,1,H
1914-10-31,1914,Sheffield United,Middlesbrough,0-1,0,1,1,1,1,-1,A
1914-10-31,1914,Sunderland,Manchester City,0-2,0,2,1,1,2,-2,A
1914-11-07,1914,Bradford City,Manchester United,4-2,4,2,1,1,6,2,H
1914-11-07,1914,Burnley,Oldham Athletic,2-3,2,3,1,1,5,-1,A
1914-11-07,1914,Chelsea,Bolton Wanderers,2-1,2,1,1,1,3,1,H
1914-11-07,1914,Everton,Blackburn Rovers,1-3,1,3,1,1,4,-2,A
1914-11-07,1914,Manchester City,Sheffield United,0-0,0,0,1,1,0,0,D
1914-11-07,1914,Middlesbrough,Aston Villa,1-1,1,1,1,1,2,0,D
1914-11-07,1914,Newcastle United,Liverpool,0-0,0,0,1,1,0,0,D
1914-11-07,1914,Sheffield Wednesday,Sunderland,1-2,1,2,1,1,3,-1,A
1914-11-07,1914,Tottenham Hotspur,Bradford Park Avenue,3-0,3,0,1,1,3,3,H
1914-11-07,1914,West Bromwich Albion,Notts County,4-1,4,1,1,1,5,3,H
1914-11-14,1914,Aston Villa,Sheffield United,1-0,1,0,1,1,1,1,H
1914-11-14,1914,Blackburn Rovers,Chelsea,3-2,3,2,1,1,5,1,H
1914-11-14,1914,Bolton Wanderers,Bradford City,3-5,3,5,1,1,8,-2,A
1914-11-14,1914,Bradford Park Avenue,Newcastle United,1-0,1,0,1,1,1,1,H
1914-11-14,1914,Liverpool,Middlesbrough,1-1,1,1,1,1,2,0,D
1914-11-14,1914,Manchester United,Burnley,0-2,0,2,1,1,2,-2,A
1914-11-14,1914,Notts County,Everton,0-0,0,0,1,1,0,0,D
1914-11-14,1914,Oldham Athletic,Tottenham Hotspur,4-1,4,1,1,1,5,3,H
1914-11-14,1914,Sheffield Wednesday,Manchester City,2-1,2,1,1,1,3,1,H
1914-11-14,1914,Sunderland,West Bromwich Albion,1-2,1,2,1,1,3,-1,A
1914-11-21,1914,Bradford City,Blackburn Rovers,3-0,3,0,1,1,3,3,H
1914-11-21,1914,Burnley,Bolton Wanderers,5-0,5,0,1,1,5,5,H
1914-11-21,1914,Chelsea,Notts County,4-1,4,1,1,1,5,3,H
1914-11-21,1914,Everton,Sunderland,7-1,7,1,1,1,8,6,H
1914-11-21,1914,Middlesbrough,Bradford Park Avenue,1-3,1,3,1,1,4,-2,A
1914-11-21,1914,Newcastle United,Oldham Athletic,1-2,1,2,1,1,3,-1,A
1914-11-21,1914,Sheffield United,Liverpool,2-1,2,1,1,1,3,1,H
1914-11-21,1914,Tottenham Hotspur,Manchester United,2-0,2,0,1,1,2,2,H
1914-11-21,1914,West Bromwich Albion,Sheffield Wednesday,0-0,0,0,1,1,0,0,D
1914-11-25,1914,Manchester City,Aston Villa,1-0,1,0,1,1,1,1,H
1914-11-28,1914,Blackburn Rovers,Burnley,6-0,6,0,1,1,6,6,H
1914-11-28,1914,Bolton Wanderers,Tottenham Hotspur,4-2,4,2,1,1,6,2,H
1914-11-28,1914,Bradford Park Avenue,Sheffield United,2-0,2,0,1,1,2,2,H
1914-11-28,1914,Liverpool,Aston Villa,3-6,3,6,1,1,9,-3,A
1914-11-28,1914,Manchester United,Newcastle United,1-0,1,0,1,1,1,1,H
1914-11-28,1914,Notts County,Bradford City,0-0,0,0,1,1,0,0,D
1914-11-28,1914,Oldham Athletic,Middlesbrough,5-1,5,1,1,1,6,4,H
1914-11-28,1914,Sheffield Wednesday,Everton,1-4,1,4,1,1,5,-3,A
1914-11-28,1914,Sunderland,Chelsea,2-1,2,1,1,1,3,1,H
1914-11-28,1914,West Bromwich Albion,Manchester City,0-1,0,1,1,1,1,-1,A
1914-12-05,1914,Aston Villa,Bradford Park Avenue,1-2,1,2,1,1,3,-1,A
1914-12-05,1914,Bradford City,Sunderland,3-1,3,1,1,1,4,2,H
1914-12-05,1914,Burnley,Notts County,0-0,0,0,1,1,0,0,D
1914-12-05,1914,Chelsea,Sheffield Wednesday,0-0,0,0,1,1,0,0,D
1914-12-05,1914,Everton,West Bromwich Albion,2-1,2,1,1,1,3,1,H
1914-12-05,1914,Manchester City,Liverpool,1-1,1,1,1,1,2,0,D
1914-12-05,1914,Middlesbrough,Manchester United,1-1,1,1,1,1,2,0,D
1914-12-05,1914,Newcastle United,Bolton Wanderers,1-2,1,2,1,1,3,-1,A
1914-12-05,1914,Sheffield United,Oldham Athletic,3-0,3,0,1,1,3,3,H
1914-12-05,1914,Tottenham Hotspur,Blackburn Rovers,0-4,0,4,1,1,4,-4,A
1914-12-12,1914,Blackburn Rovers,Newcastle United,2-3,2,3,1,1,5,-1,A
1914-12-12,1914,Bolton Wanderers,Middlesbrough,4-0,4,0,1,1,4,4,H
1914-12-12,1914,Bradford Park Avenue,Liverpool,1-0,1,0,1,1,1,1,H
1914-12-12,1914,Everton,Manchester City,4-1,4,1,1,1,5,3,H
1914-12-12,1914,Manchester United,Sheffield United,1-2,1,2,1,1,3,-1,A
1914-12-12,1914,Notts County,Tottenham Hotspur,1-2,1,2,1,1,3,-1,A
1914-12-12,1914,Oldham Athletic,Aston Villa,3-3,3,3,1,1,6,0,D
1914-12-12,1914,Sheffield Wednesday,Bradford City,3-3,3,3,1,1,6,0,D
1914-12-12,1914,Sunderland,Burnley,2-1,2,1,1,1,3,1,H
1914-12-12,1914,West Bromwich Albion,Chelsea,2-0,2,0,1,1,2,2,H
1914-12-19,1914,Aston Villa,Manchester United,3-3,3,3,1,1,6,0,D
1914-12-19,1914,Bradford City,West Bromwich Albion,5-0,5,0,1,1,5,5,H
1914-12-19,1914,Burnley,Sheffield Wednesday,2-3,2,3,1,1,5,-1,A
1914-12-19,1914,Chelsea,Everton,2-0,2,0,1,1,2,2,H
1914-12-19,1914,Liverpool,Oldham Athletic,1-2,1,2,1,1,3,-1,A
1914-12-19,1914,Manchester City,Bradford Park Avenue,2-3,2,3,1,1,5,-1,A
1914-12-19,1914,Middlesbrough,Blackburn Rovers,1-4,1,4,1,1,5,-3,A
1914-12-19,1914,Newcastle United,Notts County,1-1,1,1,1,1,2,0,D
1914-12-19,1914,Sheffield United,Bolton Wanderers,3-1,3,1,1,1,4,2,H
1914-12-19,1914,Tottenham Hotspur,Sunderland,0-6,0,6,1,1,6,-6,A
1914-12-25,1914,Blackburn Rovers,Aston Villa,1-2,1,2,1,1,3,-1,A
1914-12-25,1914,Bolton Wanderers,Liverpool,0-1,0,1,1,1,1,-1,A
1914-12-25,1914,Bradford Park Avenue,Oldham Athletic,1-1,1,1,1,1,2,0,D
1914-12-25,1914,Burnley,West Bromwich Albion,0-2,0,2,1,1,2,-2,A
1914-12-25,1914,Chelsea,Manchester City,0-0,0,0,1,1,0,0,D
1914-12-25,1914,Everton,Bradford City,1-1,1,1,1,1,2,0,D
1914-12-25,1914,Middlesbrough,Notts County,1-0,1,0,1,1,1,1,H
1914-12-25,1914,Newcastle United,Sunderland,2-5,2,5,1,1,7,-3,A
1914-12-25,1914,Sheffield Wednesday,Tottenham Hotspur,3-2,3,2,1,1,5,1,H
1914-12-26,1914,Aston Villa,Bolton Wanderers,1-7,1,7,1,1,8,-6,A
1914-12-26,1914,Bradford City,Everton,0-1,0,1,1,1,1,-1,A
1914-12-26,1914,Liverpool,Manchester United,1-1,1,1,1,1,2,0,D
1914-12-26,1914,Manchester City,Chelsea,2-1,2,1,1,1,3,1,H
1914-12-26,1914,Notts County,Middlesbrough,5-1,5,1,1,1,6,4,H
1914-12-26,1914,Oldham Athletic,Bradford Park Avenue,6-2,6,2,1,1,8,4,H
1914-12-26,1914,Sheffield United,Blackburn Rovers,1-2,1,2,1,1,3,-1,A
1914-12-26,1914,Sunderland,Newcastle United,2-4,2,4,1,1,6,-2,A
1914-12-26,1914,Tottenham Hotspur,Sheffield Wednesday,6-1,6,1,1,1,7,5,H
1914-12-26,1914,West Bromwich Albion,Burnley,3-0,3,0,1,1,3,3,H
1914-12-28,1914,Chelsea,Burnley,1-4,1,4,1,1,5,-3,A
1914-12-28,1914,Sheffield United,Notts County,1-0,1,0,1,1,1,1,H
1915-01-01,1914,Blackburn Rovers,Sheffield United,1-2,1,2,1,1,3,-1,A
1915-01-01,1914,Bolton Wanderers,Aston Villa,2-2,2,2,1,1,4,0,D
1915-01-01,1914,Everton,Tottenham Hotspur,1-1,1,1,1,1,2,0,D
1915-01-01,1914,Manchester United,Bradford Park Avenue,1-2,1,2,1,1,3,-1,A
1915-01-01,1914,Middlesbrough,Sunderland,2-3,2,3,1,1,5,-1,A
1915-01-01,1914,Oldham Athletic,Manchester City,0-0,0,0,1,1,0,0,D
1915-01-01,1914,Sheffield Wednesday,Newcastle United,2-1,2,1,1,1,3,1,H
1915-01-02,1914,Blackburn Rovers,Bradford Park Avenue,2-2,2,2,1,1,4,0,D
1915-01-02,1914,Bolton Wanderers,Oldham Athletic,2-0,2,0,1,1,2,2,H
1915-01-02,1914,Bradford City,Burnley,0-0,0,0,1,1,0,0,D
1915-01-02,1914,Chelsea,Tottenham Hotspur,1-1,1,1,1,1,2,0,D
1915-01-02,1914,Everton,Newcastle United,3-0,3,0,1,1,3,3,H
1915-01-02,1914,Manchester City,Manchester United,1-1,1,1,1,1,2,0,D
1915-01-02,1914,Notts County,Liverpool,3-1,3,1,1,1,4,2,H
1915-01-02,1914,Sheffield Wednesday,Sheffield United,1-1,1,1,1,1,2,0,D
1915-01-02,1914,Sunderland,Aston Villa,4-0,4,0,1,1,4,4,H
1915-01-02,1914,West Bromwich Albion,Middlesbrough,1-0,1,0,1,1,1,1,H
1915-01-16,1914,Aston Villa,Sheffield Wednesday,0-0,0,0,1,1,0,0,D
1915-01-16,1914,Bradford Park Avenue,Notts County,3-1,3,1,1,1,4,2,H
1915-01-16,1914,Liverpool,Sunderland,2-1,2,1,1,1,3,1,H
1915-01-16,1914,Manchester United,Bolton Wanderers,4-1,4,1,1,1,5,3,H
1915-01-16,1914,Middlesbrough,Everton,5-1,5,1,1,1,6,4,H
1915-01-16,1914,Oldham Athletic,Blackburn Rovers,3-2,3,2,1,1,5,1,H
1915-01-16,1914,Sheffield United,West Bromwich Albion,2-0,2,0,1,1,2,2,H
1915-01-16,1914,Tottenham Hotspur,Bradford City,0-0,0,0,1,1,0,0,D
1915-01-18,1914,Burnley,Manchester City,1-2,1,2,1,1,3,-1,A
1915-01-23,1914,Blackburn Rovers,Manchester United,3-3,3,3,1,1,6,0,D
1915-01-23,1914,Bradford City,Newcastle United,1-1,1,1,1,1,2,0,D
1915-01-23,1914,Burnley,Tottenham Hotspur,3-1,3,1,1,1,4,2,H
1915-01-23,1914,Chelsea,Middlesbrough,2-2,2,2,1,1,4,0,D
1915-01-23,1914,Everton,Sheffield United,0-0,0,0,1,1,0,0,D
1915-01-23,1914,Manchester City,Bolton Wanderers,2-1,2,1,1,1,3,1,H
1915-01-23,1914,Notts County,Oldham Athletic,2-1,2,1,1,1,3,1,H
1915-01-23,1914,Sheffield Wednesday,Liverpool,2-1,2,1,1,1,3,1,H
1915-01-23,1914,Sunderland,Bradford Park Avenue,3-3,3,3,1,1,6,0,D
1915-01-23,1914,West Bromwich Albion,Aston Villa,2-0,2,0,1,1,2,2,H
1915-01-30,1914,Manchester United,Notts County,2-2,2,2,1,1,4,0,D
1915-02-01,1914,Oldham Athletic,Sunderland,4-5,4,5,1,1,9,-1,A
1915-02-03,1914,Middlesbrough,Bradford City,3-0,3,0,1,1,3,3,H
1915-02-06,1914,Bradford City,Sheffield United,1-1,1,1,1,1,2,0,D
1915-02-06,1914,Burnley,Middlesbrough,4-0,4,0,1,1,4,4,H
1915-02-06,1914,Chelsea,Aston Villa,3-1,3,1,1,1,4,2,H
1915-02-06,1914,Everton,Liverpool,1-3,1,3,1,1,4,-2,A
1915-02-06,1914,Manchester City,Blackburn Rovers,1-3,1,3,1,1,4,-2,A
1915-02-06,1914,Sheffield Wednesday,Oldham Athletic,2-2,2,2,1,1,4,0,D
1915-02-06,1914,Sunderland,Manchester United,1-0,1,0,1,1,1,1,H
1915-02-06,1914,West Bromwich Albion,Bradford Park Avenue,1-0,1,0,1,1,1,1,H
1915-02-10,1914,Aston Villa,Everton,1-5,1,5,1,1,6,-4,A
1915-02-13,1914,Aston Villa,Bradford City,0-0,0,0,1,1,0,0,D
1915-02-13,1914,Blackburn Rovers,Notts County,5-1,5,1,1,1,6,4,H
1915-02-13,1914,Liverpool,Chelsea,3-3,3,3,1,1,6,0,D
1915-02-13,1914,Manchester United,Sheffield Wednesday,2-0,2,0,1,1,2,2,H
1915-02-13,1914,Middlesbrough,Tottenham Hotspur,7-5,7,5,1,1,12,2,H
1915-02-13,1914,Newcastle United,Manchester City,2-1,2,1,1,1,3,1,H
1915-02-13,1914,Sheffield United,Burnley,1-0,1,0,1,1,1,1,H
1915-02-20,1914,Sunderland,Blackburn Rovers,5-1,5,1,1,1,6,4,H
1915-02-20,1914,Tottenham Hotspur,Notts County,2-0,2,0,1,1,2,2,H
1915-02-20,1914,West Bromwich Albion,Manchester United,0-0,0,0,1,1,0,0,D
1915-02-22,1914,Burnley,Aston Villa,2-1,2,1,1,1,3,1,H
1915-02-22,1914,Manchester City,Notts County,0-0,0,0,1,1,0,0,D
1915-02-27,1914,Aston Villa,Tottenham Hotspur,3-1,3,1,1,1,4,2,H
1915-02-27,1914,Blackburn Rovers,Sheffield Wednesday,1-1,1,1,1,1,2,0,D
1915-02-27,1914,Bolton Wanderers,West Bromwich Albion,1-1,1,1,1,1,2,0,D
1915-02-27,1914,Liverpool,Burnley,3-0,3,0,1,1,3,3,H
1915-02-27,1914,Manchester United,Everton,1-2,1,2,1,1,3,-1,A
1915-02-27,1914,Middlesbrough,Manchester City,1-0,1,0,1,1,1,1,H
1915-02-27,1914,Notts County,Sunderland,2-1,2,1,1,1,3,1,H
1915-02-27,1914,Oldham Athletic,Chelsea,0-0,0,0,1,1,0,0,D
1915-02-27,1914,Sheffield United,Newcastle United,1-0,1,0,1,1,1,1,H
1915-03-01,1914,Chelsea,Bradford Park Avenue,0-1,0,1,1,1,1,-1,A
1915-03-01,1914,Sheffield Wednesday,Bolton Wanderers,7-0,7,0,1,1,7,7,H
1915-03-06,1914,Burnley,Bradford Park Avenue,2-0,2,0,1,1,2,2,H
1915-03-06,1914,Manchester City,Sunderland,2-0,2,0,1,1,2,2,H
1915-03-06,1914,Sheffield Wednesday,Notts County,0-0,0,0,1,1,0,0,D
1915-03-06,1914,Tottenham Hotspur,Liverpool,1-1,1,1,1,1,2,0,D
1915-03-06,1914,West Bromwich Albion,Blackburn Rovers,0-0,0,0,1,1,0,0,D
1915-03-08,1914,Sheffield United,Chelsea,1-1,1,1,1,1,2,0,D
1915-03-09,1914,Oldham Athletic,West Bromwich Albion,1-1,1,1,1,1,2,0,D
1915-03-10,1914,Bolton Wanderers,Sunderland,1-1,1,1,1,1,2,0,D
1915-03-10,1914,Bradford City,Liverpool,3-2,3,2,1,1,5,1,H
1915-03-10,1914,Newcastle United,Middlesbrough,1-2,1,2,1,1,3,-1,A
1915-03-13,1914,Aston Villa,Middlesbrough,5-0,5,0,1,1,5,5,H
1915-03-13,1914,Blackburn Rovers,Everton,2-1,2,1,1,1,3,1,H
1915-03-13,1914,Bolton Wanderers,Burnley,3-1,3,1,1,1,4,2,H
1915-03-13,1914,Bradford Park Avenue,Tottenham Hotspur,5-1,5,1,1,1,6,4,H
1915-03-13,1914,Liverpool,Manchester City,3-2,3,2,1,1,5,1,H
1915-03-13,1914,Manchester United,Bradford City,1-0,1,0,1,1,1,1,H
1915-03-13,1914,Notts County,West Bromwich Albion,1-1,1,1,1,1,2,0,D
1915-03-13,1914,Sunderland,Sheffield Wednesday,3-1,3,1,1,1,4,2,H
1915-03-15,1914,Tottenham Hotspur,Manchester City,2-2,2,2,1,1,4,0,D
1915-03-17,1914,Bradford Park Avenue,Sheffield Wednesday,1-1,1,1,1,1,2,0,D
1915-03-17,1914,Everton,Oldham Athletic,3-4,3,4,1,1,7,-1,A
1915-03-17,1914,Middlesbrough,Sheffield United,2-2,2,2,1,1,4,0,D
1915-03-17,1914,Newcastle United,Chelsea,2-0,2,0,1,1,2,2,H
1915-03-17,1914,Notts County,Bolton Wanderers,0-0,0,0,1,1,0,0,D
1915-03-20,1914,Bradford City,Bolton Wanderers,4-2,4,2,1,1,6,2,H
1915-03-20,1914,Burnley,Manchester United,3-0,3,0,1,1,3,3,H
1915-03-20,1914,Chelsea,Blackburn Rovers,1-3,1,3,1,1,4,-2,A
1915-03-20,1914,Everton,Notts County,4-0,4,0,1,1,4,4,H
1915-03-20,1914,Manchester City,Sheffield Wednesday,4-0,4,0,1,1,4,4,H
1915-03-20,1914,Middlesbrough,Liverpool,3-0,3,0,1,1,3,3,H
1915-03-20,1914,Newcastle United,Bradford Park Avenue,1-1,1,1,1,1,2,0,D
1915-03-20,1914,Sheffield United,Aston Villa,3-0,3,0,1,1,3,3,H
1915-03-20,1914,Tottenham Hotspur,Oldham Athletic,1-0,1,0,1,1,1,1,H
1915-03-20,1914,West Bromwich Albion,Sunderland,1-2,1,2,1,1,3,-1,A
1915-03-22,1914,Everton,Bolton Wanderers,5-3,5,3,1,1,8,2,H
1915-03-24,1914,Bradford City,Oldham Athletic,1-0,1,0,1,1,1,1,H
1915-03-24,1914,Liverpool,West Bromwich Albion,3-1,3,1,1,1,4,2,H
1915-03-27,1914,Bradford Park Avenue,Middlesbrough,2-0,2,0,1,1,2,2,H
1915-03-27,1914,Manchester United,Tottenham Hotspur,1-1,1,1,1,1,2,0,D
1915-03-27,1914,Oldham Athletic,Newcastle United,1-0,1,0,1,1,1,1,H
1915-03-27,1914,Sheffield Wednesday,West Bromwich Albion,0-0,0,0,1,1,0,0,D
1915-03-29,1914,Blackburn Rovers,Bradford City,2-1,2,1,1,1,3,1,H
1915-03-29,1914,Liverpool,Newcastle United,2-2,2,2,1,1,4,0,D
1915-03-29,1914,Sheffield United,Manchester City,0-0,0,0,1,1,0,0,D
1915-04-02,1914,Aston Villa,Blackburn Rovers,2-1,2,1,1,1,3,1,H
1915-04-02,1914,Bolton Wanderers,Bradford Park Avenue,3-2,3,2,1,1,5,1,H
1915-04-02,1914,Chelsea,Bradford City,2-0,2,0,1,1,2,2,H
1915-04-02,1914,Everton,Burnley,0-2,0,2,1,1,2,-2,A
1915-04-02,1914,Manchester United,Liverpool,2-0,2,0,1,1,2,2,H
1915-04-02,1914,Notts County,Sheffield United,3-1,3,1,1,1,4,2,H
1915-04-02,1914,Sunderland,Middlesbrough,4-1,4,1,1,1,5,3,H
1915-04-02,1914,Tottenham Hotspur,Newcastle United,0-0,0,0,1,1,0,0,D
1915-04-03,1914,Aston Villa,Liverpool,6-2,6,2,1,1,8,4,H
1915-04-03,1914,Bradford City,Notts County,3-1,3,1,1,1,4,2,H
1915-04-03,1914,Burnley,Blackburn Rovers,3-2,3,2,1,1,5,1,H
1915-04-03,1914,Chelsea,Sunderland,3-0,3,0,1,1,3,3,H
1915-04-03,1914,Everton,Sheffield Wednesday,0-1,0,1,1,1,1,-1,A
1915-04-03,1914,Manchester City,West Bromwich Albion,4-0,4,0,1,1,4,4,H
1915-04-03,1914,Middlesbrough,Oldham Athletic,4-1,4,1,1,1,5,3,H
1915-04-03,1914,Newcastle United,Manchester United,2-0,2,0,1,1,2,2,H
1915-04-03,1914,Sheffield United,Bradford Park Avenue,3-2,3,2,1,1,5,1,H
1915-04-03,1914,Tottenham Hotspur,Bolton Wanderers,4-2,4,2,1,1,6,2,H
1915-04-05,1914,Bradford Park Avenue,Manchester United,5-0,5,0,1,1,5,5,H
1915-04-05,1914,Burnley,Chelsea,2-0,2,0,1,1,2,2,H
1915-04-05,1914,Liverpool,Blackburn Rovers,3-0,3,0,1,1,3,3,H
1915-04-05,1914,Manchester City,Oldham Athletic,0-0,0,0,1,1,0,0,D
1915-04-05,1914,Middlesbrough,Sheffield Wednesday,3-1,3,1,1,1,4,2,H
1915-04-05,1914,Notts County,Aston Villa,1-1,1,1,1,1,2,0,D
1915-04-05,1914,Sheffield United,Sunderland,1-1,1,1,1,1,2,0,D
1915-04-05,1914,West Bromwich Albion,Newcastle United,2-0,2,0,1,1,2,2,H
1915-04-06,1914,Bradford City,Manchester City,0-0,0,0,1,1,0,0,D
1915-04-06,1914,Oldham Athletic,Manchester United,1-0,1,0,1,1,1,1,H
1915-04-06,1914,Sunderland,Everton,0-3,0,3,1,1,3,-3,A
1915-04-06,1914,West Bromwich Albion,Tottenham Hotspur,3-2,3,2,1,1,5,1,H
1915-04-10,1914,Blackburn Rovers,Tottenham Hotspur,4-1,4,1,1,1,5,3,H
1915-04-10,1914,Bolton Wanderers,Newcastle United,0-0,0,0,1,1,0,0,D
1915-04-10,1914,Bradford Park Avenue,Aston Villa,2-2,2,2,1,1,4,0,D
1915-04-10,1914,Manchester United,Middlesbrough,2-2,2,2,1,1,4,0,D
1915-04-10,1914,Notts County,Burnley,0-0,0,0,1,1,0,0,D
1915-04-10,1914,Oldham Athletic,Sheffield United,3-0,3,0,1,1,3,3,H
1915-04-10,1914,Sheffield Wednesday,Chelsea,3-2,3,2,1,1,5,1,H
1915-04-10,1914,Sunderland,Bradford City,1-1,1,1,1,1,2,0,D
1915-04-10,1914,West Bromwich Albion,Everton,1-2,1,2,1,1,3,-1,A
1915-04-12,1914,Liverpool,Sheffield United,2-1,2,1,1,1,3,1,H
1915-04-14,1914,Bolton Wanderers,Chelsea,3-1,3,1,1,1,4,2,H
1915-04-14,1914,Bradford Park Avenue,Everton,1-2,1,2,1,1,3,-1,A
1915-04-14,1914,Newcastle United,Burnley,1-2,1,2,1,1,3,-1,A
1915-04-17,1914,Aston Villa,Oldham Athletic,0-0,0,0,1,1,0,0,D
1915-04-17,1914,Bradford City,Sheffield Wednesday,1-0,1,0,1,1,1,1,H
1915-04-17,1914,Burnley,Sunderland,2-1,2,1,1,1,3,1,H
1915-04-17,1914,Chelsea,West Bromwich Albion,4-1,4,1,1,1,5,3,H
1915-04-17,1914,Liverpool,Bradford Park Avenue,2-1,2,1,1,1,3,1,H
1915-04-17,1914,Manchester City,Everton,0-1,0,1,1,1,1,-1,A
1915-04-17,1914,Middlesbrough,Bolton Wanderers,0-0,0,0,1,1,0,0,D
1915-04-17,1914,Newcastle United,Blackburn Rovers,2-1,2,1,1,1,3,1,H
1915-04-17,1914,Sheffield United,Manchester United,3-1,3,1,1,1,4,2,H
1915-04-19,1914,Chelsea,Manchester United,1-3,1,3,1,1,4,-2,A
1915-04-19,1914,Tottenham Hotspur,Sheffield United,1-1,1,1,1,1,2,0,D
1915-04-20,1914,Oldham Athletic,Burnley,1-2,1,2,1,1,3,-1,A
1915-04-21,1914,Aston Villa,Manchester City,4-1,4,1,1,1,5,3,H
1915-04-24,1914,Blackburn Rovers,Middlesbrough,4-0,4,0,1,1,4,4,H
1915-04-24,1914,Bradford Park Avenue,Manchester City,3-1,3,1,1,1,4,2,H
1915-04-24,1914,Notts County,Newcastle United,1-0,1,0,1,1,1,1,H
1915-04-24,1914,Oldham Athletic,Liverpool,0-2,0,2,1,1,2,-2,A
1915-04-24,1914,Sheffield Wednesday,Burnley,0-0,0,0,1,1,0,0,D
1915-04-24,1914,Sunderland,Tottenham Hotspur,5-0,5,0,1,1,5,5,H
1915-04-24,1914,West Bromwich Albion,Bradford City,3-0,3,0,1,1,3,3,H
1915-04-26,1914,Bolton Wanderers,Sheffield United,0-1,0,1,1,1,1,-1,A
1915-04-26,1914,Everton,Chelsea,2-2,2,2,1,1,4,0,D
1915-04-26,1914,Manchester United,Aston Villa,1-0,1,0,1,1,1,1,H
1915-04-28,1914,Bradford Park Avenue,Bradford City,3-0,3,0,1,1,3,3,H
1915-04-28,1914,Newcastle United,Aston Villa,3-0,3,0,1,1,3,3,H
1915-04-28,1914,Notts County,Chelsea,2-0,2,0,1,1,2,2,H
1919-08-30,1919,Arsenal,Newcastle United,0-1,0,1,1,1,1,-1,A
1919-08-30,1919,Blackburn Rovers,Preston North End,4-0,4,0,1,1,4,4,H
1919-08-30,1919,Bolton Wanderers,Bradford Park Avenue,1-2,1,2,1,1,3,-1,A
1919-08-30,1919,Bradford City,Liverpool,1-3,1,3,1,1,4,-2,A
1919-08-30,1919,Derby County,Manchester United,1-1,1,1,1,1,2,0,D
1919-08-30,1919,Everton,Chelsea,2-3,2,3,1,1,5,-1,A
1919-08-30,1919,Manchester City,Sheffield United,3-3,3,3,1,1,6,0,D
1919-08-30,1919,Notts County,Burnley,2-0,2,0,1,1,2,2,H
1919-08-30,1919,Sheffield Wednesday,Middlesbrough,0-1,0,1,1,1,1,-1,A
1919-08-30,1919,Sunderland,Aston Villa,2-1,2,1,1,1,3,1,H
1919-08-30,1919,West Bromwich Albion,Oldham Athletic,3-1,3,1,1,1,4,2,H
1919-09-01,1919,Aston Villa,Derby County,2-2,2,2,1,1,4,0,D
1919-09-01,1919,Bolton Wanderers,Burnley,1-1,1,1,1,1,2,0,D
1919-09-01,1919,Chelsea,Sunderland,2-0,2,0,1,1,2,2,H
1919-09-01,1919,Liverpool,Arsenal,2-3,2,3,1,1,5,-1,A
1919-09-01,1919,Manchester United,Sheffield Wednesday,0-0,0,0,1,1,0,0,D
1919-09-01,1919,Oldham Athletic,Manchester City,1-3,1,3,1,1,4,-2,A
1919-09-01,1919,Preston North End,Bradford City,1-5,1,5,1,1,6,-4,A
1919-09-01,1919,Sheffield United,Notts County,3-0,3,0,1,1,3,3,H
1919-09-03,1919,Bradford Park Avenue,Everton,0-2,0,2,1,1,2,-2,A
1919-09-03,1919,Middlesbrough,Blackburn Rovers,2-2,2,2,1,1,4,0,D
1919-09-03,1919,Newcastle United,West Bromwich Albion,0-2,0,2,1,1,2,-2,A
1919-09-06,1919,Aston Villa,Sunderland,0-3,0,3,1,1,3,-3,A
1919-09-06,1919,Bradford Park Avenue,Bolton Wanderers,2-0,2,0,1,1,2,2,H
1919-09-06,1919,Burnley,Notts County,2-1,2,1,1,1,3,1,H
1919-09-06,1919,Chelsea,Everton,0-1,0,1,1,1,1,-1,A
1919-09-06,1919,Liverpool,Bradford City,2-1,2,1,1,1,3,1,H
1919-09-06,1919,Manchester United,Derby County,0-2,0,2,1,1,2,-2,A
1919-09-06,1919,Middlesbrough,Sheffield Wednesday,3-0,3,0,1,1,3,3,H
1919-09-06,1919,Newcastle United,Arsenal,3-1,3,1,1,1,4,2,H
1919-09-06,1919,Oldham Athletic,West Bromwich Albion,2-1,2,1,1,1,3,1,H
1919-09-06,1919,Preston North End,Blackburn Rovers,0-0,0,0,1,1,0,0,D
1919-09-06,1919,Sheffield United,Manchester City,3-1,3,1,1,1,4,2,H
1919-09-08,1919,Arsenal,Liverpool,1-0,1,0,1,1,1,1,H
1919-09-08,1919,Burnley,Bradford City,1-1,1,1,1,1,2,0,D
1919-09-08,1919,Derby County,Aston Villa,1-0,1,0,1,1,1,1,H
1919-09-08,1919,Everton,Bradford Park Avenue,2-0,2,0,1,1,2,2,H
1919-09-08,1919,Manchester City,Oldham Athletic,3-1,3,1,1,1,4,2,H
1919-09-08,1919,Sheffield Wednesday,Manchester United,1-3,1,3,1,1,4,-2,A
1919-09-08,1919,West Bromwich Albion,Newcastle United,3-0,3,0,1,1,3,3,H
1919-09-10,1919,Bradford City,Preston North End,2-2,2,2,1,1,4,0,D
1919-09-10,1919,Burnley,Bolton Wanderers,2-1,2,1,1,1,3,1,H
1919-09-10,1919,Sunderland,Chelsea,3-2,3,2,1,1,5,1,H
1919-09-13,1919,Blackburn Rovers,Burnley,2-3,2,3,1,1,5,-1,A
1919-09-13,1919,Bradford Park Avenue,Oldham Athletic,2-0,2,0,1,1,2,2,H
1919-09-13,1919,Chelsea,Newcastle United,0-0,0,0,1,1,0,0,D
1919-09-13,1919,Derby County,Bradford City,3-0,3,0,1,1,3,3,H
1919-09-13,1919,Liverpool,Aston Villa,2-1,2,1,1,1,3,1,H
1919-09-13,1919,Manchester City,Bolton Wanderers,1-4,1,4,1,1,5,-3,A
1919-09-13,1919,Middlesbrough,Sheffield United,1-0,1,0,1,1,1,1,H
1919-09-13,1919,Preston North End,Manchester United,2-3,2,3,1,1,5,-1,A
1919-09-13,1919,Sheffield Wednesday,Notts County,0-0,0,0,1,1,0,0,D
1919-09-13,1919,Sunderland,Arsenal,1-1,1,1,1,1,2,0,D
1919-09-13,1919,West Bromwich Albion,Everton,4-3,4,3,1,1,7,1,H
1919-09-15,1919,Blackburn Rovers,Middlesbrough,0-2,0,2,1,1,2,-2,A
1919-09-17,1919,Middlesbrough,Bolton Wanderers,1-3,1,3,1,1,4,-2,A
1919-09-20,1919,Arsenal,Sunderland,3-2,3,2,1,1,5,1,H
1919-09-20,1919,Aston Villa,Liverpool,0-1,0,1,1,1,1,-1,A
1919-09-20,1919,Bolton Wanderers,Manchester City,6-2,6,2,1,1,8,4,H
1919-09-20,1919,Bradford City,Derby County,3-1,3,1,1,1,4,2,H
1919-09-20,1919,Burnley,Blackburn Rovers,3-1,3,1,1,1,4,2,H
1919-09-20,1919,Everton,West Bromwich Albion,2-5,2,5,1,1,7,-3,A
1919-09-20,1919,Manchester United,Preston North End,5-1,5,1,1,1,6,4,H
1919-09-20,1919,Newcastle United,Chelsea,3-0,3,0,1,1,3,3,H
1919-09-20,1919,Notts County,Sheffield Wednesday,3-1,3,1,1,1,4,2,H
1919-09-20,1919,Oldham Athletic,Bradford Park Avenue,2-2,2,2,1,1,4,0,D
1919-09-20,1919,Sheffield United,Middlesbrough,5-1,5,1,1,1,6,4,H
1919-09-24,1919,Newcastle United,Derby County,0-0,0,0,1,1,0,0,D
1919-09-27,1919,Blackburn Rovers,Arsenal,2-2,2,2,1,1,4,0,D
1919-09-27,1919,Bradford Park Avenue,Aston Villa,6-1,6,1,1,1,7,5,H
1919-09-27,1919,Chelsea,Burnley,0-1,0,1,1,1,1,-1,A
1919-09-27,1919,Derby County,Bolton Wanderers,1-2,1,2,1,1,3,-1,A
1919-09-27,1919,Liverpool,Newcastle United,1-1,1,1,1,1,2,0,D
1919-09-27,1919,Manchester City,Notts County,4-1,4,1,1,1,5,3,H
1919-09-27,1919,Middlesbrough,Manchester United,1-1,1,1,1,1,2,0,D
1919-09-27,1919,Preston North End,Oldham Athletic,2-1,2,1,1,1,3,1,H
1919-09-27,1919,Sheffield Wednesday,Sheffield United,2-1,2,1,1,1,3,1,H
1919-09-27,1919,Sunderland,Everton,2-3,2,3,1,1,5,-1,A
1919-09-27,1919,West Bromwich Albion,Bradford City,4-1,4,1,1,1,5,3,H
1919-10-02,1919,Notts County,Sheffield United,2-2,2,2,1,1,4,0,D
1919-10-04,1919,Arsenal,Blackburn Rovers,0-1,0,1,1,1,1,-1,A
1919-10-04,1919,Aston Villa,Bradford Park Avenue,1-0,1,0,1,1,1,1,H
1919-10-04,1919,Bolton Wanderers,Derby County,3-0,3,0,1,1,3,3,H
1919-10-04,1919,Bradford City,West Bromwich Albion,3-0,3,0,1,1,3,3,H
1919-10-04,1919,Burnley,Chelsea,2-3,2,3,1,1,5,-1,A
1919-10-04,1919,Everton,Sunderland,1-3,1,3,1,1,4,-2,A
1919-10-04,1919,Manchester United,Middlesbrough,1-1,1,1,1,1,2,0,D
1919-10-04,1919,Newcastle United,Liverpool,3-0,3,0,1,1,3,3,H
1919-10-04,1919,Notts County,Manchester City,4-1,4,1,1,1,5,3,H
1919-10-04,1919,Oldham Athletic,Preston North End,4-1,4,1,1,1,5,3,H
1919-10-04,1919,Sheffield United,Sheffield Wednesday,3-0,3,0,1,1,3,3,H
1919-10-11,1919,Bradford Park Avenue,Newcastle United,0-1,0,1,1,1,1,-1,A
1919-10-11,1919,Burnley,Sheffield United,2-2,2,2,1,1,4,0,D
1919-10-11,1919,Chelsea,Liverpool,1-0,1,0,1,1,1,1,H
1919-10-11,1919,Derby County,Notts County,3-1,3,1,1,1,4,2,H
1919-10-11,1919,Everton,Arsenal,2-3,2,3,1,1,5,-1,A
1919-10-11,1919,Manchester City,Manchester United,3-3,3,3,1,1,6,0,D
1919-10-11,1919,Middlesbrough,Oldham Athletic,1-0,1,0,1,1,1,1,H
1919-10-11,1919,Preston North End,Aston Villa,3-0,3,0,1,1,3,3,H
1919-10-11,1919,Sheffield Wednesday,Blackburn Rovers,0-0,0,0,1,1,0,0,D
1919-10-11,1919,Sunderland,Bradford City,2-0,2,0,1,1,2,2,H
1919-10-11,1919,West Bromwich Albion,Bolton Wanderers,4-1,4,1,1,1,5,3,H
1919-10-18,1919,Arsenal,Everton,1-1,1,1,1,1,2,0,D
1919-10-18,1919,Aston Villa,Preston North End,2-4,2,4,1,1,6,-2,A
1919-10-18,1919,Blackburn Rovers,Sheffield Wednesday,1-0,1,0,1,1,1,1,H
1919-10-18,1919,Bolton Wanderers,West Bromwich Albion,1-2,1,2,1,1,3,-1,A
1919-10-18,1919,Bradford City,Sunderland,2-0,2,0,1,1,2,2,H
1919-10-18,1919,Liverpool,Chelsea,0-1,0,1,1,1,1,-1,A
1919-10-18,1919,Manchester United,Manchester City,1-0,1,0,1,1,1,1,H
1919-10-18,1919,Newcastle United,Bradford Park Avenue,4-0,4,0,1,1,4,4,H
1919-10-18,1919,Notts County,Derby County,2-2,2,2,1,1,4,0,D
1919-10-18,1919,Oldham Athletic,Middlesbrough,1-2,1,2,1,1,3,-1,A
1919-10-18,1919,Sheffield United,Burnley,1-3,1,3,1,1,4,-2,A
1919-10-20,1919,Sheffield United,Blackburn Rovers,2-0,2,0,1,1,2,2,H
1919-10-25,1919,Arsenal,Bradford City,1-2,1,2,1,1,3,-1,A
1919-10-25,1919,Bradford Park Avenue,Chelsea,1-0,1,0,1,1,1,1,H
1919-10-25,1919,Burnley,Liverpool,1-2,1,2,1,1,3,-1,A
1919-10-25,1919,Derby County,Oldham Athletic,1-1,1,1,1,1,2,0,D
1919-10-25,1919,Everton,Blackburn Rovers,3-0,3,0,1,1,3,3,H
1919-10-25,1919,Manchester City,Sheffield Wednesday,4-2,4,2,1,1,6,2,H
1919-10-25,1919,Middlesbrough,Aston Villa,1-4,1,4,1,1,5,-3,A
1919-10-25,1919,Preston North End,Newcastle United,2-3,2,3,1,1,5,-1,A
1919-10-25,1919,Sheffield United,Manchester United,2-2,2,2,1,1,4,0,D
1919-10-25,1919,Sunderland,Bolton Wanderers,2-0,2,0,1,1,2,2,H
1919-10-25,1919,West Bromwich Albion,Notts County,8-0,8,0,1,1,8,8,H
1919-11-01,1919,Aston Villa,Middlesbrough,5-3,5,3,1,1,8,2,H
1919-11-01,1919,Blackburn Rovers,Everton,3-2,3,2,1,1,5,1,H
1919-11-01,1919,Bolton Wanderers,Sunderland,1-0,1,0,1,1,1,1,H
1919-11-01,1919,Bradford City,Arsenal,1-1,1,1,1,1,2,0,D
1919-11-01,1919,Chelsea,Bradford Park Avenue,4-0,4,0,1,1,4,4,H
1919-11-01,1919,Liverpool,Burnley,0-1,0,1,1,1,1,-1,A
1919-11-01,1919,Manchester United,Sheffield United,3-0,3,0,1,1,3,3,H
1919-11-01,1919,Newcastle United,Preston North End,1-0,1,0,1,1,1,1,H
1919-11-01,1919,Notts County,West Bromwich Albion,2-0,2,0,1,1,2,2,H
1919-11-01,1919,Oldham Athletic,Derby County,3-0,3,0,1,1,3,3,H
1919-11-01,1919,Sheffield Wednesday,Manchester City,0-0,0,0,1,1,0,0,D
1919-11-08,1919,Arsenal,Bolton Wanderers,2-2,2,2,1,1,4,0,D
1919-11-08,1919,Bradford Park Avenue,Liverpool,1-2,1,2,1,1,3,-1,A
1919-11-08,1919,Burnley,Manchester United,2-1,2,1,1,1,3,1,H
1919-11-08,1919,Derby County,Sheffield Wednesday,2-1,2,1,1,1,3,1,H
1919-11-08,1919,Everton,Bradford City,4-1,4,1,1,1,5,3,H
1919-11-08,1919,Manchester City,Blackburn Rovers,8-2,8,2,1,1,10,6,H
1919-11-08,1919,Middlesbrough,Newcastle United,0-1,0,1,1,1,1,-1,A
1919-11-08,1919,Preston North End,Chelsea,3-1,3,1,1,1,4,2,H
1919-11-08,1919,Sheffield United,Oldham Athletic,1-0,1,0,1,1,1,1,H
1919-11-08,1919,Sunderland,Notts County,3-1,3,1,1,1,4,2,H
1919-11-10,1919,West Bromwich Albion,Aston Villa,1-2,1,2,1,1,3,-1,A
1919-11-15,1919,Aston Villa,West Bromwich Albion,2-4,2,4,1,1,6,-2,A
1919-11-15,1919,Blackburn Rovers,Manchester City,1-4,1,4,1,1,5,-3,A
1919-11-15,1919,Bolton Wanderers,Arsenal,2-2,2,2,1,1,4,0,D
1919-11-15,1919,Bradford City,Everton,3-3,3,3,1,1,6,0,D
1919-11-15,1919,Chelsea,Preston North End,4-0,4,0,1,1,4,4,H
1919-11-15,1919,Liverpool,Bradford Park Avenue,3-3,3,3,1,1,6,0,D
1919-11-15,1919,Manchester United,Burnley,0-1,0,1,1,1,1,-1,A
1919-11-15,1919,Notts County,Sunderland,2-2,2,2,1,1,4,0,D
1919-11-15,1919,Oldham Athletic,Sheffield United,4-0,4,0,1,1,4,4,H
1919-11-15,1919,Sheffield Wednesday,Derby County,2-0,2,0,1,1,2,2,H
1919-11-22,1919,Arsenal,Notts County,3-1,3,1,1,1,4,2,H
1919-11-22,1919,Bradford City,Blackburn Rovers,3-1,3,1,1,1,4,2,H
1919-11-22,1919,Burnley,Bradford Park Avenue,2-6,2,6,1,1,8,-4,A
1919-11-22,1919,Everton,Bolton Wanderers,3-3,3,3,1,1,6,0,D
1919-11-22,1919,Manchester City,Derby County,3-1,3,1,1,1,4,2,H
1919-11-22,1919,Middlesbrough,Chelsea,0-0,0,0,1,1,0,0,D
1919-11-22,1919,Oldham Athletic,Manchester United,0-3,0,3,1,1,3,-3,A
1919-11-22,1919,Preston North End,Liverpool,2-1,2,1,1,1,3,1,H
1919-11-22,1919,Sheffield United,Aston Villa,1-2,1,2,1,1,3,-1,A
1919-11-22,1919,Sunderland,Newcastle United,2-0,2,0,1,1,2,2,H
1919-11-22,1919,West Bromwich Albion,Sheffield Wednesday,1-3,1,3,1,1,4,-2,A
1919-11-29,1919,Aston Villa,Sheffield United,4-0,4,0,1,1,4,4,H
1919-11-29,1919,Bolton Wanderers,Everton,0-2,0,2,1,1,2,-2,A
1919-11-29,1919,Bradford Park Avenue,Burnley,0-1,0,1,1,1,1,-1,A
1919-11-29,1919,Chelsea,Middlesbrough,3-1,3,1,1,1,4,2,H
1919-11-29,1919,Derby County,Manchester City,0-0,0,0,1,1,0,0,D
1919-11-29,1919,Liverpool,Preston North End,1-2,1,2,1,1,3,-1,A
1919-11-29,1919,Newcastle United,Sunderland,2-3,2,3,1,1,5,-1,A
1919-11-29,1919,Notts County,Arsenal,2-2,2,2,1,1,4,0,D
1919-11-29,1919,Sheffield Wednesday,West Bromwich Albion,0-3,0,3,1,1,3,-3,A
1919-12-03,1919,Newcastle United,Middlesbrough,0-0,0,0,1,1,0,0,D
1919-12-06,1919,Arsenal,Chelsea,1-1,1,1,1,1,2,0,D
1919-12-06,1919,Aston Villa,Manchester United,2-0,2,0,1,1,2,2,H
1919-12-06,1919,Blackburn Rovers,Derby County,2-0,2,0,1,1,2,2,H
1919-12-06,1919,Bradford City,Bolton Wanderers,0-1,0,1,1,1,1,-1,A
1919-12-06,1919,Everton,Notts County,1-2,1,2,1,1,3,-1,A
1919-12-06,1919,Manchester City,West Bromwich Albion,2-3,2,3,1,1,5,-1,A
1919-12-06,1919,Middlesbrough,Liverpool,3-2,3,2,1,1,5,1,H
1919-12-06,1919,Oldham Athletic,Burnley,1-0,1,0,1,1,1,1,H
1919-12-06,1919,Preston North End,Bradford Park Avenue,0-3,0,3,1,1,3,-3,A
1919-12-06,1919,Sheffield United,Newcastle United,2-1,2,1,1,1,3,1,H
1919-12-06,1919,Sunderland,Sheffield Wednesday,2-1,2,1,1,1,3,1,H
1919-12-11,1919,Blackburn Rovers,Bradford City,4-1,4,1,1,1,5,3,H
1919-12-13,1919,Bolton Wanderers,Bradford City,1-1,1,1,1,1,2,0,D
1919-12-13,1919,Bradford Park Avenue,Preston North End,3-3,3,3,1,1,6,0,D
1919-12-13,1919,Burnley,Oldham Athletic,2-1,2,1,1,1,3,1,H
1919-12-13,1919,Chelsea,Arsenal,3-1,3,1,1,1,4,2,H
1919-12-13,1919,Derby County,Blackburn Rovers,0-0,0,0,1,1,0,0,D
1919-12-13,1919,Liverpool,Middlesbrough,1-0,1,0,1,1,1,1,H
1919-12-13,1919,Manchester United,Aston Villa,1-2,1,2,1,1,3,-1,A
1919-12-13,1919,Newcastle United,Sheffield United,2-1,2,1,1,1,3,1,H
1919-12-13,1919,Notts County,Everton,1-1,1,1,1,1,2,0,D
1919-12-13,1919,Sheffield Wednesday,Sunderland,0-2,0,2,1,1,2,-2,A
1919-12-13,1919,West Bromwich Albion,Manchester City,2-0,2,0,1,1,2,2,H
1919-12-20,1919,Arsenal,Sheffield Wednesday,3-1,3,1,1,1,4,2,H
1919-12-20,1919,Aston Villa,Oldham Athletic,3-0,3,0,1,1,3,3,H
1919-12-20,1919,Blackburn Rovers,Bolton Wanderers,2-2,2,2,1,1,4,0,D
1919-12-20,1919,Bradford City,Notts County,3-4,3,4,1,1,7,-1,A
1919-12-20,1919,Derby County,West Bromwich Albion,0-4,0,4,1,1,4,-4,A
1919-12-20,1919,Everton,Liverpool,0-0,0,0,1,1,0,0,D
1919-12-20,1919,Manchester United,Newcastle United,2-1,2,1,1,1,3,1,H
1919-12-20,1919,Middlesbrough,Bradford Park Avenue,1-2,1,2,1,1,3,-1,A
1919-12-20,1919,Preston North End,Burnley,0-1,0,1,1,1,1,-1,A
1919-12-20,1919,Sheffield United,Chelsea,3-1,3,1,1,1,4,2,H
1919-12-20,1919,Sunderland,Manchester City,2-1,2,1,1,1,3,1,H
1919-12-25,1919,Aston Villa,Chelsea,5-2,5,2,1,1,7,3,H
1919-12-25,1919,Bolton Wanderers,Preston North End,4-1,4,1,1,1,5,3,H
1919-12-25,1919,Bradford City,Sheffield Wednesday,1-1,1,1,1,1,2,0,D
1919-12-25,1919,Burnley,Middlesbrough,5-3,5,3,1,1,8,2,H
1919-12-25,1919,Derby County,Arsenal,2-1,2,1,1,1,3,1,H
1919-12-25,1919,Liverpool,Sunderland,3-2,3,2,1,1,5,1,H
1919-12-25,1919,Manchester City,Everton,1-1,1,1,1,1,2,0,D
1919-12-25,1919,Notts County,Blackburn Rovers,5-0,5,0,1,1,5,5,H
1919-12-25,1919,Sheffield United,Bradford Park Avenue,2-2,2,2,1,1,4,0,D
1919-12-26,1919,Arsenal,Derby County,1-0,1,0,1,1,1,1,H
1919-12-26,1919,Bradford Park Avenue,Sheffield United,1-0,1,0,1,1,1,1,H
1919-12-26,1919,Chelsea,Oldham Athletic,1-0,1,0,1,1,1,1,H
1919-12-26,1919,Everton,Manchester City,2-0,2,0,1,1,2,2,H
1919-12-26,1919,Manchester United,Liverpool,0-0,0,0,1,1,0,0,D
1919-12-26,1919,Newcastle United,Burnley,0-0,0,0,1,1,0,0,D
1919-12-26,1919,Preston North End,Bolton Wanderers,1-1,1,1,1,1,2,0,D
1919-12-26,1919,Sheffield Wednesday,Bradford City,1-0,1,0,1,1,1,1,H
1919-12-26,1919,West Bromwich Albion,Sunderland,4-0,4,0,1,1,4,4,H
1919-12-27,1919,Bolton Wanderers,Blackburn Rovers,2-1,2,1,1,1,3,1,H
1919-12-27,1919,Bradford Park Avenue,Middlesbrough,1-1,1,1,1,1,2,0,D
1919-12-27,1919,Burnley,Preston North End,1-1,1,1,1,1,2,0,D
1919-12-27,1919,Chelsea,Sheffield United,1-0,1,0,1,1,1,1,H
1919-12-27,1919,Liverpool,Everton,3-1,3,1,1,1,4,2,H
1919-12-27,1919,Manchester City,Sunderland,1-0,1,0,1,1,1,1,H
1919-12-27,1919,Newcastle United,Manchester United,2-1,2,1,1,1,3,1,H
1919-12-27,1919,Notts County,Bradford City,5-2,5,2,1,1,7,3,H
1919-12-27,1919,Oldham Athletic,Aston Villa,0-3,0,3,1,1,3,-3,A
1919-12-27,1919,Sheffield Wednesday,Arsenal,1-2,1,2,1,1,3,-1,A
1919-12-27,1919,West Bromwich Albion,Derby County,3-0,3,0,1,1,3,3,H
1920-01-01,1919,Blackburn Rovers,Notts County,1-1,1,1,1,1,2,0,D
1920-01-01,1919,Bolton Wanderers,Sheffield Wednesday,2-0,2,0,1,1,2,2,H
1920-01-01,1919,Liverpool,Manchester United,0-0,0,0,1,1,0,0,D
1920-01-01,1919,Manchester City,Bradford City,1-0,1,0,1,1,1,1,H
1920-01-01,1919,Middlesbrough,Burnley,4-0,4,0,1,1,4,4,H
1920-01-01,1919,Newcastle United,Aston Villa,2-0,2,0,1,1,2,2,H
1920-01-01,1919,Oldham Athletic,Chelsea,1-0,1,0,1,1,1,1,H
1920-01-01,1919,Sheffield United,Preston North End,2-1,2,1,1,1,3,1,H
1920-01-01,1919,Sunderland,West Bromwich Albion,4-1,4,1,1,1,5,3,H
1920-01-03,1919,Arsenal,Manchester City,2-2,2,2,1,1,4,0,D
1920-01-03,1919,Aston Villa,Burnley,2-2,2,2,1,1,4,0,D
1920-01-03,1919,Blackburn Rovers,West Bromwich Albion,1-5,1,5,1,1,6,-4,A
1920-01-03,1919,Bolton Wanderers,Notts County,1-0,1,0,1,1,1,1,H
1920-01-03,1919,Bradford City,Bradford Park Avenue,0-0,0,0,1,1,0,0,D
1920-01-03,1919,Derby County,Sunderland,3-1,3,1,1,1,4,2,H
1920-01-03,1919,Everton,Sheffield Wednesday,1-1,1,1,1,1,2,0,D
1920-01-03,1919,Manchester United,Chelsea,0-2,0,2,1,1,2,-2,A
1920-01-03,1919,Middlesbrough,Preston North End,4-1,4,1,1,1,5,3,H
1920-01-03,1919,Newcastle United,Oldham Athletic,0-1,0,1,1,1,1,-1,A
1920-01-03,1919,Sheffield United,Liverpool,3-2,3,2,1,1,5,1,H
1920-01-17,1919,Burnley,Aston Villa,0-0,0,0,1,1,0,0,D
1920-01-17,1919,Chelsea,Manchester United,1-0,1,0,1,1,1,1,H
1920-01-17,1919,Liverpool,Sheffield United,2-0,2,0,1,1,2,2,H
1920-01-17,1919,Manchester City,Arsenal,4-1,4,1,1,1,5,3,H
1920-01-17,1919,Notts County,Bolton Wanderers,2-2,2,2,1,1,4,0,D
1920-01-17,1919,Oldham Athletic,Newcastle United,1-0,1,0,1,1,1,1,H
1920-01-17,1919,Preston North End,Middlesbrough,3-1,3,1,1,1,4,2,H
1920-01-17,1919,Sheffield Wednesday,Everton,1-0,1,0,1,1,1,1,H
1920-01-17,1919,Sunderland,Derby County,2-1,2,1,1,1,3,1,H
1920-01-17,1919,West Bromwich Albion,Blackburn Rovers,5-2,5,2,1,1,7,3,H
1920-01-24,1919,Arsenal,Aston Villa,0-1,0,1,1,1,1,-1,A
1920-01-24,1919,Blackburn Rovers,Bradford Park Avenue,3-3,3,3,1,1,6,0,D
1920-01-24,1919,Bolton Wanderers,Liverpool,0-3,0,3,1,1,3,-3,A
1920-01-24,1919,Bradford City,Chelsea,3-1,3,1,1,1,4,2,H
1920-01-24,1919,Derby County,Sheffield United,5-1,5,1,1,1,6,4,H
1920-01-24,1919,Everton,Newcastle United,4-0,4,0,1,1,4,4,H
1920-01-24,1919,Manchester City,Middlesbrough,1-0,1,0,1,1,1,1,H
1920-01-24,1919,Notts County,Preston North End,1-2,1,2,1,1,3,-1,A
1920-01-24,1919,Sheffield Wednesday,Burnley,3-1,3,1,1,1,4,2,H
1920-01-24,1919,Sunderland,Oldham Athletic,3-0,3,0,1,1,3,3,H
1920-01-24,1919,West Bromwich Albion,Manchester United,2-1,2,1,1,1,3,1,H
1920-02-04,1919,Chelsea,Bradford City,1-0,1,0,1,1,1,1,H
1920-02-04,1919,Liverpool,Bolton Wanderers,2-0,2,0,1,1,2,2,H
1920-02-07,1919,Arsenal,Oldham Athletic,3-2,3,2,1,1,5,1,H
1920-02-07,1919,Blackburn Rovers,Liverpool,0-2,0,2,1,1,2,-2,A
1920-02-07,1919,Bolton Wanderers,Chelsea,1-2,1,2,1,1,3,-1,A
1920-02-07,1919,Bradford City,Newcastle United,1-0,1,0,1,1,1,1,H
1920-02-07,1919,Derby County,Middlesbrough,1-2,1,2,1,1,3,-1,A
1920-02-07,1919,Everton,Aston Villa,1-1,1,1,1,1,2,0,D
1920-02-07,1919,Manchester City,Burnley,3-1,3,1,1,1,4,2,H
1920-02-07,1919,Notts County,Bradford Park Avenue,0-2,0,2,1,1,2,-2,A
1920-02-07,1919,Sheffield Wednesday,Preston North End,0-1,0,1,1,1,1,-1,A
1920-02-07,1919,Sunderland,Manchester United,3-0,3,0,1,1,3,3,H
1920-02-07,1919,West Bromwich Albion,Sheffield United,0-2,0,2,1,1,2,-2,A
1920-02-09,1919,Sheffield United,Derby County,0-0,0,0,1,1,0,0,D
1920-02-11,1919,Aston Villa,Arsenal,2-1,2,1,1,1,3,1,H
1920-02-11,1919,Bradford Park Avenue,Bradford City,0-0,0,0,1,1,0,0,D
1920-02-11,1919,Manchester United,Oldham Athletic,1-1,1,1,1,1,2,0,D
1920-02-11,1919,Newcastle United,Everton,3-0,3,0,1,1,3,3,H
1920-02-14,1919,Aston Villa,Everton,2-2,2,2,1,1,4,0,D
1920-02-14,1919,Bradford Park Avenue,Notts County,0-1,0,1,1,1,1,-1,A
1920-02-14,1919,Burnley,Manchester City,2-0,2,0,1,1,2,2,H
1920-02-14,1919,Chelsea,Bolton Wanderers,2-3,2,3,1,1,5,-1,A
1920-02-14,1919,Liverpool,Blackburn Rovers,3-0,3,0,1,1,3,3,H
1920-02-14,1919,Manchester United,Sunderland,2-0,2,0,1,1,2,2,H
1920-02-14,1919,Middlesbrough,Derby County,2-0,2,0,1,1,2,2,H
1920-02-14,1919,Newcastle United,Bradford City,0-1,0,1,1,1,1,-1,A
1920-02-14,1919,Oldham Athletic,Arsenal,3-0,3,0,1,1,3,3,H
1920-02-14,1919,Preston North End,Sheffield Wednesday,3-0,3,0,1,1,3,3,H
1920-02-14,1919,Sheffield United,West Bromwich Albion,1-0,1,0,1,1,1,1,H
1920-02-17,1919,Burnley,Sheffield Wednesday,2-0,2,0,1,1,2,2,H
1920-02-18,1919,Everton,Oldham Athletic,0-2,0,2,1,1,2,-2,A
1920-02-18,1919,Middlesbrough,Manchester City,0-2,0,2,1,1,2,-2,A
1920-02-21,1919,Arsenal,Manchester United,0-3,0,3,1,1,3,-3,A
1920-02-21,1919,Bolton Wanderers,Newcastle United,0-3,0,3,1,1,3,-3,A
1920-02-21,1919,Derby County,Burnley,0-2,0,2,1,1,2,-2,A
1920-02-21,1919,West Bromwich Albion,Middlesbrough,4-1,4,1,1,1,5,3,H
1920-02-23,1919,Bradford Park Avenue,Blackburn Rovers,5-2,5,2,1,1,7,3,H
1920-02-25,1919,Manchester United,West Bromwich Albion,1-2,1,2,1,1,3,-1,A
1920-02-26,1919,Notts County,Liverpool,1-0,1,0,1,1,1,1,H
1920-02-28,1919,Aston Villa,Bradford City,3-1,3,1,1,1,4,2,H
1920-02-28,1919,Bradford Park Avenue,Sheffield Wednesday,3-0,3,0,1,1,3,3,H
1920-02-28,1919,Burnley,Derby County,2-0,2,0,1,1,2,2,H
1920-02-28,1919,Chelsea,Blackburn Rovers,2-1,2,1,1,1,3,1,H
1920-02-28,1919,Liverpool,Notts County,3-0,3,0,1,1,3,3,H
1920-02-28,1919,Manchester United,Arsenal,0-1,0,1,1,1,1,-1,A
1920-02-28,1919,Middlesbrough,West Bromwich Albion,0-0,0,0,1,1,0,0,D
1920-02-28,1919,Newcastle United,Bolton Wanderers,0-1,0,1,1,1,1,-1,A
1920-02-28,1919,Oldham Athletic,Everton,4-1,4,1,1,1,5,3,H
1920-02-28,1919,Preston North End,Manchester City,1-1,1,1,1,1,2,0,D
1920-02-28,1919,Sheffield United,Sunderland,3-1,3,1,1,1,4,2,H
1920-03-04,1919,Preston North End,Notts County,2-0,2,0,1,1,2,2,H
1920-03-06,1919,Burnley,West Bromwich Albion,2-2,2,2,1,1,4,0,D
1920-03-06,1919,Manchester United,Everton,1-0,1,0,1,1,1,1,H
1920-03-06,1919,Middlesbrough,Sunderland,0-2,0,2,1,1,2,-2,A
1920-03-06,1919,Newcastle United,Blackburn Rovers,0-0,0,0,1,1,0,0,D
1920-03-06,1919,Preston North End,Derby County,1-1,1,1,1,1,2,0,D
1920-03-06,1919,Sheffield United,Arsenal,2-0,2,0,1,1,2,2,H
1920-03-08,1919,Oldham Athletic,Sunderland,2-1,2,1,1,1,3,1,H
1920-03-10,1919,Liverpool,Sheffield Wednesday,1-0,1,0,1,1,1,1,H
1920-03-11,1919,Blackburn Rovers,Chelsea,3-1,3,1,1,1,4,2,H
1920-03-13,1919,Arsenal,Sheffield United,3-0,3,0,1,1,3,3,H
1920-03-13,1919,Blackburn Rovers,Newcastle United,2-0,2,0,1,1,2,2,H
1920-03-13,1919,Bolton Wanderers,Aston Villa,2-1,2,1,1,1,3,1,H
1920-03-13,1919,Bradford City,Oldham Athletic,1-1,1,1,1,1,2,0,D
1920-03-13,1919,Derby County,Preston North End,2-0,2,0,1,1,2,2,H
1920-03-13,1919,Everton,Manchester United,0-0,0,0,1,1,0,0,D
1920-03-13,1919,Manchester City,Bradford Park Avenue,4-1,4,1,1,1,5,3,H
1920-03-13,1919,Notts County,Chelsea,0-1,0,1,1,1,1,-1,A
1920-03-13,1919,Sheffield Wednesday,Liverpool,2-2,2,2,1,1,4,0,D
1920-03-13,1919,Sunderland,Middlesbrough,1-1,1,1,1,1,2,0,D
1920-03-13,1919,West Bromwich Albion,Burnley,4-1,4,1,1,1,5,3,H
1920-03-17,1919,Bradford City,Aston Villa,3-1,3,1,1,1,4,2,H
1920-03-17,1919,Chelsea,Notts County,2-0,2,0,1,1,2,2,H
1920-03-17,1919,Manchester City,Preston North End,1-0,1,0,1,1,1,1,H
1920-03-17,1919,Sunderland,Sheffield United,3-2,3,2,1,1,5,1,H
1920-03-20,1919,Aston Villa,Blackburn Rovers,1-2,1,2,1,1,3,-1,A
1920-03-20,1919,Bradford Park Avenue,Derby County,1-1,1,1,1,1,2,0,D
1920-03-20,1919,Burnley,Sunderland,2-1,2,1,1,1,3,1,H
1920-03-20,1919,Chelsea,Sheffield Wednesday,1-1,1,1,1,1,2,0,D
1920-03-20,1919,Liverpool,Manchester City,1-0,1,0,1,1,1,1,H
1920-03-20,1919,Manchester United,Bradford City,0-0,0,0,1,1,0,0,D
1920-03-20,1919,Middlesbrough,Arsenal,1-0,1,0,1,1,1,1,H
1920-03-20,1919,Newcastle United,Notts County,2-1,2,1,1,1,3,1,H
1920-03-20,1919,Oldham Athletic,Bolton Wanderers,2-0,2,0,1,1,2,2,H
1920-03-20,1919,Preston North End,West Bromwich Albion,0-1,0,1,1,1,1,-1,A
1920-03-20,1919,Sheffield United,Everton,1-1,1,1,1,1,2,0,D
1920-03-22,1919,Bradford Park Avenue,Manchester City,2-1,2,1,1,1,3,1,H
1920-03-22,1919,Oldham Athletic,Bradford City,0-1,0,1,1,1,1,-1,A
1920-03-22,1919,Sheffield Wednesday,Newcastle United,0-1,0,1,1,1,1,-1,A
1920-03-27,1919,Arsenal,Middlesbrough,2-1,2,1,1,1,3,1,H
1920-03-27,1919,Bolton Wanderers,Oldham Athletic,1-0,1,0,1,1,1,1,H
1920-03-27,1919,Bradford City,Manchester United,2-1,2,1,1,1,3,1,H
1920-03-27,1919,Derby County,Bradford Park Avenue,0-0,0,0,1,1,0,0,D
1920-03-27,1919,Everton,Sheffield United,3-0,3,0,1,1,3,3,H
1920-03-27,1919,Manchester City,Liverpool,2-1,2,1,1,1,3,1,H
1920-03-27,1919,Notts County,Newcastle United,0-0,0,0,1,1,0,0,D
1920-03-27,1919,Sunderland,Burnley,3-0,3,0,1,1,3,3,H
1920-03-27,1919,West Bromwich Albion,Preston North End,4-1,4,1,1,1,5,3,H
1920-04-02,1919,Blackburn Rovers,Sunderland,3-0,3,0,1,1,3,3,H
1920-04-02,1919,Burnley,Newcastle United,1-0,1,0,1,1,1,1,H
1920-04-02,1919,Chelsea,Aston Villa,2-1,2,1,1,1,3,1,H
1920-04-02,1919,Everton,Derby County,4-0,4,0,1,1,4,4,H
1920-04-02,1919,Manchester United,Bradford Park Avenue,0-1,0,1,1,1,1,-1,A
1920-04-02,1919,Notts County,Middlesbrough,1-1,1,1,1,1,2,0,D
1920-04-02,1919,Oldham Athletic,Liverpool,1-1,1,1,1,1,2,0,D
1920-04-02,1919,Preston North End,Sheffield United,2-0,2,0,1,1,2,2,H
1920-04-03,1919,Aston Villa,Notts County,3-1,3,1,1,1,4,2,H
1920-04-03,1919,Bradford Park Avenue,West Bromwich Albion,0-4,0,4,1,1,4,-4,A
1920-04-03,1919,Burnley,Arsenal,2-1,2,1,1,1,3,1,H
1920-04-03,1919,Chelsea,Manchester City,1-0,1,0,1,1,1,1,H
1920-04-03,1919,Liverpool,Derby County,3-0,3,0,1,1,3,3,H
1920-04-03,1919,Manchester United,Bolton Wanderers,1-1,1,1,1,1,2,0,D
1920-04-03,1919,Middlesbrough,Everton,1-1,1,1,1,1,2,0,D
1920-04-03,1919,Newcastle United,Sheffield Wednesday,1-1,1,1,1,1,2,0,D
1920-04-03,1919,Oldham Athletic,Blackburn Rovers,0-0,0,0,1,1,0,0,D
1920-04-03,1919,Preston North End,Sunderland,5-2,5,2,1,1,7,3,H
1920-04-03,1919,Sheffield United,Bradford City,0-0,0,0,1,1,0,0,D
1920-04-05,1919,Arsenal,West Bromwich Albion,1-0,1,0,1,1,1,1,H
1920-04-05,1919,Aston Villa,Newcastle United,4-0,4,0,1,1,4,4,H
1920-04-05,1919,Bradford City,Manchester City,1-0,1,0,1,1,1,1,H
1920-04-05,1919,Derby County,Everton,2-1,2,1,1,1,3,1,H
1920-04-05,1919,Liverpool,Oldham Athletic,2-2,2,2,1,1,4,0,D
1920-04-05,1919,Middlesbrough,Notts County,5-2,5,2,1,1,7,3,H
1920-04-05,1919,Sheffield Wednesday,Bolton Wanderers,0-2,0,2,1,1,2,-2,A
1920-04-05,1919,Sunderland,Blackburn Rovers,2-0,2,0,1,1,2,2,H
1920-04-06,1919,Bradford Park Avenue,Manchester United,1-4,1,4,1,1,5,-3,A
1920-04-06,1919,Sheffield Wednesday,Chelsea,0-2,0,2,1,1,2,-2,A
1920-04-06,1919,West Bromwich Albion,Arsenal,1-0,1,0,1,1,1,1,H
1920-04-07,1919,Aston Villa,Bolton Wanderers,3-6,3,6,1,1,9,-3,A
1920-04-10,1919,Arsenal,Burnley,2-0,2,0,1,1,2,2,H
1920-04-10,1919,Blackburn Rovers,Oldham Athletic,0-1,0,1,1,1,1,-1,A
1920-04-10,1919,Bolton Wanderers,Manchester United,3-5,3,5,1,1,8,-2,A
1920-04-10,1919,Bradford City,Sheffield United,1-2,1,2,1,1,3,-1,A
1920-04-10,1919,Derby County,Liverpool,3-0,3,0,1,1,3,3,H
1920-04-10,1919,Everton,Middlesbrough,5-2,5,2,1,1,7,3,H
1920-04-10,1919,Manchester City,Chelsea,1-0,1,0,1,1,1,1,H
1920-04-10,1919,Notts County,Aston Villa,2-1,2,1,1,1,3,1,H
1920-04-10,1919,Sunderland,Preston North End,1-0,1,0,1,1,1,1,H
1920-04-10,1919,West Bromwich Albion,Bradford Park Avenue,3-1,3,1,1,1,4,2,H
1920-04-15,1919,Blackburn Rovers,Aston Villa,5-1,5,1,1,1,6,4,H
1920-04-17,1919,Aston Villa,Sheffield Wednesday,3-1,3,1,1,1,4,2,H
1920-04-17,1919,Bradford Park Avenue,Sunderland,2-2,2,2,1,1,4,0,D
1920-04-17,1919,Burnley,Everton,5-0,5,0,1,1,5,5,H
1920-04-17,1919,Chelsea,Derby County,0-0,0,0,1,1,0,0,D
1920-04-17,1919,Liverpool,West Bromwich Albion,0-0,0,0,1,1,0,0,D
1920-04-17,1919,Manchester United,Blackburn Rovers,1-1,1,1,1,1,2,0,D
1920-04-17,1919,Middlesbrough,Bradford City,4-0,4,0,1,1,4,4,H
1920-04-17,1919,Newcastle United,Manchester City,3-0,3,0,1,1,3,3,H
1920-04-17,1919,Oldham Athletic,Notts County,0-0,0,0,1,1,0,0,D
1920-04-17,1919,Preston North End,Arsenal,1-1,1,1,1,1,2,0,D
1920-04-17,1919,Sheffield United,Bolton Wanderers,3-2,3,2,1,1,5,1,H
1920-04-19,1919,Sheffield Wednesday,Bradford Park Avenue,0-1,0,1,1,1,1,-1,A
1920-04-24,1919,Arsenal,Preston North End,0-0,0,0,1,1,0,0,D
1920-04-24,1919,Blackburn Rovers,Manchester United,5-0,5,0,1,1,5,5,H
1920-04-24,1919,Bolton Wanderers,Sheffield United,1-0,1,0,1,1,1,1,H
1920-04-24,1919,Bradford City,Middlesbrough,0-1,0,1,1,1,1,-1,A
1920-04-24,1919,Derby County,Chelsea,5-0,5,0,1,1,5,5,H
1920-04-24,1919,Everton,Burnley,2-2,2,2,1,1,4,0,D
1920-04-24,1919,Manchester City,Newcastle United,0-0,0,0,1,1,0,0,D
1920-04-24,1919,Notts County,Oldham Athletic,2-1,2,1,1,1,3,1,H
1920-04-24,1919,Sunderland,Bradford Park Avenue,2-0,2,0,1,1,2,2,H
1920-04-24,1919,West Bromwich Albion,Liverpool,1-1,1,1,1,1,2,0,D
1920-04-26,1919,Aston Villa,Manchester City,0-1,0,1,1,1,1,-1,A
1920-04-26,1919,Chelsea,West Bromwich Albion,2-0,2,0,1,1,2,2,H
1920-04-26,1919,Manchester United,Notts County,0-0,0,0,1,1,0,0,D
1920-04-26,1919,Oldham Athletic,Sheffield Wednesday,1-0,1,0,1,1,1,1,H
1920-04-26,1919,Preston North End,Everton,1-1,1,1,1,1,2,0,D
1920-04-28,1919,Bradford Park Avenue,Arsenal,0-0,0,0,1,1,0,0,D
1920-04-29,1919,Sheffield Wednesday,Aston Villa,0-1,0,1,1,1,1,-1,A
1920-05-01,1919,Arsenal,Bradford Park Avenue,3-0,3,0,1,1,3,3,H
1920-05-01,1919,Blackburn Rovers,Sheffield United,4-0,4,0,1,1,4,4,H
1920-05-01,1919,Bolton Wanderers,Middlesbrough,2-1,2,1,1,1,3,1,H
1920-05-01,1919,Bradford City,Burnley,2-1,2,1,1,1,3,1,H
1920-05-01,1919,Derby County,Newcastle United,1-0,1,0,1,1,1,1,H
1920-05-01,1919,Everton,Preston North End,0-1,0,1,1,1,1,-1,A
1920-05-01,1919,Manchester City,Aston Villa,2-2,2,2,1,1,4,0,D
1920-05-01,1919,Notts County,Manchester United,0-2,0,2,1,1,2,-2,A
1920-05-01,1919,Sheffield Wednesday,Oldham Athletic,1-0,1,0,1,1,1,1,H
1920-05-01,1919,Sunderland,Liverpool,0-1,0,1,1,1,1,-1,A
1920-05-01,1919,West Bromwich Albion,Chelsea,4-0,4,0,1,1,4,4,H
1920-08-28,1920,Aston Villa,Arsenal,5-0,5,0,1,1,5,5,H
1920-08-28,1920,Bradford Park Avenue,Everton,3-3,3,3,1,1,6,0,D
1920-08-28,1920,Burnley,Bradford City,1-4,1,4,1,1,5,-3,A
1920-08-28,1920,Derby County,Chelsea,0-0,0,0,1,1,0,0,D
1920-08-28,1920,Liverpool,Manchester City,4-2,4,2,1,1,6,2,H
1920-08-28,1920,Manchester United,Bolton Wanderers,2-3,2,3,1,1,5,-1,A
1920-08-28,1920,Middlesbrough,Oldham Athletic,1-2,1,2,1,1,3,-1,A
1920-08-28,1920,Newcastle United,West Bromwich Albion,1-1,1,1,1,1,2,0,D
1920-08-28,1920,Preston North End,Huddersfield Town,0-1,0,1,1,1,1,-1,A
1920-08-28,1920,Sheffield United,Sunderland,1-1,1,1,1,1,2,0,D
1920-08-28,1920,Tottenham Hotspur,Blackburn Rovers,1-2,1,2,1,1,3,-1,A
1920-08-30,1920,Arsenal,Manchester United,2-0,2,0,1,1,2,2,H
1920-08-30,1920,Bradford City,Sheffield United,4-0,4,0,1,1,4,4,H
1920-08-30,1920,Derby County,Tottenham Hotspur,2-2,2,2,1,1,4,0,D
1920-08-30,1920,Huddersfield Town,Burnley,1-0,1,0,1,1,1,1,H
1920-08-30,1920,Manchester City,Aston Villa,3-1,3,1,1,1,4,2,H
1920-08-30,1920,Middlesbrough,Preston North End,0-0,0,0,1,1,0,0,D
1920-08-30,1920,Oldham Athletic,Blackburn Rovers,1-0,1,0,1,1,1,1,H
1920-09-01,1920,Chelsea,Bolton Wanderers,1-0,1,0,1,1,1,1,H
1920-09-01,1920,Everton,Newcastle United,3-1,3,1,1,1,4,2,H
1920-09-01,1920,Sunderland,Bradford Park Avenue,5-1,5,1,1,1,6,4,H
1920-09-01,1920,West Bromwich Albion,Liverpool,1-1,1,1,1,1,2,0,D
1920-09-04,1920,Arsenal,Aston Villa,0-1,0,1,1,1,1,-1,A
1920-09-04,1920,Blackburn Rovers,Tottenham Hotspur,1-1,1,1,1,1,2,0,D
1920-09-04,1920,Bolton Wanderers,Manchester United,1-1,1,1,1,1,2,0,D
1920-09-04,1920,Bradford City,Burnley,2-0,2,0,1,1,2,2,H
1920-09-04,1920,Chelsea,Derby County,1-1,1,1,1,1,2,0,D
1920-09-04,1920,Everton,Bradford Park Avenue,1-1,1,1,1,1,2,0,D
1920-09-04,1920,Huddersfield Town,Preston North End,1-0,1,0,1,1,1,1,H
1920-09-04,1920,Manchester City,Liverpool,3-2,3,2,1,1,5,1,H
1920-09-04,1920,Oldham Athletic,Middlesbrough,3-3,3,3,1,1,6,0,D
1920-09-04,1920,Sunderland,Sheffield United,3-1,3,1,1,1,4,2,H
1920-09-04,1920,West Bromwich Albion,Newcastle United,0-0,0,0,1,1,0,0,D
1920-09-06,1920,Aston Villa,Manchester City,3-1,3,1,1,1,4,2,H
1920-09-06,1920,Bolton Wanderers,Chelsea,3-1,3,1,1,1,4,2,H
1920-09-06,1920,Burnley,Huddersfield Town,3-0,3,0,1,1,3,3,H
1920-09-06,1920,Liverpool,West Bromwich Albion,0-0,0,0,1,1,0,0,D
1920-09-06,1920,Manchester United,Arsenal,1-1,1,1,1,1,2,0,D
1920-09-06,1920,Preston North End,Middlesbrough,2-0,2,0,1,1,2,2,H
1920-09-06,1920,Sheffield United,Bradford City,4-1,4,1,1,1,5,3,H
1920-09-06,1920,Tottenham Hotspur,Derby County,2-0,2,0,1,1,2,2,H
1920-09-08,1920,Bradford Park Avenue,Sunderland,1-1,1,1,1,1,2,0,D
1920-09-08,1920,Newcastle United,Everton,2-0,2,0,1,1,2,2,H
1920-09-11,1920,Arsenal,Manchester City,2-1,2,1,1,1,3,1,H
1920-09-11,1920,Aston Villa,Tottenham Hotspur,4-2,4,2,1,1,6,2,H
1920-09-11,1920,Blackburn Rovers,Sunderland,2-0,2,0,1,1,2,2,H
1920-09-11,1920,Bolton Wanderers,West Bromwich Albion,3-0,3,0,1,1,3,3,H
1920-09-11,1920,Bradford Park Avenue,Sheffield United,2-0,2,0,1,1,2,2,H
1920-09-11,1920,Burnley,Middlesbrough,2-1,2,1,1,1,3,1,H
1920-09-11,1920,Derby County,Everton,2-4,2,4,1,1,6,-2,A
1920-09-11,1920,Huddersfield Town,Bradford City,1-0,1,0,1,1,1,1,H
1920-09-11,1920,Liverpool,Oldham Athletic,5-2,5,2,1,1,7,3,H
1920-09-11,1920,Manchester United,Chelsea,3-1,3,1,1,1,4,2,H
1920-09-11,1920,Newcastle United,Preston North End,4-2,4,2,1,1,6,2,H
1920-09-15,1920,Bolton Wanderers,Aston Villa,5-0,5,0,1,1,5,5,H
1920-09-18,1920,Bradford City,Huddersfield Town,0-2,0,2,1,1,2,-2,A
1920-09-18,1920,Chelsea,Manchester United,1-2,1,2,1,1,3,-1,A
1920-09-18,1920,Everton,Derby County,3-1,3,1,1,1,4,2,H
1920-09-18,1920,Manchester City,Arsenal,3-1,3,1,1,1,4,2,H
1920-09-18,1920,Middlesbrough,Burnley,0-0,0,0,1,1,0,0,D
1920-09-18,1920,Oldham Athletic,Liverpool,0-0,0,0,1,1,0,0,D
1920-09-18,1920,Preston North End,Newcastle United,3-2,3,2,1,1,5,1,H
1920-09-18,1920,Sheffield United,Bradford Park Avenue,2-0,2,0,1,1,2,2,H
1920-09-18,1920,Sunderland,Blackburn Rovers,2-0,2,0,1,1,2,2,H
1920-09-18,1920,Tottenham Hotspur,Aston Villa,1-2,1,2,1,1,3,-1,A
1920-09-18,1920,West Bromwich Albion,Bolton Wanderers,2-1,2,1,1,1,3,1,H
1920-09-20,1920,Blackburn Rovers,Oldham Athletic,5-1,5,1,1,1,6,4,H
1920-09-22,1920,Everton,Sheffield United,3-0,3,0,1,1,3,3,H
1920-09-25,1920,Arsenal,Middlesbrough,2-2,2,2,1,1,4,0,D
1920-09-25,1920,Aston Villa,Oldham Athletic,3-0,3,0,1,1,3,3,H
1920-09-25,1920,Blackburn Rovers,Everton,0-0,0,0,1,1,0,0,D
1920-09-25,1920,Bolton Wanderers,Manchester City,3-0,3,0,1,1,3,3,H
1920-09-25,1920,Bradford Park Avenue,Bradford City,1-2,1,2,1,1,3,-1,A
1920-09-25,1920,Burnley,Chelsea,4-0,4,0,1,1,4,4,H
1920-09-25,1920,Derby County,West Bromwich Albion,1-1,1,1,1,1,2,0,D
1920-09-25,1920,Huddersfield Town,Sunderland,0-0,0,0,1,1,0,0,D
1920-09-25,1920,Liverpool,Preston North End,6-0,6,0,1,1,6,6,H
1920-09-25,1920,Manchester United,Tottenham Hotspur,0-1,0,1,1,1,1,-1,A
1920-09-25,1920,Newcastle United,Sheffield United,3-0,3,0,1,1,3,3,H
1920-10-02,1920,Bradford City,Bradford Park Avenue,2-1,2,1,1,1,3,1,H
1920-10-02,1920,Chelsea,Burnley,1-1,1,1,1,1,2,0,D
1920-10-02,1920,Everton,Blackburn Rovers,2-1,2,1,1,1,3,1,H
1920-10-02,1920,Manchester City,Bolton Wanderers,3-1,3,1,1,1,4,2,H
1920-10-02,1920,Middlesbrough,Arsenal,2-1,2,1,1,1,3,1,H
1920-10-02,1920,Oldham Athletic,Aston Villa,1-1,1,1,1,1,2,0,D
1920-10-02,1920,Preston North End,Liverpool,2-3,2,3,1,1,5,-1,A
1920-10-02,1920,Sheffield United,Newcastle United,0-3,0,3,1,1,3,-3,A
1920-10-02,1920,Sunderland,Huddersfield Town,2-1,2,1,1,1,3,1,H
1920-10-02,1920,Tottenham Hotspur,Manchester United,4-1,4,1,1,1,5,3,H
1920-10-02,1920,West Bromwich Albion,Derby County,3-0,3,0,1,1,3,3,H
1920-10-04,1920,Sheffield United,Everton,2-0,2,0,1,1,2,2,H
1920-10-09,1920,Arsenal,Bolton Wanderers,0-0,0,0,1,1,0,0,D
1920-10-09,1920,Aston Villa,Preston North End,1-0,1,0,1,1,1,1,H
1920-10-09,1920,Blackburn Rovers,West Bromwich Albion,5-1,5,1,1,1,6,4,H
1920-10-09,1920,Bradford Park Avenue,Burnley,1-3,1,3,1,1,4,-2,A
1920-10-09,1920,Derby County,Manchester City,3-0,3,0,1,1,3,3,H
1920-10-09,1920,Huddersfield Town,Everton,0-1,0,1,1,1,1,-1,A
1920-10-09,1920,Liverpool,Sheffield United,2-2,2,2,1,1,4,0,D
1920-10-09,1920,Manchester United,Oldham Athletic,4-1,4,1,1,1,5,3,H
1920-10-09,1920,Middlesbrough,Bradford City,2-1,2,1,1,1,3,1,H
1920-10-09,1920,Newcastle United,Sunderland,6-1,6,1,1,1,7,5,H
1920-10-09,1920,Tottenham Hotspur,Chelsea,5-0,5,0,1,1,5,5,H
1920-10-16,1920,Bolton Wanderers,Arsenal,1-1,1,1,1,1,2,0,D
1920-10-16,1920,Bradford City,Middlesbrough,0-1,0,1,1,1,1,-1,A
1920-10-16,1920,Burnley,Bradford Park Avenue,1-0,1,0,1,1,1,1,H
1920-10-16,1920,Chelsea,Tottenham Hotspur,0-4,0,4,1,1,4,-4,A
1920-10-16,1920,Everton,Huddersfield Town,0-0,0,0,1,1,0,0,D
1920-10-16,1920,Manchester City,Derby County,0-0,0,0,1,1,0,0,D
1920-10-16,1920,Oldham Athletic,Manchester United,2-2,2,2,1,1,4,0,D
1920-10-16,1920,Preston North End,Aston Villa,6-1,6,1,1,1,7,5,H
1920-10-16,1920,Sheffield United,Liverpool,0-1,0,1,1,1,1,-1,A
1920-10-16,1920,Sunderland,Newcastle United,0-2,0,2,1,1,2,-2,A
1920-10-16,1920,West Bromwich Albion,Blackburn Rovers,1-1,1,1,1,1,2,0,D
1920-10-23,1920,Aston Villa,Sheffield United,4-0,4,0,1,1,4,4,H
1920-10-23,1920,Blackburn Rovers,Manchester City,0-2,0,2,1,1,2,-2,A
1920-10-23,1920,Bradford City,Sunderland,2-2,2,2,1,1,4,0,D
1920-10-23,1920,Chelsea,Oldham Athletic,1-1,1,1,1,1,2,0,D
1920-10-23,1920,Derby County,Arsenal,1-1,1,1,1,1,2,0,D
1920-10-23,1920,Huddersfield Town,West Bromwich Albion,5-1,5,1,1,1,6,4,H
1920-10-23,1920,Liverpool,Everton,1-0,1,0,1,1,1,1,H
1920-10-23,1920,Manchester United,Preston North End,1-0,1,0,1,1,1,1,H
1920-10-23,1920,Middlesbrough,Bolton Wanderers,4-1,4,1,1,1,5,3,H
1920-10-23,1920,Newcastle United,Bradford Park Avenue,2-1,2,1,1,1,3,1,H
1920-10-23,1920,Tottenham Hotspur,Burnley,1-2,1,2,1,1,3,-1,A
1920-10-30,1920,Arsenal,Derby County,2-0,2,0,1,1,2,2,H
1920-10-30,1920,Bolton Wanderers,Middlesbrough,6-2,6,2,1,1,8,4,H
1920-10-30,1920,Bradford Park Avenue,Newcastle United,0-2,0,2,1,1,2,-2,A
1920-10-30,1920,Burnley,Tottenham Hotspur,2-0,2,0,1,1,2,2,H
1920-10-30,1920,Everton,Liverpool,0-3,0,3,1,1,3,-3,A
1920-10-30,1920,Manchester City,Blackburn Rovers,0-0,0,0,1,1,0,0,D
1920-10-30,1920,Oldham Athletic,Chelsea,1-2,1,2,1,1,3,-1,A
1920-10-30,1920,Preston North End,Manchester United,0-0,0,0,1,1,0,0,D
1920-10-30,1920,Sheffield United,Aston Villa,0-0,0,0,1,1,0,0,D
1920-10-30,1920,Sunderland,Bradford City,0-0,0,0,1,1,0,0,D
1920-10-30,1920,West Bromwich Albion,Huddersfield Town,3-0,3,0,1,1,3,3,H
1920-11-06,1920,Aston Villa,West Bromwich Albion,0-0,0,0,1,1,0,0,D
1920-11-06,1920,Blackburn Rovers,Arsenal,2-2,2,2,1,1,4,0,D
1920-11-06,1920,Bradford City,Everton,2-2,2,2,1,1,4,0,D
1920-11-06,1920,Chelsea,Preston North End,1-1,1,1,1,1,2,0,D
1920-11-06,1920,Derby County,Bolton Wanderers,0-0,0,0,1,1,0,0,D
1920-11-06,1920,Huddersfield Town,Manchester City,0-1,0,1,1,1,1,-1,A
1920-11-06,1920,Liverpool,Bradford Park Avenue,0-1,0,1,1,1,1,-1,A
1920-11-06,1920,Manchester United,Sheffield United,2-1,2,1,1,1,3,1,H
1920-11-06,1920,Middlesbrough,Sunderland,2-0,2,0,1,1,2,2,H
1920-11-06,1920,Newcastle United,Burnley,1-2,1,2,1,1,3,-1,A
1920-11-06,1920,Tottenham Hotspur,Oldham Athletic,5-1,5,1,1,1,6,4,H
1920-11-13,1920,Arsenal,Blackburn Rovers,2-0,2,0,1,1,2,2,H
1920-11-13,1920,Bolton Wanderers,Derby County,1-0,1,0,1,1,1,1,H
1920-11-13,1920,Bradford Park Avenue,Liverpool,1-3,1,3,1,1,4,-2,A
1920-11-13,1920,Burnley,Newcastle United,3-1,3,1,1,1,4,2,H
1920-11-13,1920,Everton,Bradford City,2-2,2,2,1,1,4,0,D
1920-11-13,1920,Manchester City,Huddersfield Town,3-2,3,2,1,1,5,1,H
1920-11-13,1920,Oldham Athletic,Tottenham Hotspur,2-5,2,5,1,1,7,-3,A
1920-11-13,1920,Preston North End,Chelsea,0-1,0,1,1,1,1,-1,A
1920-11-13,1920,Sheffield United,Manchester United,0-0,0,0,1,1,0,0,D
1920-11-13,1920,Sunderland,Middlesbrough,1-2,1,2,1,1,3,-1,A
1920-11-13,1920,West Bromwich Albion,Aston Villa,2-1,2,1,1,1,3,1,H
1920-11-20,1920,Aston Villa,Bradford Park Avenue,4-1,4,1,1,1,5,3,H
1920-11-20,1920,Blackburn Rovers,Bolton Wanderers,2-2,2,2,1,1,4,0,D
1920-11-20,1920,Chelsea,Sheffield United,2-1,2,1,1,1,3,1,H
1920-11-20,1920,Everton,Sunderland,1-1,1,1,1,1,2,0,D
1920-11-20,1920,Huddersfield Town,Arsenal,0-4,0,4,1,1,4,-4,A
1920-11-20,1920,Manchester United,Manchester City,1-1,1,1,1,1,2,0,D
1920-11-20,1920,Middlesbrough,Derby County,1-0,1,0,1,1,1,1,H
1920-11-20,1920,Newcastle United,Liverpool,2-0,2,0,1,1,2,2,H
1920-11-20,1920,Oldham Athletic,Burnley,2-2,2,2,1,1,4,0,D
1920-11-20,1920,Tottenham Hotspur,Preston North End,1-2,1,2,1,1,3,-1,A
1920-11-27,1920,Arsenal,Huddersfield Town,2-0,2,0,1,1,2,2,H
1920-11-27,1920,Bolton Wanderers,Blackburn Rovers,2-1,2,1,1,1,3,1,H
1920-11-27,1920,Bradford Park Avenue,Aston Villa,4-0,4,0,1,1,4,4,H
1920-11-27,1920,Burnley,Oldham Athletic,7-1,7,1,1,1,8,6,H
1920-11-27,1920,Derby County,Middlesbrough,0-1,0,1,1,1,1,-1,A
1920-11-27,1920,Liverpool,Newcastle United,0-1,0,1,1,1,1,-1,A
1920-11-27,1920,Manchester City,Manchester United,3-0,3,0,1,1,3,3,H
1920-11-27,1920,Preston North End,Tottenham Hotspur,4-1,4,1,1,1,5,3,H
1920-11-27,1920,Sheffield United,Chelsea,0-1,0,1,1,1,1,-1,A
1920-11-27,1920,Sunderland,Everton,0-2,0,2,1,1,2,-2,A
1920-11-27,1920,West Bromwich Albion,Bradford City,2-0,2,0,1,1,2,2,H
1920-12-04,1920,Blackburn Rovers,Derby County,2-0,2,0,1,1,2,2,H
1920-12-04,1920,Bradford City,Manchester City,1-2,1,2,1,1,3,-1,A
1920-12-04,1920,Chelsea,Arsenal,1-2,1,2,1,1,3,-1,A
1920-12-04,1920,Huddersfield Town,Bolton Wanderers,0-0,0,0,1,1,0,0,D
1920-12-04,1920,Liverpool,Burnley,0-0,0,0,1,1,0,0,D
1920-12-04,1920,Manchester United,Bradford Park Avenue,5-1,5,1,1,1,6,4,H
1920-12-04,1920,Middlesbrough,Everton,3-1,3,1,1,1,4,2,H
1920-12-04,1920,Newcastle United,Aston Villa,2-1,2,1,1,1,3,1,H
1920-12-04,1920,Oldham Athletic,Preston North End,0-2,0,2,1,1,2,-2,A
1920-12-04,1920,Tottenham Hotspur,Sheffield United,4-1,4,1,1,1,5,3,H
1920-12-04,1920,West Bromwich Albion,Sunderland,4-1,4,1,1,1,5,3,H
1920-12-11,1920,Arsenal,Chelsea,1-1,1,1,1,1,2,0,D
1920-12-11,1920,Aston Villa,Newcastle United,0-0,0,0,1,1,0,0,D
1920-12-11,1920,Bolton Wanderers,Huddersfield Town,3-1,3,1,1,1,4,2,H
1920-12-11,1920,Bradford Park Avenue,Manchester United,2-4,2,4,1,1,6,-2,A
1920-12-11,1920,Burnley,Liverpool,1-0,1,0,1,1,1,1,H
1920-12-11,1920,Derby County,Blackburn Rovers,0-1,0,1,1,1,1,-1,A
1920-12-11,1920,Everton,Middlesbrough,2-1,2,1,1,1,3,1,H
1920-12-11,1920,Manchester City,Bradford City,1-0,1,0,1,1,1,1,H
1920-12-11,1920,Preston North End,Oldham Athletic,4-0,4,0,1,1,4,4,H
1920-12-11,1920,Sheffield United,Tottenham Hotspur,1-1,1,1,1,1,2,0,D
1920-12-11,1920,Sunderland,West Bromwich Albion,3-0,3,0,1,1,3,3,H
1920-12-18,1920,Blackburn Rovers,Middlesbrough,3-2,3,2,1,1,5,1,H
1920-12-18,1920,Bradford City,Arsenal,3-1,3,1,1,1,4,2,H
1920-12-18,1920,Burnley,Preston North End,2-0,2,0,1,1,2,2,H
1920-12-18,1920,Chelsea,Bradford Park Avenue,4-1,4,1,1,1,5,3,H
1920-12-18,1920,Huddersfield Town,Derby County,2-0,2,0,1,1,2,2,H
1920-12-18,1920,Liverpool,Aston Villa,4-1,4,1,1,1,5,3,H
1920-12-18,1920,Manchester United,Newcastle United,2-0,2,0,1,1,2,2,H
1920-12-18,1920,Oldham Athletic,Sheffield United,0-0,0,0,1,1,0,0,D
1920-12-18,1920,Sunderland,Manchester City,1-0,1,0,1,1,1,1,H
1920-12-18,1920,Tottenham Hotspur,Bolton Wanderers,5-2,5,2,1,1,7,3,H
1920-12-18,1920,West Bromwich Albion,Everton,1-2,1,2,1,1,3,-1,A
1920-12-25,1920,Aston Villa,Manchester United,3-4,3,4,1,1,7,-1,A
1920-12-25,1920,Blackburn Rovers,Preston North End,2-2,2,2,1,1,4,0,D
1920-12-25,1920,Bolton Wanderers,Sunderland,6-2,6,2,1,1,8,4,H
1920-12-25,1920,Bradford City,Derby County,2-2,2,2,1,1,4,0,D
1920-12-25,1920,Burnley,Sheffield United,6-0,6,0,1,1,6,6,H
1920-12-25,1920,Chelsea,Liverpool,1-1,1,1,1,1,2,0,D
1920-12-25,1920,Everton,Arsenal,2-4,2,4,1,1,6,-2,A
1920-12-25,1920,Manchester City,West Bromwich Albion,4-0,4,0,1,1,4,4,H
1920-12-25,1920,Middlesbrough,Huddersfield Town,2-0,2,0,1,1,2,2,H
1920-12-25,1920,Newcastle United,Tottenham Hotspur,1-1,1,1,1,1,2,0,D
1920-12-25,1920,Oldham Athletic,Bradford Park Avenue,1-0,1,0,1,1,1,1,H
1920-12-27,1920,Arsenal,Everton,1-1,1,1,1,1,2,0,D
1920-12-27,1920,Bradford Park Avenue,Oldham Athletic,2-1,2,1,1,1,3,1,H
1920-12-27,1920,Derby County,Bradford City,1-1,1,1,1,1,2,0,D
1920-12-27,1920,Huddersfield Town,Middlesbrough,0-1,0,1,1,1,1,-1,A
1920-12-27,1920,Liverpool,Chelsea,2-1,2,1,1,1,3,1,H
1920-12-27,1920,Manchester United,Aston Villa,1-3,1,3,1,1,4,-2,A
1920-12-27,1920,Preston North End,Blackburn Rovers,4-2,4,2,1,1,6,2,H
1920-12-27,1920,Sheffield United,Burnley,1-1,1,1,1,1,2,0,D
1920-12-27,1920,Sunderland,Bolton Wanderers,0-0,0,0,1,1,0,0,D
1920-12-27,1920,Tottenham Hotspur,Newcastle United,2-0,2,0,1,1,2,2,H
1920-12-27,1920,West Bromwich Albion,Manchester City,2-2,2,2,1,1,4,0,D
1920-12-29,1920,Sheffield United,Huddersfield Town,1-1,1,1,1,1,2,0,D
1921-01-01,1920,Arsenal,Bradford City,1-2,1,2,1,1,3,-1,A
1921-01-01,1920,Aston Villa,Liverpool,0-2,0,2,1,1,2,-2,A
1921-01-01,1920,Bolton Wanderers,Tottenham Hotspur,1-0,1,0,1,1,1,1,H
1921-01-01,1920,Bradford Park Avenue,Chelsea,0-2,0,2,1,1,2,-2,A
1921-01-01,1920,Derby County,Huddersfield Town,2-1,2,1,1,1,3,1,H
1921-01-01,1920,Everton,West Bromwich Albion,2-2,2,2,1,1,4,0,D
1921-01-01,1920,Manchester City,Sunderland,3-1,3,1,1,1,4,2,H
1921-01-01,1920,Middlesbrough,Blackburn Rovers,1-1,1,1,1,1,2,0,D
1921-01-01,1920,Newcastle United,Manchester United,6-3,6,3,1,1,9,3,H
1921-01-01,1920,Preston North End,Burnley,0-3,0,3,1,1,3,-3,A
1921-01-01,1920,Sheffield United,Oldham Athletic,3-0,3,0,1,1,3,3,H
1921-01-15,1920,Aston Villa,Everton,1-3,1,3,1,1,4,-2,A
1921-01-15,1920,Bradford Park Avenue,Huddersfield Town,1-1,1,1,1,1,2,0,D
1921-01-15,1920,Burnley,Blackburn Rovers,4-1,4,1,1,1,5,3,H
1921-01-15,1920,Chelsea,Manchester City,2-1,2,1,1,1,3,1,H
1921-01-15,1920,Liverpool,Sunderland,0-0,0,0,1,1,0,0,D
1921-01-15,1920,Manchester United,West Bromwich Albion,1-4,1,4,1,1,5,-3,A
1921-01-15,1920,Newcastle United,Bradford City,4-0,4,0,1,1,4,4,H
1921-01-15,1920,Oldham Athletic,Bolton Wanderers,0-0,0,0,1,1,0,0,D
1921-01-15,1920,Preston North End,Derby County,2-1,2,1,1,1,3,1,H
1921-01-15,1920,Sheffield United,Middlesbrough,1-1,1,1,1,1,2,0,D
1921-01-15,1920,Tottenham Hotspur,Arsenal,2-1,2,1,1,1,3,1,H
1921-01-22,1920,Arsenal,Tottenham Hotspur,3-2,3,2,1,1,5,1,H
1921-01-22,1920,Blackburn Rovers,Burnley,1-3,1,3,1,1,4,-2,A
1921-01-22,1920,Bolton Wanderers,Oldham Athletic,1-1,1,1,1,1,2,0,D
1921-01-22,1920,Bradford City,Newcastle United,1-1,1,1,1,1,2,0,D
1921-01-22,1920,Derby County,Preston North End,1-1,1,1,1,1,2,0,D
1921-01-22,1920,Everton,Aston Villa,1-1,1,1,1,1,2,0,D
1921-01-22,1920,Huddersfield Town,Bradford Park Avenue,0-0,0,0,1,1,0,0,D
1921-01-22,1920,Manchester City,Chelsea,1-0,1,0,1,1,1,1,H
1921-01-22,1920,Middlesbrough,Sheffield United,2-2,2,2,1,1,4,0,D
1921-01-22,1920,Sunderland,Liverpool,2-1,2,1,1,1,3,1,H
1921-01-22,1920,West Bromwich Albion,Manchester United,0-2,0,2,1,1,2,-2,A
1921-01-29,1920,Arsenal,Sunderland,1-2,1,2,1,1,3,-1,A
1921-01-29,1920,Middlesbrough,West Bromwich Albion,0-1,0,1,1,1,1,-1,A
1921-02-03,1920,Tottenham Hotspur,Bradford Park Avenue,2-0,2,0,1,1,2,2,H
1921-02-05,1920,Bolton Wanderers,Bradford City,1-1,1,1,1,1,2,0,D
1921-02-05,1920,Bradford Park Avenue,Tottenham Hotspur,1-1,1,1,1,1,2,0,D
1921-02-05,1920,Burnley,Aston Villa,7-1,7,1,1,1,8,6,H
1921-02-05,1920,Chelsea,Newcastle United,2-0,2,0,1,1,2,2,H
1921-02-05,1920,Derby County,Oldham Athletic,3-3,3,3,1,1,6,0,D
1921-02-05,1920,Everton,Manchester City,3-0,3,0,1,1,3,3,H
1921-02-05,1920,Huddersfield Town,Blackburn Rovers,0-0,0,0,1,1,0,0,D
1921-02-05,1920,Manchester United,Liverpool,1-1,1,1,1,1,2,0,D
1921-02-05,1920,Sheffield United,Preston North End,1-0,1,0,1,1,1,1,H
1921-02-05,1920,Sunderland,Arsenal,5-1,5,1,1,1,6,4,H
1921-02-05,1920,West Bromwich Albion,Middlesbrough,0-1,0,1,1,1,1,-1,A
1921-02-07,1920,Preston North End,Sheffield United,2-0,2,0,1,1,2,2,H
1921-02-09,1920,Aston Villa,Burnley,0-0,0,0,1,1,0,0,D
1921-02-09,1920,Bradford City,West Bromwich Albion,1-1,1,1,1,1,2,0,D
1921-02-09,1920,Liverpool,Manchester United,2-0,2,0,1,1,2,2,H
1921-02-09,1920,Newcastle United,Chelsea,1-0,1,0,1,1,1,1,H
1921-02-10,1920,Blackburn Rovers,Huddersfield Town,1-2,1,2,1,1,3,-1,A
1921-02-12,1920,Aston Villa,Sunderland,1-5,1,5,1,1,6,-4,A
1921-02-12,1920,Bradford Park Avenue,Middlesbrough,3-0,3,0,1,1,3,3,H
1921-02-12,1920,Burnley,Derby County,2-1,2,1,1,1,3,1,H
1921-02-12,1920,Chelsea,West Bromwich Albion,3-0,3,0,1,1,3,3,H
1921-02-12,1920,Liverpool,Bradford City,2-1,2,1,1,1,3,1,H
1921-02-12,1920,Manchester United,Everton,1-2,1,2,1,1,3,-1,A
1921-02-12,1920,Newcastle United,Huddersfield Town,1-0,1,0,1,1,1,1,H
1921-02-12,1920,Oldham Athletic,Arsenal,1-1,1,1,1,1,2,0,D
1921-02-12,1920,Preston North End,Bolton Wanderers,1-2,1,2,1,1,3,-1,A
1921-02-12,1920,Sheffield United,Blackburn Rovers,1-1,1,1,1,1,2,0,D
1921-02-12,1920,Tottenham Hotspur,Manchester City,2-0,2,0,1,1,2,2,H
1921-02-14,1920,Oldham Athletic,Derby County,2-1,2,1,1,1,3,1,H
1921-02-16,1920,Bradford City,Bolton Wanderers,2-2,2,2,1,1,4,0,D
1921-02-19,1920,Arsenal,Oldham Athletic,2-2,2,2,1,1,4,0,D
1921-02-19,1920,Blackburn Rovers,Sheffield United,1-1,1,1,1,1,2,0,D
1921-02-19,1920,Bradford City,Liverpool,0-0,0,0,1,1,0,0,D
1921-02-19,1920,Middlesbrough,Bradford Park Avenue,2-1,2,1,1,1,3,1,H
1921-02-23,1920,Derby County,Burnley,0-0,0,0,1,1,0,0,D
1921-02-23,1920,Huddersfield Town,Newcastle United,1-3,1,3,1,1,4,-2,A
1921-02-23,1920,Manchester City,Everton,2-0,2,0,1,1,2,2,H
1921-02-23,1920,Sunderland,Aston Villa,0-1,0,1,1,1,1,-1,A
1921-02-23,1920,West Bromwich Albion,Tottenham Hotspur,3-1,3,1,1,1,4,2,H
1921-02-26,1920,Aston Villa,Bradford City,1-2,1,2,1,1,3,-1,A
1921-02-26,1920,Bradford Park Avenue,Blackburn Rovers,1-1,1,1,1,1,2,0,D
1921-02-26,1920,Burnley,Bolton Wanderers,3-1,3,1,1,1,4,2,H
1921-02-26,1920,Chelsea,Everton,0-1,0,1,1,1,1,-1,A
1921-02-26,1920,Liverpool,Huddersfield Town,4-1,4,1,1,1,5,3,H
1921-02-26,1920,Manchester United,Sunderland,3-0,3,0,1,1,3,3,H
1921-02-26,1920,Newcastle United,Middlesbrough,2-0,2,0,1,1,2,2,H
1921-02-26,1920,Oldham Athletic,Manchester City,2-0,2,0,1,1,2,2,H
1921-02-26,1920,Preston North End,Arsenal,0-1,0,1,1,1,1,-1,A
1921-02-26,1920,Sheffield United,Derby County,0-1,0,1,1,1,1,-1,A
1921-02-26,1920,Tottenham Hotspur,West Bromwich Albion,1-0,1,0,1,1,1,1,H
1921-03-05,1920,Blackburn Rovers,Bradford Park Avenue,1-0,1,0,1,1,1,1,H
1921-03-05,1920,Bolton Wanderers,Burnley,1-1,1,1,1,1,2,0,D
1921-03-05,1920,Derby County,Sheffield United,1-1,1,1,1,1,2,0,D
1921-03-05,1920,Huddersfield Town,Liverpool,1-2,1,2,1,1,3,-1,A
1921-03-05,1920,Manchester City,Oldham Athletic,3-1,3,1,1,1,4,2,H
1921-03-05,1920,Middlesbrough,Newcastle United,0-0,0,0,1,1,0,0,D
1921-03-05,1920,Sunderland,Manchester United,2-3,2,3,1,1,5,-1,A
1921-03-07,1920,Bradford City,Aston Villa,3-0,3,0,1,1,3,3,H
1921-03-09,1920,Everton,Manchester United,2-0,2,0,1,1,2,2,H
1921-03-09,1920,Manchester City,Tottenham Hotspur,2-0,2,0,1,1,2,2,H
1921-03-12,1920,Aston Villa,Huddersfield Town,0-0,0,0,1,1,0,0,D
1921-03-12,1920,Bradford Park Avenue,Derby County,2-1,2,1,1,1,3,1,H
1921-03-12,1920,Burnley,Arsenal,1-0,1,0,1,1,1,1,H
1921-03-12,1920,Chelsea,Sunderland,3-1,3,1,1,1,4,2,H
1921-03-12,1920,Liverpool,Middlesbrough,0-0,0,0,1,1,0,0,D
1921-03-12,1920,Manchester United,Bradford City,1-1,1,1,1,1,2,0,D
1921-03-12,1920,Newcastle United,Blackburn Rovers,1-2,1,2,1,1,3,-1,A
1921-03-12,1920,Oldham Athletic,West Bromwich Albion,0-3,0,3,1,1,3,-3,A
1921-03-12,1920,Preston North End,Manchester City,0-1,0,1,1,1,1,-1,A
1921-03-12,1920,Sheffield United,Bolton Wanderers,2-2,2,2,1,1,4,0,D
1921-03-12,1920,Tottenham Hotspur,Everton,2-0,2,0,1,1,2,2,H
1921-03-14,1920,West Bromwich Albion,Chelsea,1-1,1,1,1,1,2,0,D
1921-03-19,1920,Arsenal,Burnley,1-1,1,1,1,1,2,0,D
1921-03-19,1920,Blackburn Rovers,Newcastle United,3-3,3,3,1,1,6,0,D
1921-03-19,1920,Bolton Wanderers,Sheffield United,2-2,2,2,1,1,4,0,D
1921-03-19,1920,Bradford City,Manchester United,1-1,1,1,1,1,2,0,D
1921-03-19,1920,Derby County,Bradford Park Avenue,1-0,1,0,1,1,1,1,H
1921-03-19,1920,Huddersfield Town,Aston Villa,1-0,1,0,1,1,1,1,H
1921-03-19,1920,Middlesbrough,Liverpool,0-1,0,1,1,1,1,-1,A
1921-03-19,1920,Sunderland,Chelsea,1-0,1,0,1,1,1,1,H
1921-03-19,1920,West Bromwich Albion,Oldham Athletic,0-0,0,0,1,1,0,0,D
1921-03-25,1920,Blackburn Rovers,Bradford City,2-3,2,3,1,1,5,-1,A
1921-03-25,1920,Bolton Wanderers,Everton,4-2,4,2,1,1,6,2,H
1921-03-25,1920,Burnley,Manchester United,1-0,1,0,1,1,1,1,H
1921-03-25,1920,Liverpool,Tottenham Hotspur,1-1,1,1,1,1,2,0,D
1921-03-25,1920,Manchester City,Middlesbrough,2-1,2,1,1,1,3,1,H
1921-03-25,1920,Newcastle United,Oldham Athletic,1-2,1,2,1,1,3,-1,A
1921-03-25,1920,Preston North End,Bradford Park Avenue,3-3,3,3,1,1,6,0,D
1921-03-25,1920,Sunderland,Derby County,3-0,3,0,1,1,3,3,H
1921-03-26,1920,Arsenal,Sheffield United,2-6,2,6,1,1,8,-4,A
1921-03-26,1920,Blackburn Rovers,Liverpool,1-1,1,1,1,1,2,0,D
1921-03-26,1920,Bolton Wanderers,Bradford Park Avenue,2-0,2,0,1,1,2,2,H
1921-03-26,1920,Bradford City,Chelsea,1-1,1,1,1,1,2,0,D
1921-03-26,1920,Derby County,Newcastle United,0-1,0,1,1,1,1,-1,A
1921-03-26,1920,Everton,Oldham Athletic,5-2,5,2,1,1,7,3,H
1921-03-26,1920,Huddersfield Town,Manchester United,5-2,5,2,1,1,7,3,H
1921-03-26,1920,Manchester City,Burnley,3-0,3,0,1,1,3,3,H
1921-03-26,1920,Middlesbrough,Aston Villa,1-4,1,4,1,1,5,-3,A
1921-03-26,1920,Sunderland,Tottenham Hotspur,0-1,0,1,1,1,1,-1,A
1921-03-26,1920,West Bromwich Albion,Preston North End,0-3,0,3,1,1,3,-3,A
1921-03-28,1920,Arsenal,West Bromwich Albion,2-1,2,1,1,1,3,1,H
1921-03-28,1920,Aston Villa,Chelsea,3-0,3,0,1,1,3,3,H
1921-03-28,1920,Bradford Park Avenue,Preston North End,1-3,1,3,1,1,4,-2,A
1921-03-28,1920,Derby County,Sunderland,0-1,0,1,1,1,1,-1,A
1921-03-28,1920,Everton,Bolton Wanderers,2-3,2,3,1,1,5,-1,A
1921-03-28,1920,Manchester United,Burnley,0-3,0,3,1,1,3,-3,A
1921-03-28,1920,Middlesbrough,Manchester City,3-1,3,1,1,1,4,2,H
1921-03-28,1920,Oldham Athletic,Newcastle United,0-0,0,0,1,1,0,0,D
1921-03-28,1920,Tottenham Hotspur,Liverpool,1-0,1,0,1,1,1,1,H
1921-03-29,1920,Bradford City,Blackburn Rovers,3-4,3,4,1,1,7,-1,A
1921-03-29,1920,Chelsea,Aston Villa,5-1,5,1,1,1,6,4,H
1921-03-29,1920,Huddersfield Town,Sheffield United,1-0,1,0,1,1,1,1,H
1921-03-29,1920,West Bromwich Albion,Arsenal,3-4,3,4,1,1,7,-1,A
1921-04-02,1920,Aston Villa,Middlesbrough,0-1,0,1,1,1,1,-1,A
1921-04-02,1920,Bradford Park Avenue,Bolton Wanderers,2-1,2,1,1,1,3,1,H
1921-04-02,1920,Burnley,Manchester City,2-1,2,1,1,1,3,1,H
1921-04-02,1920,Chelsea,Bradford City,3-1,3,1,1,1,4,2,H
1921-04-02,1920,Liverpool,Blackburn Rovers,2-0,2,0,1,1,2,2,H
1921-04-02,1920,Manchester United,Huddersfield Town,2-0,2,0,1,1,2,2,H
1921-04-02,1920,Newcastle United,Derby County,0-1,0,1,1,1,1,-1,A
1921-04-02,1920,Oldham Athletic,Everton,0-1,0,1,1,1,1,-1,A
1921-04-02,1920,Preston North End,West Bromwich Albion,2-1,2,1,1,1,3,1,H
1921-04-02,1920,Sheffield United,Arsenal,1-1,1,1,1,1,2,0,D
1921-04-02,1920,Tottenham Hotspur,Sunderland,0-0,0,0,1,1,0,0,D
1921-04-04,1920,Bolton Wanderers,Preston North End,3-0,3,0,1,1,3,3,H
1921-04-06,1920,Everton,Chelsea,5-1,5,1,1,1,6,4,H
1921-04-09,1920,Arsenal,Bradford Park Avenue,2-1,2,1,1,1,3,1,H
1921-04-09,1920,Blackburn Rovers,Aston Villa,0-1,0,1,1,1,1,-1,A
1921-04-09,1920,Bolton Wanderers,Newcastle United,3-1,3,1,1,1,4,2,H
1921-04-09,1920,Bradford City,Tottenham Hotspur,1-0,1,0,1,1,1,1,H
1921-04-09,1920,Derby County,Liverpool,0-0,0,0,1,1,0,0,D
1921-04-09,1920,Everton,Preston North End,0-1,0,1,1,1,1,-1,A
1921-04-09,1920,Huddersfield Town,Chelsea,2-0,2,0,1,1,2,2,H
1921-04-09,1920,Manchester City,Sheffield United,2-1,2,1,1,1,3,1,H
1921-04-09,1920,Middlesbrough,Manchester United,2-4,2,4,1,1,6,-2,A
1921-04-09,1920,Sunderland,Oldham Athletic,1-1,1,1,1,1,2,0,D
1921-04-09,1920,West Bromwich Albion,Burnley,2-0,2,0,1,1,2,2,H
1921-04-16,1920,Aston Villa,Blackburn Rovers,3-0,3,0,1,1,3,3,H
1921-04-16,1920,Bradford Park Avenue,Arsenal,0-1,0,1,1,1,1,-1,A
1921-04-16,1920,Burnley,West Bromwich Albion,1-1,1,1,1,1,2,0,D
1921-04-16,1920,Chelsea,Huddersfield Town,1-1,1,1,1,1,2,0,D
1921-04-16,1920,Liverpool,Derby County,1-1,1,1,1,1,2,0,D
1921-04-16,1920,Manchester United,Middlesbrough,0-1,0,1,1,1,1,-1,A
1921-04-16,1920,Newcastle United,Bolton Wanderers,1-0,1,0,1,1,1,1,H
1921-04-16,1920,Oldham Athletic,Sunderland,2-1,2,1,1,1,3,1,H
1921-04-16,1920,Preston North End,Everton,1-0,1,0,1,1,1,1,H
1921-04-16,1920,Sheffield United,Manchester City,1-1,1,1,1,1,2,0,D
1921-04-16,1920,Tottenham Hotspur,Bradford City,2-0,2,0,1,1,2,2,H
1921-04-20,1920,Manchester City,Preston North End,5-1,5,1,1,1,6,4,H
1921-04-23,1920,Arsenal,Newcastle United,1-1,1,1,1,1,2,0,D
1921-04-23,1920,Blackburn Rovers,Manchester United,2-0,2,0,1,1,2,2,H
1921-04-23,1920,Bolton Wanderers,Liverpool,1-0,1,0,1,1,1,1,H
1921-04-23,1920,Bradford City,Oldham Athletic,1-3,1,3,1,1,4,-2,A
1921-04-23,1920,Derby County,Aston Villa,2-3,2,3,1,1,5,-1,A
1921-04-23,1920,Everton,Burnley,1-1,1,1,1,1,2,0,D
1921-04-23,1920,Manchester City,Bradford Park Avenue,1-0,1,0,1,1,1,1,H
1921-04-23,1920,Middlesbrough,Chelsea,0-0,0,0,1,1,0,0,D
1921-04-23,1920,Sunderland,Preston North End,2-2,2,2,1,1,4,0,D
1921-04-23,1920,West Bromwich Albion,Sheffield United,1-1,1,1,1,1,2,0,D
1921-04-25,1920,Arsenal,Preston North End,2-1,2,1,1,1,3,1,H
1921-04-25,1920,Huddersfield Town,Tottenham Hotspur,2-0,2,0,1,1,2,2,H
1921-04-27,1920,Everton,Tottenham Hotspur,0-0,0,0,1,1,0,0,D
1921-04-30,1920,Aston Villa,Derby County,1-0,1,0,1,1,1,1,H
1921-04-30,1920,Bradford Park Avenue,Manchester City,1-2,1,2,1,1,3,-1,A
1921-04-30,1920,Burnley,Everton,1-1,1,1,1,1,2,0,D
1921-04-30,1920,Chelsea,Middlesbrough,1-1,1,1,1,1,2,0,D
1921-04-30,1920,Liverpool,Bolton Wanderers,2-3,2,3,1,1,5,-1,A
1921-04-30,1920,Manchester United,Blackburn Rovers,0-1,0,1,1,1,1,-1,A
1921-04-30,1920,Newcastle United,Arsenal,1-0,1,0,1,1,1,1,H
1921-04-30,1920,Oldham Athletic,Bradford City,2-0,2,0,1,1,2,2,H
1921-04-30,1920,Preston North End,Sunderland,1-1,1,1,1,1,2,0,D
1921-04-30,1920,Sheffield United,West Bromwich Albion,0-2,0,2,1,1,2,-2,A
1921-04-30,1920,Tottenham Hotspur,Huddersfield Town,1-0,1,0,1,1,1,1,H
1921-05-02,1920,Arsenal,Liverpool,0-0,0,0,1,1,0,0,D
1921-05-02,1920,Blackburn Rovers,Chelsea,0-0,0,0,1,1,0,0,D
1921-05-02,1920,Bradford City,Preston North End,6-2,6,2,1,1,8,4,H
1921-05-02,1920,Derby County,Manchester United,1-1,1,1,1,1,2,0,D
1921-05-02,1920,Huddersfield Town,Oldham Athletic,3-1,3,1,1,1,4,2,H
1921-05-02,1920,Manchester City,Newcastle United,3-1,3,1,1,1,4,2,H
1921-05-02,1920,Middlesbrough,Tottenham Hotspur,1-0,1,0,1,1,1,1,H
1921-05-02,1920,Sunderland,Burnley,1-0,1,0,1,1,1,1,H
1921-05-02,1920,West Bromwich Albion,Bradford Park Avenue,0-1,0,1,1,1,1,-1,A
1921-05-07,1920,Aston Villa,Bolton Wanderers,2-0,2,0,1,1,2,2,H
1921-05-07,1920,Bradford Park Avenue,West Bromwich Albion,0-3,0,3,1,1,3,-3,A
1921-05-07,1920,Burnley,Sunderland,2-2,2,2,1,1,4,0,D
1921-05-07,1920,Chelsea,Blackburn Rovers,1-2,1,2,1,1,3,-1,A
1921-05-07,1920,Liverpool,Arsenal,3-0,3,0,1,1,3,3,H
1921-05-07,1920,Manchester United,Derby County,3-0,3,0,1,1,3,3,H
1921-05-07,1920,Newcastle United,Manchester City,1-1,1,1,1,1,2,0,D
1921-05-07,1920,Oldham Athletic,Huddersfield Town,1-2,1,2,1,1,3,-1,A
1921-05-07,1920,Preston North End,Bradford City,1-1,1,1,1,1,2,0,D
1921-05-07,1920,Tottenham Hotspur,Middlesbrough,2-2,2,2,1,1,4,0,D
1921-08-27,1921,Arsenal,Sheffield United,1-2,1,2,1,1,3,-1,A
1921-08-27,1921,Birmingham City,Burnley,2-3,2,3,1,1,5,-1,A
1921-08-27,1921,Blackburn Rovers,Chelsea,1-1,1,1,1,1,2,0,D
1921-08-27,1921,Bolton Wanderers,Preston North End,2-2,2,2,1,1,4,0,D
1921-08-27,1921,Cardiff City,Tottenham Hotspur,0-1,0,1,1,1,1,-1,A
1921-08-27,1921,Everton,Manchester United,5-0,5,0,1,1,5,5,H
1921-08-27,1921,Huddersfield Town,Newcastle United,1-2,1,2,1,1,3,-1,A
1921-08-27,1921,Manchester City,Aston Villa,2-1,2,1,1,1,3,1,H
1921-08-27,1921,Oldham Athletic,Bradford City,0-0,0,0,1,1,0,0,D
1921-08-27,1921,Sunderland,Liverpool,3-0,3,0,1,1,3,3,H
1921-08-27,1921,West Bromwich Albion,Middlesbrough,0-0,0,0,1,1,0,0,D
1921-08-29,1921,Aston Villa,Cardiff City,2-1,2,1,1,1,3,1,H
1921-08-29,1921,Bradford City,Blackburn Rovers,1-1,1,1,1,1,2,0,D
1921-08-29,1921,Chelsea,Birmingham City,1-2,1,2,1,1,3,-1,A
1921-08-29,1921,Manchester United,West Bromwich Albion,2-3,2,3,1,1,5,-1,A
1921-08-29,1921,Middlesbrough,Oldham Athletic,1-1,1,1,1,1,2,0,D
1921-08-29,1921,Preston North End,Arsenal,3-2,3,2,1,1,5,1,H
1921-08-29,1921,Sheffield United,Huddersfield Town,1-1,1,1,1,1,2,0,D
1921-08-29,1921,Tottenham Hotspur,Bolton Wanderers,1-2,1,2,1,1,3,-1,A
1921-08-31,1921,Liverpool,Manchester City,3-2,3,2,1,1,5,1,H
1921-08-31,1921,Newcastle United,Everton,3-0,3,0,1,1,3,3,H
1921-08-31,1921,Sunderland,Burnley,3-2,3,2,1,1,5,1,H
1921-09-03,1921,Aston Villa,Manchester City,4-0,4,0,1,1,4,4,H
1921-09-03,1921,Bradford City,Oldham Athletic,3-0,3,0,1,1,3,3,H
1921-09-03,1921,Burnley,Birmingham City,3-1,3,1,1,1,4,2,H
1921-09-03,1921,Chelsea,Blackburn Rovers,1-0,1,0,1,1,1,1,H
1921-09-03,1921,Liverpool,Sunderland,2-1,2,1,1,1,3,1,H
1921-09-03,1921,Manchester United,Everton,2-1,2,1,1,1,3,1,H
1921-09-03,1921,Middlesbrough,West Bromwich Albion,3-2,3,2,1,1,5,1,H
1921-09-03,1921,Newcastle United,Huddersfield Town,1-2,1,2,1,1,3,-1,A
1921-09-03,1921,Preston North End,Bolton Wanderers,3-1,3,1,1,1,4,2,H
1921-09-03,1921,Sheffield United,Arsenal,4-1,4,1,1,1,5,3,H
1921-09-03,1921,Tottenham Hotspur,Cardiff City,4-1,4,1,1,1,5,3,H
1921-09-05,1921,Arsenal,Preston North End,1-0,1,0,1,1,1,1,H
1921-09-05,1921,Birmingham City,Chelsea,5-1,5,1,1,1,6,4,H
1921-09-05,1921,Bolton Wanderers,Tottenham Hotspur,1-0,1,0,1,1,1,1,H
1921-09-05,1921,Burnley,Sunderland,2-0,2,0,1,1,2,2,H
1921-09-05,1921,Cardiff City,Aston Villa,0-4,0,4,1,1,4,-4,A
1921-09-05,1921,Oldham Athletic,Middlesbrough,0-1,0,1,1,1,1,-1,A
1921-09-06,1921,Huddersfield Town,Sheffield United,1-1,1,1,1,1,2,0,D
1921-09-07,1921,Everton,Newcastle United,2-3,2,3,1,1,5,-1,A
1921-09-07,1921,Manchester City,Liverpool,1-1,1,1,1,1,2,0,D
1921-09-07,1921,West Bromwich Albion,Manchester United,0-0,0,0,1,1,0,0,D
1921-09-10,1921,Bolton Wanderers,Bradford City,3-3,3,3,1,1,6,0,D
1921-09-10,1921,Burnley,Newcastle United,2-0,2,0,1,1,2,2,H
1921-09-10,1921,Cardiff City,Oldham Athletic,0-1,0,1,1,1,1,-1,A
1921-09-10,1921,Chelsea,Manchester United,0-0,0,0,1,1,0,0,D
1921-09-10,1921,Everton,Birmingham City,2-1,2,1,1,1,3,1,H
1921-09-10,1921,Manchester City,Arsenal,2-0,2,0,1,1,2,2,H
1921-09-10,1921,Preston North End,Aston Villa,1-0,1,0,1,1,1,1,H
1921-09-10,1921,Sheffield United,Liverpool,0-1,0,1,1,1,1,-1,A
1921-09-10,1921,Sunderland,Huddersfield Town,2-2,2,2,1,1,4,0,D
1921-09-10,1921,Tottenham Hotspur,Middlesbrough,2-4,2,4,1,1,6,-2,A
1921-09-10,1921,West Bromwich Albion,Blackburn Rovers,0-2,0,2,1,1,2,-2,A
1921-09-12,1921,Aston Villa,Blackburn Rovers,1-1,1,1,1,1,2,0,D
1921-09-17,1921,Arsenal,Manchester City,0-1,0,1,1,1,1,-1,A
1921-09-17,1921,Aston Villa,Preston North End,2-0,2,0,1,1,2,2,H
1921-09-17,1921,Birmingham City,Everton,1-1,1,1,1,1,2,0,D
1921-09-17,1921,Blackburn Rovers,West Bromwich Albion,2-3,2,3,1,1,5,-1,A
1921-09-17,1921,Bradford City,Bolton Wanderers,4-3,4,3,1,1,7,1,H
1921-09-17,1921,Huddersfield Town,Sunderland,1-2,1,2,1,1,3,-1,A
1921-09-17,1921,Liverpool,Sheffield United,1-1,1,1,1,1,2,0,D
1921-09-17,1921,Manchester United,Chelsea,0-0,0,0,1,1,0,0,D
1921-09-17,1921,Middlesbrough,Tottenham Hotspur,0-0,0,0,1,1,0,0,D
1921-09-17,1921,Newcastle United,Burnley,2-1,2,1,1,1,3,1,H
1921-09-17,1921,Oldham Athletic,Cardiff City,2-1,2,1,1,1,3,1,H
1921-09-19,1921,Blackburn Rovers,Bradford City,3-1,3,1,1,1,4,2,H
1921-09-24,1921,Bolton Wanderers,Huddersfield Town,3-1,3,1,1,1,4,2,H
1921-09-24,1921,Burnley,Bradford City,4-0,4,0,1,1,4,4,H
1921-09-24,1921,Cardiff City,Middlesbrough,3-1,3,1,1,1,4,2,H
1921-09-24,1921,Chelsea,Liverpool,0-1,0,1,1,1,1,-1,A
1921-09-24,1921,Everton,Arsenal,1-1,1,1,1,1,2,0,D
1921-09-24,1921,Manchester City,Blackburn Rovers,1-1,1,1,1,1,2,0,D
1921-09-24,1921,Preston North End,Manchester United,3-2,3,2,1,1,5,1,H
1921-09-24,1921,Sheffield United,Newcastle United,1-1,1,1,1,1,2,0,D
1921-09-24,1921,Sunderland,Birmingham City,2-1,2,1,1,1,3,1,H
1921-09-24,1921,Tottenham Hotspur,Aston Villa,3-1,3,1,1,1,4,2,H
1921-09-24,1921,West Bromwich Albion,Oldham Athletic,0-1,0,1,1,1,1,-1,A
1921-10-01,1921,Arsenal,Everton,1-0,1,0,1,1,1,1,H
1921-10-01,1921,Aston Villa,Tottenham Hotspur,2-1,2,1,1,1,3,1,H
1921-10-01,1921,Birmingham City,Sunderland,1-0,1,0,1,1,1,1,H
1921-10-01,1921,Blackburn Rovers,Manchester City,3-1,3,1,1,1,4,2,H
1921-10-01,1921,Bradford City,Burnley,0-4,0,4,1,1,4,-4,A
1921-10-01,1921,Huddersfield Town,Bolton Wanderers,3-0,3,0,1,1,3,3,H
1921-10-01,1921,Liverpool,Chelsea,1-1,1,1,1,1,2,0,D
1921-10-01,1921,Manchester United,Preston North End,1-1,1,1,1,1,2,0,D
1921-10-01,1921,Middlesbrough,Cardiff City,0-0,0,0,1,1,0,0,D
1921-10-01,1921,Newcastle United,Sheffield United,2-1,2,1,1,1,3,1,H
1921-10-01,1921,Oldham Athletic,West Bromwich Albion,1-0,1,0,1,1,1,1,H
1921-10-08,1921,Birmingham City,Huddersfield Town,0-2,0,2,1,1,2,-2,A
1921-10-08,1921,Bradford City,Middlesbrough,0-2,0,2,1,1,2,-2,A
1921-10-08,1921,Burnley,Sheffield United,2-1,2,1,1,1,3,1,H
1921-10-08,1921,Cardiff City,Bolton Wanderers,1-2,1,2,1,1,3,-1,A
1921-10-08,1921,Chelsea,Newcastle United,1-1,1,1,1,1,2,0,D
1921-10-08,1921,Everton,Blackburn Rovers,2-0,2,0,1,1,2,2,H
1921-10-08,1921,Manchester City,Oldham Athletic,2-1,2,1,1,1,3,1,H
1921-10-08,1921,Preston North End,Liverpool,1-1,1,1,1,1,2,0,D
1921-10-08,1921,Sunderland,Arsenal,1-0,1,0,1,1,1,1,H
1921-10-08,1921,Tottenham Hotspur,Manchester United,2-2,2,2,1,1,4,0,D
1921-10-08,1921,West Bromwich Albion,Aston Villa,0-1,0,1,1,1,1,-1,A
1921-10-15,1921,Arsenal,Sunderland,1-2,1,2,1,1,3,-1,A
1921-10-15,1921,Aston Villa,West Bromwich Albion,0-1,0,1,1,1,1,-1,A
1921-10-15,1921,Blackburn Rovers,Everton,2-2,2,2,1,1,4,0,D
1921-10-15,1921,Bolton Wanderers,Cardiff City,1-2,1,2,1,1,3,-1,A
1921-10-15,1921,Huddersfield Town,Birmingham City,1-0,1,0,1,1,1,1,H
1921-10-15,1921,Liverpool,Preston North End,4-0,4,0,1,1,4,4,H
1921-10-15,1921,Manchester United,Tottenham Hotspur,2-1,2,1,1,1,3,1,H
1921-10-15,1921,Middlesbrough,Bradford City,1-2,1,2,1,1,3,-1,A
1921-10-15,1921,Newcastle United,Chelsea,1-0,1,0,1,1,1,1,H
1921-10-15,1921,Oldham Athletic,Manchester City,0-1,0,1,1,1,1,-1,A
1921-10-15,1921,Sheffield United,Burnley,0-1,0,1,1,1,1,-1,A
1921-10-22,1921,Birmingham City,Bolton Wanderers,1-1,1,1,1,1,2,0,D
1921-10-22,1921,Bradford City,Sheffield United,1-1,1,1,1,1,2,0,D
1921-10-22,1921,Burnley,Chelsea,5-0,5,0,1,1,5,5,H
1921-10-22,1921,Everton,Oldham Athletic,2-2,2,2,1,1,4,0,D
1921-10-22,1921,Huddersfield Town,Arsenal,2-0,2,0,1,1,2,2,H
1921-10-22,1921,Manchester City,Manchester United,4-1,4,1,1,1,5,3,H
1921-10-22,1921,Middlesbrough,Aston Villa,5-0,5,0,1,1,5,5,H
1921-10-22,1921,Preston North End,Newcastle United,2-0,2,0,1,1,2,2,H
1921-10-22,1921,Sunderland,Blackburn Rovers,3-1,3,1,1,1,4,2,H
1921-10-22,1921,Tottenham Hotspur,Liverpool,0-1,0,1,1,1,1,-1,A
1921-10-22,1921,West Bromwich Albion,Cardiff City,2-2,2,2,1,1,4,0,D
1921-10-29,1921,Arsenal,Huddersfield Town,1-3,1,3,1,1,4,-2,A
1921-10-29,1921,Aston Villa,Middlesbrough,6-2,6,2,1,1,8,4,H
1921-10-29,1921,Blackburn Rovers,Sunderland,1-2,1,2,1,1,3,-1,A
1921-10-29,1921,Bolton Wanderers,Birmingham City,1-2,1,2,1,1,3,-1,A
1921-10-29,1921,Cardiff City,West Bromwich Albion,2-0,2,0,1,1,2,2,H
1921-10-29,1921,Chelsea,Burnley,4-1,4,1,1,1,5,3,H
1921-10-29,1921,Liverpool,Tottenham Hotspur,1-1,1,1,1,1,2,0,D
1921-10-29,1921,Manchester United,Manchester City,3-1,3,1,1,1,4,2,H
1921-10-29,1921,Newcastle United,Preston North End,3-1,3,1,1,1,4,2,H
1921-10-29,1921,Oldham Athletic,Everton,0-0,0,0,1,1,0,0,D
1921-10-29,1921,Sheffield United,Bradford City,1-0,1,0,1,1,1,1,H
1921-11-05,1921,Birmingham City,Arsenal,0-1,0,1,1,1,1,-1,A
1921-11-05,1921,Bradford City,Aston Villa,3-2,3,2,1,1,5,1,H
1921-11-05,1921,Burnley,Preston North End,3-3,3,3,1,1,6,0,D
1921-11-05,1921,Cardiff City,Manchester City,0-2,0,2,1,1,2,-2,A
1921-11-05,1921,Chelsea,Sheffield United,0-2,0,2,1,1,2,-2,A
1921-11-05,1921,Everton,Liverpool,1-1,1,1,1,1,2,0,D
1921-11-05,1921,Huddersfield Town,Blackburn Rovers,3-0,3,0,1,1,3,3,H
1921-11-05,1921,Manchester United,Middlesbrough,3-5,3,5,1,1,8,-2,A
1921-11-05,1921,Sunderland,Oldham Athletic,5-1,5,1,1,1,6,4,H
1921-11-05,1921,Tottenham Hotspur,Newcastle United,4-0,4,0,1,1,4,4,H
1921-11-05,1921,West Bromwich Albion,Bolton Wanderers,0-1,0,1,1,1,1,-1,A
1921-11-12,1921,Arsenal,Birmingham City,5-2,5,2,1,1,7,3,H
1921-11-12,1921,Aston Villa,Bradford City,7-1,7,1,1,1,8,6,H
1921-11-12,1921,Blackburn Rovers,Huddersfield Town,2-0,2,0,1,1,2,2,H
1921-11-12,1921,Bolton Wanderers,West Bromwich Albion,2-0,2,0,1,1,2,2,H
1921-11-12,1921,Liverpool,Everton,1-1,1,1,1,1,2,0,D
1921-11-12,1921,Manchester City,Cardiff City,1-1,1,1,1,1,2,0,D
1921-11-12,1921,Middlesbrough,Manchester United,2-0,2,0,1,1,2,2,H
1921-11-12,1921,Newcastle United,Tottenham Hotspur,0-2,0,2,1,1,2,-2,A
1921-11-12,1921,Oldham Athletic,Sunderland,3-0,3,0,1,1,3,3,H
1921-11-12,1921,Preston North End,Burnley,2-1,2,1,1,1,3,1,H
1921-11-12,1921,Sheffield United,Chelsea,1-2,1,2,1,1,3,-1,A
1921-11-19,1921,Aston Villa,Manchester United,3-1,3,1,1,1,4,2,H
1921-11-19,1921,Blackburn Rovers,Birmingham City,1-1,1,1,1,1,2,0,D
1921-11-19,1921,Bolton Wanderers,Arsenal,1-0,1,0,1,1,1,1,H
1921-11-19,1921,Cardiff City,Everton,2-1,2,1,1,1,3,1,H
1921-11-19,1921,Chelsea,Bradford City,1-0,1,0,1,1,1,1,H
1921-11-19,1921,Liverpool,Middlesbrough,4-0,4,0,1,1,4,4,H
1921-11-19,1921,Manchester City,West Bromwich Albion,6-1,6,1,1,1,7,5,H
1921-11-19,1921,Newcastle United,Sunderland,2-2,2,2,1,1,4,0,D
1921-11-19,1921,Oldham Athletic,Huddersfield Town,1-1,1,1,1,1,2,0,D
1921-11-19,1921,Sheffield United,Preston North End,3-0,3,0,1,1,3,3,H
1921-11-19,1921,Tottenham Hotspur,Burnley,1-1,1,1,1,1,2,0,D
1921-11-26,1921,Birmingham City,Blackburn Rovers,1-0,1,0,1,1,1,1,H
1921-11-26,1921,Bradford City,Chelsea,0-1,0,1,1,1,1,-1,A
1921-11-26,1921,Burnley,Tottenham Hotspur,1-0,1,0,1,1,1,1,H
1921-11-26,1921,Everton,Cardiff City,0-1,0,1,1,1,1,-1,A
1921-11-26,1921,Huddersfield Town,Oldham Athletic,1-0,1,0,1,1,1,1,H
1921-11-26,1921,Manchester United,Aston Villa,1-0,1,0,1,1,1,1,H
1921-11-26,1921,Middlesbrough,Liverpool,3-1,3,1,1,1,4,2,H
1921-11-26,1921,Preston North End,Sheffield United,3-0,3,0,1,1,3,3,H
1921-11-26,1921,Sunderland,Newcastle United,0-0,0,0,1,1,0,0,D
1921-11-26,1921,West Bromwich Albion,Manchester City,2-0,2,0,1,1,2,2,H
1921-12-03,1921,Aston Villa,Liverpool,1-1,1,1,1,1,2,0,D
1921-12-03,1921,Blackburn Rovers,Arsenal,0-1,0,1,1,1,1,-1,A
1921-12-03,1921,Bradford City,Manchester United,2-1,2,1,1,1,3,1,H
1921-12-03,1921,Cardiff City,Sunderland,2-0,2,0,1,1,2,2,H
1921-12-03,1921,Chelsea,Preston North End,0-0,0,0,1,1,0,0,D
1921-12-03,1921,Everton,West Bromwich Albion,1-2,1,2,1,1,3,-1,A
1921-12-03,1921,Huddersfield Town,Burnley,1-0,1,0,1,1,1,1,H
1921-12-03,1921,Manchester City,Bolton Wanderers,2-3,2,3,1,1,5,-1,A
1921-12-03,1921,Newcastle United,Middlesbrough,0-0,0,0,1,1,0,0,D
1921-12-03,1921,Oldham Athletic,Birmingham City,0-1,0,1,1,1,1,-1,A
1921-12-03,1921,Tottenham Hotspur,Sheffield United,2-1,2,1,1,1,3,1,H
1921-12-10,1921,Arsenal,Blackburn Rovers,1-1,1,1,1,1,2,0,D
1921-12-10,1921,Birmingham City,Oldham Athletic,3-0,3,0,1,1,3,3,H
1921-12-10,1921,Bolton Wanderers,Manchester City,5-0,5,0,1,1,5,5,H
1921-12-10,1921,Burnley,Huddersfield Town,1-0,1,0,1,1,1,1,H
1921-12-10,1921,Liverpool,Aston Villa,2-0,2,0,1,1,2,2,H
1921-12-10,1921,Manchester United,Bradford City,1-1,1,1,1,1,2,0,D
1921-12-10,1921,Middlesbrough,Newcastle United,1-1,1,1,1,1,2,0,D
1921-12-10,1921,Preston North End,Chelsea,2-0,2,0,1,1,2,2,H
1921-12-10,1921,Sheffield United,Tottenham Hotspur,1-0,1,0,1,1,1,1,H
1921-12-10,1921,Sunderland,Cardiff City,4-1,4,1,1,1,5,3,H
1921-12-10,1921,West Bromwich Albion,Everton,1-1,1,1,1,1,2,0,D
1921-12-12,1921,Arsenal,Bolton Wanderers,1-1,1,1,1,1,2,0,D
1921-12-17,1921,Birmingham City,Sheffield United,2-1,2,1,1,1,3,1,H
1921-12-17,1921,Blackburn Rovers,Bolton Wanderers,1-2,1,2,1,1,3,-1,A
1921-12-17,1921,Bradford City,Preston North End,1-0,1,0,1,1,1,1,H
1921-12-17,1921,Cardiff City,Huddersfield Town,0-0,0,0,1,1,0,0,D
1921-12-17,1921,Liverpool,Manchester United,2-1,2,1,1,1,3,1,H
1921-12-17,1921,Manchester City,Everton,2-1,2,1,1,1,3,1,H
1921-12-17,1921,Middlesbrough,Burnley,4-1,4,1,1,1,5,3,H
1921-12-17,1921,Newcastle United,Aston Villa,1-2,1,2,1,1,3,-1,A
1921-12-17,1921,Oldham Athletic,Arsenal,2-1,2,1,1,1,3,1,H
1921-12-17,1921,Tottenham Hotspur,Chelsea,0-0,0,0,1,1,0,0,D
1921-12-17,1921,West Bromwich Albion,Sunderland,2-1,2,1,1,1,3,1,H
1921-12-24,1921,Arsenal,Oldham Athletic,0-1,0,1,1,1,1,-1,A
1921-12-24,1921,Aston Villa,Newcastle United,1-0,1,0,1,1,1,1,H
1921-12-24,1921,Bolton Wanderers,Blackburn Rovers,1-1,1,1,1,1,2,0,D
1921-12-24,1921,Burnley,Middlesbrough,3-1,3,1,1,1,4,2,H
1921-12-24,1921,Chelsea,Tottenham Hotspur,1-2,1,2,1,1,3,-1,A
1921-12-24,1921,Everton,Manchester City,2-2,2,2,1,1,4,0,D
1921-12-24,1921,Huddersfield Town,Cardiff City,0-1,0,1,1,1,1,-1,A
1921-12-24,1921,Manchester United,Liverpool,0-0,0,0,1,1,0,0,D
1921-12-24,1921,Preston North End,Bradford City,2-1,2,1,1,1,3,1,H
1921-12-24,1921,Sheffield United,Birmingham City,1-2,1,2,1,1,3,-1,A
1921-12-24,1921,Sunderland,West Bromwich Albion,5-0,5,0,1,1,5,5,H
1921-12-26,1921,Arsenal,Cardiff City,0-0,0,0,1,1,0,0,D
1921-12-26,1921,Blackburn Rovers,Preston North End,3-0,3,0,1,1,3,3,H
1921-12-26,1921,Huddersfield Town,Manchester City,2-0,2,0,1,1,2,2,H
1921-12-26,1921,Liverpool,Newcastle United,1-0,1,0,1,1,1,1,H
1921-12-26,1921,Manchester United,Burnley,0-1,0,1,1,1,1,-1,A
1921-12-26,1921,Middlesbrough,Chelsea,0-1,0,1,1,1,1,-1,A
1921-12-26,1921,Oldham Athletic,Bolton Wanderers,0-0,0,0,1,1,0,0,D
1921-12-26,1921,Sheffield United,Aston Villa,2-3,2,3,1,1,5,-1,A
1921-12-26,1921,Sunderland,Everton,1-2,1,2,1,1,3,-1,A
1921-12-26,1921,Tottenham Hotspur,Bradford City,1-0,1,0,1,1,1,1,H
1921-12-26,1921,West Bromwich Albion,Birmingham City,1-0,1,0,1,1,1,1,H
1921-12-27,1921,Aston Villa,Sheffield United,5-3,5,3,1,1,8,2,H
1921-12-27,1921,Birmingham City,West Bromwich Albion,0-2,0,2,1,1,2,-2,A
1921-12-27,1921,Bradford City,Tottenham Hotspur,0-4,0,4,1,1,4,-4,A
1921-12-27,1921,Burnley,Manchester United,4-2,4,2,1,1,6,2,H
1921-12-27,1921,Cardiff City,Arsenal,4-3,4,3,1,1,7,1,H
1921-12-27,1921,Chelsea,Middlesbrough,1-1,1,1,1,1,2,0,D
1921-12-27,1921,Liverpool,Huddersfield Town,2-0,2,0,1,1,2,2,H
1921-12-27,1921,Preston North End,Blackburn Rovers,2-1,2,1,1,1,3,1,H
1921-12-31,1921,Birmingham City,Cardiff City,0-1,0,1,1,1,1,-1,A
1921-12-31,1921,Bradford City,Liverpool,0-0,0,0,1,1,0,0,D
1921-12-31,1921,Burnley,Aston Villa,2-1,2,1,1,1,3,1,H
1921-12-31,1921,Chelsea,Arsenal,0-2,0,2,1,1,2,-2,A
1921-12-31,1921,Everton,Bolton Wanderers,1-0,1,0,1,1,1,1,H
1921-12-31,1921,Manchester City,Sunderland,3-0,3,0,1,1,3,3,H
1921-12-31,1921,Newcastle United,Manchester United,3-0,3,0,1,1,3,3,H
1921-12-31,1921,Oldham Athletic,Blackburn Rovers,1-1,1,1,1,1,2,0,D
1921-12-31,1921,Sheffield United,Middlesbrough,6-1,6,1,1,1,7,5,H
1921-12-31,1921,Tottenham Hotspur,Preston North End,5-0,5,0,1,1,5,5,H
1921-12-31,1921,West Bromwich Albion,Huddersfield Town,3-2,3,2,1,1,5,1,H
1922-01-02,1921,Blackburn Rovers,Cardiff City,1-3,1,3,1,1,4,-2,A
1922-01-02,1921,Bolton Wanderers,Oldham Athletic,5-1,5,1,1,1,6,4,H
1922-01-02,1921,Everton,Sunderland,3-0,3,0,1,1,3,3,H
1922-01-02,1921,Manchester City,Huddersfield Town,2-1,2,1,1,1,3,1,H
1922-01-02,1921,Newcastle United,Liverpool,1-1,1,1,1,1,2,0,D
1922-01-02,1921,Sheffield United,Manchester United,3-0,3,0,1,1,3,3,H
1922-01-14,1921,Arsenal,Chelsea,1-0,1,0,1,1,1,1,H
1922-01-14,1921,Aston Villa,Burnley,2-0,2,0,1,1,2,2,H
1922-01-14,1921,Blackburn Rovers,Oldham Athletic,3-2,3,2,1,1,5,1,H
1922-01-14,1921,Bolton Wanderers,Everton,1-0,1,0,1,1,1,1,H
1922-01-14,1921,Cardiff City,Birmingham City,3-1,3,1,1,1,4,2,H
1922-01-14,1921,Huddersfield Town,West Bromwich Albion,2-0,2,0,1,1,2,2,H
1922-01-14,1921,Liverpool,Bradford City,2-1,2,1,1,1,3,1,H
1922-01-14,1921,Manchester United,Newcastle United,0-1,0,1,1,1,1,-1,A
1922-01-14,1921,Middlesbrough,Sheffield United,1-1,1,1,1,1,2,0,D
1922-01-14,1921,Preston North End,Tottenham Hotspur,1-2,1,2,1,1,3,-1,A
1922-01-14,1921,Sunderland,Manchester City,2-3,2,3,1,1,5,-1,A
1922-01-18,1921,Chelsea,Bolton Wanderers,0-3,0,3,1,1,3,-3,A
1922-01-21,1921,Arsenal,Burnley,0-0,0,0,1,1,0,0,D
1922-01-21,1921,Birmingham City,Newcastle United,0-4,0,4,1,1,4,-4,A
1922-01-21,1921,Blackburn Rovers,Sheffield United,2-3,2,3,1,1,5,-1,A
1922-01-21,1921,Bolton Wanderers,Chelsea,0-2,0,2,1,1,2,-2,A
1922-01-21,1921,Cardiff City,Bradford City,6-3,6,3,1,1,9,3,H
1922-01-21,1921,Everton,Aston Villa,3-2,3,2,1,1,5,1,H
1922-01-21,1921,Huddersfield Town,Liverpool,0-1,0,1,1,1,1,-1,A
1922-01-21,1921,Manchester City,Middlesbrough,2-2,2,2,1,1,4,0,D
1922-01-21,1921,Oldham Athletic,Preston North End,2-0,2,0,1,1,2,2,H
1922-01-21,1921,Sunderland,Manchester United,2-1,2,1,1,1,3,1,H
1922-01-21,1921,West Bromwich Albion,Tottenham Hotspur,3-0,3,0,1,1,3,3,H
1922-01-28,1921,Manchester United,Sunderland,3-1,3,1,1,1,4,2,H
1922-01-30,1921,Tottenham Hotspur,West Bromwich Albion,2-0,2,0,1,1,2,2,H
1922-02-01,1921,Middlesbrough,Manchester City,4-1,4,1,1,1,5,3,H
1922-02-04,1921,Arsenal,Newcastle United,2-1,2,1,1,1,3,1,H
1922-02-04,1921,Birmingham City,Liverpool,0-2,0,2,1,1,2,-2,A
1922-02-04,1921,Blackburn Rovers,Burnley,3-2,3,2,1,1,5,1,H
1922-02-04,1921,Bolton Wanderers,Sheffield United,3-1,3,1,1,1,4,2,H
1922-02-04,1921,Cardiff City,Preston North End,3-0,3,0,1,1,3,3,H
1922-02-04,1921,Manchester City,Tottenham Hotspur,3-3,3,3,1,1,6,0,D
1922-02-04,1921,Oldham Athletic,Chelsea,0-3,0,3,1,1,3,-3,A
1922-02-04,1921,Sunderland,Aston Villa,1-4,1,4,1,1,5,-3,A
1922-02-04,1921,West Bromwich Albion,Bradford City,1-1,1,1,1,1,2,0,D
1922-02-08,1921,Aston Villa,Everton,2-1,2,1,1,1,3,1,H
1922-02-08,1921,Cardiff City,Chelsea,2-0,2,0,1,1,2,2,H
1922-02-08,1921,Newcastle United,Birmingham City,0-1,0,1,1,1,1,-1,A
1922-02-09,1921,Preston North End,Oldham Athletic,0-0,0,0,1,1,0,0,D
1922-02-11,1921,Aston Villa,Sunderland,2-0,2,0,1,1,2,2,H
1922-02-11,1921,Burnley,Blackburn Rovers,1-2,1,2,1,1,3,-1,A
1922-02-11,1921,Chelsea,Oldham Athletic,1-0,1,0,1,1,1,1,H
1922-02-11,1921,Liverpool,Birmingham City,1-0,1,0,1,1,1,1,H
1922-02-11,1921,Manchester United,Huddersfield Town,1-1,1,1,1,1,2,0,D
1922-02-11,1921,Middlesbrough,Everton,3-1,3,1,1,1,4,2,H
1922-02-11,1921,Newcastle United,Arsenal,3-1,3,1,1,1,4,2,H
1922-02-11,1921,Preston North End,Cardiff City,1-1,1,1,1,1,2,0,D
1922-02-11,1921,Sheffield United,Bolton Wanderers,1-0,1,0,1,1,1,1,H
1922-02-11,1921,Tottenham Hotspur,Manchester City,3-1,3,1,1,1,4,2,H
1922-02-18,1921,Birmingham City,Manchester United,0-1,0,1,1,1,1,-1,A
1922-02-18,1921,Bolton Wanderers,Burnley,0-1,0,1,1,1,1,-1,A
1922-02-18,1921,Oldham Athletic,Sheffield United,0-2,0,2,1,1,2,-2,A
1922-02-18,1921,Sunderland,Middlesbrough,1-1,1,1,1,1,2,0,D
1922-02-20,1921,Burnley,Arsenal,1-0,1,0,1,1,1,1,H
1922-02-22,1921,Manchester City,Bradford City,3-2,3,2,1,1,5,1,H
1922-02-25,1921,Aston Villa,Huddersfield Town,2-0,2,0,1,1,2,2,H
1922-02-25,1921,Bradford City,Manchester City,1-2,1,2,1,1,3,-1,A
1922-02-25,1921,Burnley,Bolton Wanderers,2-0,2,0,1,1,2,2,H
1922-02-25,1921,Chelsea,Cardiff City,1-0,1,0,1,1,1,1,H
1922-02-25,1921,Liverpool,Arsenal,4-0,4,0,1,1,4,4,H
1922-02-25,1921,Manchester United,Birmingham City,1-1,1,1,1,1,2,0,D
1922-02-25,1921,Middlesbrough,Sunderland,3-0,3,0,1,1,3,3,H
1922-02-25,1921,Newcastle United,Blackburn Rovers,2-0,2,0,1,1,2,2,H
1922-02-25,1921,Preston North End,West Bromwich Albion,0-3,0,3,1,1,3,-3,A
1922-02-25,1921,Sheffield United,Oldham Athletic,1-0,1,0,1,1,1,1,H
1922-02-25,1921,Tottenham Hotspur,Everton,2-0,2,0,1,1,2,2,H
1922-02-27,1921,Huddersfield Town,Manchester United,1-1,1,1,1,1,2,0,D
1922-02-27,1921,Sheffield United,Blackburn Rovers,0-1,0,1,1,1,1,-1,A
1922-03-01,1921,Everton,Middlesbrough,4-1,4,1,1,1,5,3,H
1922-03-04,1921,Blackburn Rovers,Liverpool,0-0,0,0,1,1,0,0,D
1922-03-04,1921,Bolton Wanderers,Newcastle United,3-2,3,2,1,1,5,1,H
1922-03-04,1921,Everton,Bradford City,2-0,2,0,1,1,2,2,H
1922-03-04,1921,Oldham Athletic,Burnley,0-1,0,1,1,1,1,-1,A
1922-03-04,1921,Sunderland,Sheffield United,1-0,1,0,1,1,1,1,H
1922-03-04,1921,West Bromwich Albion,Chelsea,2-2,2,2,1,1,4,0,D
1922-03-06,1921,Blackburn Rovers,Newcastle United,0-2,0,2,1,1,2,-2,A
1922-03-08,1921,Bradford City,West Bromwich Albion,1-1,1,1,1,1,2,0,D
1922-03-11,1921,Aston Villa,Birmingham City,1-1,1,1,1,1,2,0,D
1922-03-11,1921,Bradford City,Everton,3-1,3,1,1,1,4,2,H
1922-03-11,1921,Burnley,Oldham Athletic,0-1,0,1,1,1,1,-1,A
1922-03-11,1921,Chelsea,West Bromwich Albion,1-1,1,1,1,1,2,0,D
1922-03-11,1921,Liverpool,Blackburn Rovers,2-0,2,0,1,1,2,2,H
1922-03-11,1921,Manchester United,Arsenal,1-0,1,0,1,1,1,1,H
1922-03-11,1921,Middlesbrough,Huddersfield Town,5-1,5,1,1,1,6,4,H
1922-03-11,1921,Newcastle United,Bolton Wanderers,2-1,2,1,1,1,3,1,H
1922-03-11,1921,Preston North End,Manchester City,1-0,1,0,1,1,1,1,H
1922-03-11,1921,Sheffield United,Cardiff City,0-2,0,2,1,1,2,-2,A
1922-03-11,1921,Tottenham Hotspur,Sunderland,1-0,1,0,1,1,1,1,H
1922-03-15,1921,Birmingham City,Aston Villa,1-0,1,0,1,1,1,1,H
1922-03-15,1921,Bradford City,Cardiff City,1-0,1,0,1,1,1,1,H
1922-03-15,1921,Everton,Tottenham Hotspur,0-0,0,0,1,1,0,0,D
1922-03-18,1921,Aston Villa,Arsenal,2-0,2,0,1,1,2,2,H
1922-03-18,1921,Bradford City,Sunderland,0-0,0,0,1,1,0,0,D
1922-03-18,1921,Burnley,Cardiff City,1-1,1,1,1,1,2,0,D
1922-03-18,1921,Chelsea,Manchester City,0-0,0,0,1,1,0,0,D
1922-03-18,1921,Liverpool,Bolton Wanderers,0-2,0,2,1,1,2,-2,A
1922-03-18,1921,Manchester United,Blackburn Rovers,0-1,0,1,1,1,1,-1,A
1922-03-18,1921,Middlesbrough,Birmingham City,1-1,1,1,1,1,2,0,D
1922-03-18,1921,Newcastle United,Oldham Athletic,1-1,1,1,1,1,2,0,D
1922-03-18,1921,Preston North End,Everton,1-0,1,0,1,1,1,1,H
1922-03-18,1921,Sheffield United,West Bromwich Albion,0-0,0,0,1,1,0,0,D
1922-03-18,1921,Tottenham Hotspur,Huddersfield Town,1-0,1,0,1,1,1,1,H
1922-03-22,1921,Arsenal,Liverpool,1-0,1,0,1,1,1,1,H
1922-03-25,1921,Arsenal,Aston Villa,2-0,2,0,1,1,2,2,H
1922-03-25,1921,Birmingham City,Middlesbrough,4-3,4,3,1,1,7,1,H
1922-03-25,1921,Blackburn Rovers,Manchester United,3-0,3,0,1,1,3,3,H
1922-03-25,1921,Bolton Wanderers,Liverpool,1-3,1,3,1,1,4,-2,A
1922-03-25,1921,Cardiff City,Burnley,4-2,4,2,1,1,6,2,H
1922-03-25,1921,Manchester City,Chelsea,0-0,0,0,1,1,0,0,D
1922-03-25,1921,Oldham Athletic,Newcastle United,0-0,0,0,1,1,0,0,D
1922-03-25,1921,Sunderland,Bradford City,0-0,0,0,1,1,0,0,D
1922-03-25,1921,West Bromwich Albion,Sheffield United,3-0,3,0,1,1,3,3,H
1922-03-27,1921,Huddersfield Town,Tottenham Hotspur,1-1,1,1,1,1,2,0,D
1922-03-29,1921,West Bromwich Albion,Preston North End,2-0,2,0,1,1,2,2,H
1922-04-01,1921,Arsenal,Middlesbrough,2-2,2,2,1,1,4,0,D
1922-04-01,1921,Birmingham City,Tottenham Hotspur,0-3,0,3,1,1,3,-3,A
1922-04-01,1921,Blackburn Rovers,Aston Villa,1-2,1,2,1,1,3,-1,A
1922-04-01,1921,Bradford City,Huddersfield Town,4-0,4,0,1,1,4,4,H
1922-04-01,1921,Chelsea,Everton,1-0,1,0,1,1,1,1,H
1922-04-01,1921,Liverpool,Oldham Athletic,2-0,2,0,1,1,2,2,H
1922-04-01,1921,Manchester United,Bolton Wanderers,0-1,0,1,1,1,1,-1,A
1922-04-01,1921,Newcastle United,Cardiff City,0-0,0,0,1,1,0,0,D
1922-04-01,1921,Preston North End,Sunderland,1-1,1,1,1,1,2,0,D
1922-04-01,1921,Sheffield United,Manchester City,1-0,1,0,1,1,1,1,H
1922-04-01,1921,West Bromwich Albion,Burnley,2-0,2,0,1,1,2,2,H
1922-04-05,1921,Arsenal,Manchester United,3-1,3,1,1,1,4,2,H
1922-04-05,1921,Huddersfield Town,Aston Villa,1-0,1,0,1,1,1,1,H
1922-04-05,1921,Manchester City,Preston North End,2-0,2,0,1,1,2,2,H
1922-04-05,1921,Sunderland,Tottenham Hotspur,2-0,2,0,1,1,2,2,H
1922-04-08,1921,Bolton Wanderers,Manchester United,1-0,1,0,1,1,1,1,H
1922-04-08,1921,Burnley,West Bromwich Albion,4-2,4,2,1,1,6,2,H
1922-04-08,1921,Cardiff City,Newcastle United,1-0,1,0,1,1,1,1,H
1922-04-08,1921,Everton,Chelsea,2-3,2,3,1,1,5,-1,A
1922-04-08,1921,Huddersfield Town,Bradford City,1-2,1,2,1,1,3,-1,A
1922-04-08,1921,Manchester City,Sheffield United,2-2,2,2,1,1,4,0,D
1922-04-08,1921,Middlesbrough,Arsenal,4-2,4,2,1,1,6,2,H
1922-04-08,1921,Oldham Athletic,Liverpool,4-0,4,0,1,1,4,4,H
1922-04-08,1921,Sunderland,Preston North End,1-0,1,0,1,1,1,1,H
1922-04-08,1921,Tottenham Hotspur,Birmingham City,2-1,2,1,1,1,3,1,H
1922-04-10,1921,Chelsea,Huddersfield Town,1-0,1,0,1,1,1,1,H
1922-04-10,1921,Everton,Preston North End,0-0,0,0,1,1,0,0,D
1922-04-14,1921,Burnley,Liverpool,1-1,1,1,1,1,2,0,D
1922-04-14,1921,Chelsea,Aston Villa,1-0,1,0,1,1,1,1,H
1922-04-14,1921,Everton,Huddersfield Town,6-2,6,2,1,1,8,4,H
1922-04-14,1921,Manchester City,Birmingham City,1-0,1,0,1,1,1,1,H
1922-04-14,1921,Newcastle United,Bradford City,1-2,1,2,1,1,3,-1,A
1922-04-14,1921,Preston North End,Middlesbrough,1-1,1,1,1,1,2,0,D
1922-04-14,1921,Sunderland,Bolton Wanderers,6-2,6,2,1,1,8,4,H
1922-04-14,1921,Tottenham Hotspur,Oldham Athletic,3-1,3,1,1,1,4,2,H
1922-04-15,1921,Aston Villa,Bolton Wanderers,2-1,2,1,1,1,3,1,H
1922-04-15,1921,Bradford City,Birmingham City,1-2,1,2,1,1,3,-1,A
1922-04-15,1921,Burnley,Manchester City,5-2,5,2,1,1,7,3,H
1922-04-15,1921,Chelsea,Sunderland,1-0,1,0,1,1,1,1,H
1922-04-15,1921,Liverpool,Cardiff City,5-1,5,1,1,1,6,4,H
1922-04-15,1921,Manchester United,Oldham Athletic,0-3,0,3,1,1,3,-3,A
1922-04-15,1921,Middlesbrough,Blackburn Rovers,0-1,0,1,1,1,1,-1,A
1922-04-15,1921,Newcastle United,West Bromwich Albion,3-0,3,0,1,1,3,3,H
1922-04-15,1921,Preston North End,Huddersfield Town,1-1,1,1,1,1,2,0,D
1922-04-15,1921,Sheffield United,Everton,1-0,1,0,1,1,1,1,H
1922-04-15,1921,Tottenham Hotspur,Arsenal,2-0,2,0,1,1,2,2,H
1922-04-17,1921,Aston Villa,Chelsea,1-4,1,4,1,1,5,-3,A
1922-04-17,1921,Bolton Wanderers,Sunderland,1-1,1,1,1,1,2,0,D
1922-04-17,1921,Bradford City,Newcastle United,2-3,2,3,1,1,5,-1,A
1922-04-17,1921,Cardiff City,Blackburn Rovers,1-3,1,3,1,1,4,-2,A
1922-04-17,1921,Liverpool,Burnley,2-1,2,1,1,1,3,1,H
1922-04-17,1921,Manchester United,Sheffield United,3-2,3,2,1,1,5,1,H
1922-04-17,1921,Middlesbrough,Preston North End,1-0,1,0,1,1,1,1,H
1922-04-17,1921,Oldham Athletic,Tottenham Hotspur,1-0,1,0,1,1,1,1,H
1922-04-17,1921,West Bromwich Albion,Arsenal,0-3,0,3,1,1,3,-3,A
1922-04-18,1921,Arsenal,West Bromwich Albion,2-2,2,2,1,1,4,0,D
1922-04-18,1921,Birmingham City,Manchester City,3-1,3,1,1,1,4,2,H
1922-04-18,1921,Huddersfield Town,Everton,1-2,1,2,1,1,3,-1,A
1922-04-22,1921,Arsenal,Tottenham Hotspur,1-0,1,0,1,1,1,1,H
1922-04-22,1921,Birmingham City,Bradford City,1-0,1,0,1,1,1,1,H
1922-04-22,1921,Blackburn Rovers,Middlesbrough,2-2,2,2,1,1,4,0,D
1922-04-22,1921,Bolton Wanderers,Aston Villa,1-0,1,0,1,1,1,1,H
1922-04-22,1921,Cardiff City,Liverpool,2-0,2,0,1,1,2,2,H
1922-04-22,1921,Everton,Sheffield United,1-1,1,1,1,1,2,0,D
1922-04-22,1921,Huddersfield Town,Preston North End,6-0,6,0,1,1,6,6,H
1922-04-22,1921,Manchester City,Burnley,2-0,2,0,1,1,2,2,H
1922-04-22,1921,Oldham Athletic,Manchester United,1-1,1,1,1,1,2,0,D
1922-04-22,1921,Sunderland,Chelsea,1-2,1,2,1,1,3,-1,A
1922-04-22,1921,West Bromwich Albion,Newcastle United,1-2,1,2,1,1,3,-1,A
1922-04-26,1921,Cardiff City,Sheffield United,1-1,1,1,1,1,2,0,D
1922-04-29,1921,Aston Villa,Oldham Athletic,2-0,2,0,1,1,2,2,H
1922-04-29,1921,Bradford City,Arsenal,0-2,0,2,1,1,2,-2,A
1922-04-29,1921,Burnley,Everton,2-0,2,0,1,1,2,2,H
1922-04-29,1921,Liverpool,West Bromwich Albion,1-2,1,2,1,1,3,-1,A
1922-04-29,1921,Manchester United,Cardiff City,1-1,1,1,1,1,2,0,D
1922-04-29,1921,Middlesbrough,Bolton Wanderers,4-2,4,2,1,1,6,2,H
1922-04-29,1921,Newcastle United,Manchester City,5-1,5,1,1,1,6,4,H
1922-04-29,1921,Sheffield United,Sunderland,4-1,4,1,1,1,5,3,H
1922-04-29,1921,Tottenham Hotspur,Blackburn Rovers,2-1,2,1,1,1,3,1,H
1922-05-01,1921,Huddersfield Town,Middlesbrough,2-1,2,1,1,1,3,1,H
1922-05-01,1921,Preston North End,Birmingham City,2-2,2,2,1,1,4,0,D
1922-05-06,1921,Arsenal,Bradford City,1-0,1,0,1,1,1,1,H
1922-05-06,1921,Birmingham City,Preston North End,0-2,0,2,1,1,2,-2,A
1922-05-06,1921,Blackburn Rovers,Tottenham Hotspur,1-1,1,1,1,1,2,0,D
1922-05-06,1921,Bolton Wanderers,Middlesbrough,4-2,4,2,1,1,6,2,H
1922-05-06,1921,Cardiff City,Manchester United,3-1,3,1,1,1,4,2,H
1922-05-06,1921,Everton,Burnley,2-0,2,0,1,1,2,2,H
1922-05-06,1921,Huddersfield Town,Chelsea,2-0,2,0,1,1,2,2,H
1922-05-06,1921,Manchester City,Newcastle United,1-0,1,0,1,1,1,1,H
1922-05-06,1921,Oldham Athletic,Aston Villa,3-1,3,1,1,1,4,2,H
1922-05-06,1921,West Bromwich Albion,Liverpool,1-4,1,4,1,1,5,-3,A
1922-08-26,1922,Aston Villa,Blackburn Rovers,2-0,2,0,1,1,2,2,H
1922-08-26,1922,Burnley,West Bromwich Albion,3-0,3,0,1,1,3,3,H
1922-08-26,1922,Chelsea,Birmingham City,1-1,1,1,1,1,2,0,D
1922-08-26,1922,Liverpool,Arsenal,5-2,5,2,1,1,7,3,H
1922-08-26,1922,Middlesbrough,Huddersfield Town,2-2,2,2,1,1,4,0,D
1922-08-26,1922,Newcastle United,Everton,2-0,2,0,1,1,2,2,H
1922-08-26,1922,Nottingham Forest,Sunderland,1-0,1,0,1,1,1,1,H
1922-08-26,1922,Oldham Athletic,Stoke City,4-1,4,1,1,1,5,3,H
1922-08-26,1922,Preston North End,Bolton Wanderers,3-1,3,1,1,1,4,2,H
1922-08-26,1922,Sheffield United,Manchester City,2-0,2,0,1,1,2,2,H
1922-08-26,1922,Tottenham Hotspur,Cardiff City,1-1,1,1,1,1,2,0,D
1922-08-28,1922,Arsenal,Burnley,1-1,1,1,1,1,2,0,D
1922-08-28,1922,Birmingham City,Newcastle United,0-2,0,2,1,1,2,-2,A
1922-08-28,1922,Cardiff City,Aston Villa,3-0,3,0,1,1,3,3,H
1922-08-28,1922,Huddersfield Town,Nottingham Forest,2-1,2,1,1,1,3,1,H
1922-08-28,1922,Manchester City,Middlesbrough,2-1,2,1,1,1,3,1,H
1922-08-28,1922,Stoke City,Chelsea,1-2,1,2,1,1,3,-1,A
1922-08-28,1922,West Bromwich Albion,Preston North End,2-2,2,2,1,1,4,0,D
1922-08-30,1922,Sunderland,Liverpool,1-0,1,0,1,1,1,1,H
1922-09-02,1922,Arsenal,Liverpool,1-0,1,0,1,1,1,1,H
1922-09-02,1922,Birmingham City,Chelsea,0-1,0,1,1,1,1,-1,A
1922-09-02,1922,Blackburn Rovers,Aston Villa,4-2,4,2,1,1,6,2,H
1922-09-02,1922,Bolton Wanderers,Preston North End,1-1,1,1,1,1,2,0,D
1922-09-02,1922,Cardiff City,Tottenham Hotspur,2-3,2,3,1,1,5,-1,A
1922-09-02,1922,Everton,Newcastle United,3-2,3,2,1,1,5,1,H
1922-09-02,1922,Huddersfield Town,Middlesbrough,0-2,0,2,1,1,2,-2,A
1922-09-02,1922,Manchester City,Sheffield United,3-3,3,3,1,1,6,0,D
1922-09-02,1922,Stoke City,Oldham Athletic,2-2,2,2,1,1,4,0,D
1922-09-02,1922,Sunderland,Nottingham Forest,0-0,0,0,1,1,0,0,D
1922-09-02,1922,West Bromwich Albion,Burnley,2-1,2,1,1,1,3,1,H
1922-09-04,1922,Aston Villa,Cardiff City,1-3,1,3,1,1,4,-2,A
1922-09-04,1922,Bolton Wanderers,Oldham Athletic,3-1,3,1,1,1,4,2,H
1922-09-04,1922,Burnley,Arsenal,4-1,4,1,1,1,5,3,H
1922-09-04,1922,Chelsea,Stoke City,3-2,3,2,1,1,5,1,H
1922-09-04,1922,Middlesbrough,Manchester City,5-0,5,0,1,1,5,5,H
1922-09-04,1922,Nottingham Forest,Huddersfield Town,0-1,0,1,1,1,1,-1,A
1922-09-04,1922,Preston North End,West Bromwich Albion,0-0,0,0,1,1,0,0,D
1922-09-04,1922,Sheffield United,Blackburn Rovers,1-1,1,1,1,1,2,0,D
1922-09-04,1922,Tottenham Hotspur,Everton,2-0,2,0,1,1,2,2,H
1922-09-06,1922,Liverpool,Sunderland,5-1,5,1,1,1,6,4,H
1922-09-06,1922,Newcastle United,Birmingham City,0-0,0,0,1,1,0,0,D
1922-09-09,1922,Aston Villa,West Bromwich Albion,2-0,2,0,1,1,2,2,H
1922-09-09,1922,Bolton Wanderers,Sunderland,1-1,1,1,1,1,2,0,D
1922-09-09,1922,Cardiff City,Arsenal,4-1,4,1,1,1,5,3,H
1922-09-09,1922,Chelsea,Middlesbrough,1-1,1,1,1,1,2,0,D
1922-09-09,1922,Everton,Blackburn Rovers,2-0,2,0,1,1,2,2,H
1922-09-09,1922,Manchester City,Birmingham City,0-1,0,1,1,1,1,-1,A
1922-09-09,1922,Newcastle United,Sheffield United,3-0,3,0,1,1,3,3,H
1922-09-09,1922,Oldham Athletic,Nottingham Forest,2-0,2,0,1,1,2,2,H
1922-09-09,1922,Preston North End,Liverpool,1-3,1,3,1,1,4,-2,A
1922-09-09,1922,Stoke City,Huddersfield Town,2-2,2,2,1,1,4,0,D
1922-09-09,1922,Tottenham Hotspur,Burnley,1-3,1,3,1,1,4,-2,A
1922-09-11,1922,Oldham Athletic,Bolton Wanderers,3-1,3,1,1,1,4,2,H
1922-09-13,1922,Birmingham City,Stoke City,2-0,2,0,1,1,2,2,H
1922-09-16,1922,Arsenal,Cardiff City,2-1,2,1,1,1,3,1,H
1922-09-16,1922,Birmingham City,Manchester City,0-1,0,1,1,1,1,-1,A
1922-09-16,1922,Blackburn Rovers,Everton,5-1,5,1,1,1,6,4,H
1922-09-16,1922,Burnley,Tottenham Hotspur,0-1,0,1,1,1,1,-1,A
1922-09-16,1922,Huddersfield Town,Stoke City,1-0,1,0,1,1,1,1,H
1922-09-16,1922,Liverpool,Preston North End,5-2,5,2,1,1,7,3,H
1922-09-16,1922,Middlesbrough,Chelsea,2-1,2,1,1,1,3,1,H
1922-09-16,1922,Nottingham Forest,Oldham Athletic,1-0,1,0,1,1,1,1,H
1922-09-16,1922,Sheffield United,Newcastle United,2-0,2,0,1,1,2,2,H
1922-09-16,1922,Sunderland,Bolton Wanderers,5-1,5,1,1,1,6,4,H
1922-09-16,1922,West Bromwich Albion,Aston Villa,3-0,3,0,1,1,3,3,H
1922-09-18,1922,Blackburn Rovers,Sheffield United,1-0,1,0,1,1,1,1,H
1922-09-23,1922,Aston Villa,Middlesbrough,2-2,2,2,1,1,4,0,D
1922-09-23,1922,Blackburn Rovers,Sunderland,0-0,0,0,1,1,0,0,D
1922-09-23,1922,Bolton Wanderers,Birmingham City,3-0,3,0,1,1,3,3,H
1922-09-23,1922,Cardiff City,Everton,0-2,0,2,1,1,2,-2,A
1922-09-23,1922,Chelsea,Oldham Athletic,4-0,4,0,1,1,4,4,H
1922-09-23,1922,Liverpool,Burnley,3-0,3,0,1,1,3,3,H
1922-09-23,1922,Manchester City,Huddersfield Town,3-1,3,1,1,1,4,2,H
1922-09-23,1922,Newcastle United,Preston North End,3-1,3,1,1,1,4,2,H
1922-09-23,1922,Nottingham Forest,Sheffield United,1-0,1,0,1,1,1,1,H
1922-09-23,1922,Stoke City,West Bromwich Albion,0-2,0,2,1,1,2,-2,A
1922-09-23,1922,Tottenham Hotspur,Arsenal,1-2,1,2,1,1,3,-1,A
1922-09-30,1922,Arsenal,Tottenham Hotspur,0-2,0,2,1,1,2,-2,A
1922-09-30,1922,Birmingham City,Bolton Wanderers,2-0,2,0,1,1,2,2,H
1922-09-30,1922,Burnley,Liverpool,2-0,2,0,1,1,2,2,H
1922-09-30,1922,Everton,Cardiff City,3-1,3,1,1,1,4,2,H
1922-09-30,1922,Huddersfield Town,Manchester City,0-0,0,0,1,1,0,0,D
1922-09-30,1922,Middlesbrough,Aston Villa,2-2,2,2,1,1,4,0,D
1922-09-30,1922,Oldham Athletic,Chelsea,2-0,2,0,1,1,2,2,H
1922-09-30,1922,Preston North End,Newcastle United,1-0,1,0,1,1,1,1,H
1922-09-30,1922,Sheffield United,Nottingham Forest,0-0,0,0,1,1,0,0,D
1922-09-30,1922,Sunderland,Blackburn Rovers,4-3,4,3,1,1,7,1,H
1922-09-30,1922,West Bromwich Albion,Stoke City,0-1,0,1,1,1,1,-1,A
1922-10-02,1922,Sheffield United,Arsenal,2-1,2,1,1,1,3,1,H
1922-10-05,1922,Nottingham Forest,Bolton Wanderers,1-1,1,1,1,1,2,0,D
1922-10-07,1922,Arsenal,West Bromwich Albion,3-1,3,1,1,1,4,2,H
1922-10-07,1922,Aston Villa,Tottenham Hotspur,2-0,2,0,1,1,2,2,H
1922-10-07,1922,Blackburn Rovers,Birmingham City,1-1,1,1,1,1,2,0,D
1922-10-07,1922,Bolton Wanderers,Huddersfield Town,1-0,1,0,1,1,1,1,H
1922-10-07,1922,Cardiff City,Sunderland,2-4,2,4,1,1,6,-2,A
1922-10-07,1922,Chelsea,Sheffield United,0-0,0,0,1,1,0,0,D
1922-10-07,1922,Liverpool,Everton,5-1,5,1,1,1,6,4,H
1922-10-07,1922,Newcastle United,Burnley,0-2,0,2,1,1,2,-2,A
1922-10-07,1922,Nottingham Forest,Preston North End,3-0,3,0,1,1,3,3,H
1922-10-07,1922,Oldham Athletic,Middlesbrough,0-0,0,0,1,1,0,0,D
1922-10-07,1922,Stoke City,Manchester City,1-1,1,1,1,1,2,0,D
1922-10-14,1922,Birmingham City,Blackburn Rovers,1-1,1,1,1,1,2,0,D
1922-10-14,1922,Burnley,Newcastle United,0-0,0,0,1,1,0,0,D
1922-10-14,1922,Everton,Liverpool,0-1,0,1,1,1,1,-1,A
1922-10-14,1922,Huddersfield Town,Bolton Wanderers,0-2,0,2,1,1,2,-2,A
1922-10-14,1922,Manchester City,Stoke City,2-1,2,1,1,1,3,1,H
1922-10-14,1922,Middlesbrough,Oldham Athletic,2-1,2,1,1,1,3,1,H
1922-10-14,1922,Preston North End,Nottingham Forest,2-2,2,2,1,1,4,0,D
1922-10-14,1922,Sheffield United,Chelsea,0-2,0,2,1,1,2,-2,A
1922-10-14,1922,Sunderland,Cardiff City,2-1,2,1,1,1,3,1,H
1922-10-14,1922,Tottenham Hotspur,Aston Villa,1-2,1,2,1,1,3,-1,A
1922-10-14,1922,West Bromwich Albion,Arsenal,7-0,7,0,1,1,7,7,H
1922-10-21,1922,Aston Villa,Bolton Wanderers,2-0,2,0,1,1,2,2,H
1922-10-21,1922,Burnley,Blackburn Rovers,3-1,3,1,1,1,4,2,H
1922-10-21,1922,Chelsea,Sunderland,1-3,1,3,1,1,4,-2,A
1922-10-21,1922,Liverpool,Cardiff City,3-1,3,1,1,1,4,2,H
1922-10-21,1922,Middlesbrough,Birmingham City,2-1,2,1,1,1,3,1,H
1922-10-21,1922,Newcastle United,Arsenal,1-1,1,1,1,1,2,0,D
1922-10-21,1922,Nottingham Forest,Everton,2-1,2,1,1,1,3,1,H
1922-10-21,1922,Oldham Athletic,Huddersfield Town,0-3,0,3,1,1,3,-3,A
1922-10-21,1922,Preston North End,Manchester City,0-2,0,2,1,1,2,-2,A
1922-10-21,1922,Sheffield United,Stoke City,2-0,2,0,1,1,2,2,H
1922-10-21,1922,Tottenham Hotspur,West Bromwich Albion,3-1,3,1,1,1,4,2,H
1922-10-28,1922,Arsenal,Newcastle United,1-2,1,2,1,1,3,-1,A
1922-10-28,1922,Birmingham City,Middlesbrough,2-0,2,0,1,1,2,2,H
1922-10-28,1922,Blackburn Rovers,Burnley,2-1,2,1,1,1,3,1,H
1922-10-28,1922,Bolton Wanderers,Aston Villa,3-0,3,0,1,1,3,3,H
1922-10-28,1922,Cardiff City,Liverpool,3-0,3,0,1,1,3,3,H
1922-10-28,1922,Everton,Nottingham Forest,4-2,4,2,1,1,6,2,H
1922-10-28,1922,Huddersfield Town,Oldham Athletic,3-0,3,0,1,1,3,3,H
1922-10-28,1922,Manchester City,Preston North End,2-1,2,1,1,1,3,1,H
1922-10-28,1922,Stoke City,Sheffield United,4-0,4,0,1,1,4,4,H
1922-10-28,1922,Sunderland,Chelsea,1-1,1,1,1,1,2,0,D
1922-10-28,1922,West Bromwich Albion,Tottenham Hotspur,5-1,5,1,1,1,6,4,H
1922-11-04,1922,Birmingham City,Cardiff City,0-0,0,0,1,1,0,0,D
1922-11-04,1922,Bolton Wanderers,Stoke City,1-1,1,1,1,1,2,0,D
1922-11-04,1922,Burnley,Nottingham Forest,8-2,8,2,1,1,10,6,H
1922-11-04,1922,Everton,Arsenal,1-0,1,0,1,1,1,1,H
1922-11-04,1922,Huddersfield Town,Blackburn Rovers,0-2,0,2,1,1,2,-2,A
1922-11-04,1922,Middlesbrough,Sheffield United,3-2,3,2,1,1,5,1,H
1922-11-04,1922,Newcastle United,Sunderland,2-1,2,1,1,1,3,1,H
1922-11-04,1922,Oldham Athletic,Aston Villa,0-2,0,2,1,1,2,-2,A
1922-11-04,1922,Preston North End,Chelsea,2-0,2,0,1,1,2,2,H
1922-11-04,1922,Tottenham Hotspur,Liverpool,2-4,2,4,1,1,6,-2,A
1922-11-04,1922,West Bromwich Albion,Manchester City,2-0,2,0,1,1,2,2,H
1922-11-11,1922,Arsenal,Everton,1-2,1,2,1,1,3,-1,A
1922-11-11,1922,Aston Villa,Oldham Athletic,3-0,3,0,1,1,3,3,H
1922-11-11,1922,Blackburn Rovers,Huddersfield Town,0-0,0,0,1,1,0,0,D
1922-11-11,1922,Cardiff City,Birmingham City,1-1,1,1,1,1,2,0,D
1922-11-11,1922,Chelsea,Preston North End,0-1,0,1,1,1,1,-1,A
1922-11-11,1922,Liverpool,Tottenham Hotspur,0-0,0,0,1,1,0,0,D
1922-11-11,1922,Manchester City,West Bromwich Albion,1-1,1,1,1,1,2,0,D
1922-11-11,1922,Nottingham Forest,Burnley,1-0,1,0,1,1,1,1,H
1922-11-11,1922,Sheffield United,Middlesbrough,4-1,4,1,1,1,5,3,H
1922-11-11,1922,Stoke City,Bolton Wanderers,2-0,2,0,1,1,2,2,H
1922-11-11,1922,Sunderland,Newcastle United,2-0,2,0,1,1,2,2,H
1922-11-18,1922,Birmingham City,Nottingham Forest,2-0,2,0,1,1,2,2,H
1922-11-18,1922,Burnley,Chelsea,1-0,1,0,1,1,1,1,H
1922-11-18,1922,Huddersfield Town,Cardiff City,1-0,1,0,1,1,1,1,H
1922-11-18,1922,Liverpool,Aston Villa,3-0,3,0,1,1,3,3,H
1922-11-18,1922,Manchester City,Bolton Wanderers,2-0,2,0,1,1,2,2,H
1922-11-18,1922,Preston North End,Middlesbrough,1-2,1,2,1,1,3,-1,A
1922-11-18,1922,Sheffield United,Oldham Athletic,2-2,2,2,1,1,4,0,D
1922-11-18,1922,Stoke City,Blackburn Rovers,1-1,1,1,1,1,2,0,D
1922-11-18,1922,Sunderland,Arsenal,3-3,3,3,1,1,6,0,D
1922-11-18,1922,Tottenham Hotspur,Newcastle United,0-1,0,1,1,1,1,-1,A
1922-11-18,1922,West Bromwich Albion,Everton,0-0,0,0,1,1,0,0,D
1922-11-25,1922,Arsenal,Sunderland,2-3,2,3,1,1,5,-1,A
1922-11-25,1922,Aston Villa,Liverpool,0-1,0,1,1,1,1,-1,A
1922-11-25,1922,Bolton Wanderers,Manchester City,2-1,2,1,1,1,3,1,H
1922-11-25,1922,Cardiff City,Huddersfield Town,0-1,0,1,1,1,1,-1,A
1922-11-25,1922,Chelsea,Burnley,0-1,0,1,1,1,1,-1,A
1922-11-25,1922,Everton,West Bromwich Albion,0-1,0,1,1,1,1,-1,A
1922-11-25,1922,Middlesbrough,Preston North End,1-1,1,1,1,1,2,0,D
1922-11-25,1922,Newcastle United,Tottenham Hotspur,1-1,1,1,1,1,2,0,D
1922-11-25,1922,Nottingham Forest,Birmingham City,1-1,1,1,1,1,2,0,D
1922-11-25,1922,Oldham Athletic,Sheffield United,0-2,0,2,1,1,2,-2,A
1922-12-02,1922,Birmingham City,Arsenal,3-2,3,2,1,1,5,1,H
1922-12-02,1922,Blackburn Rovers,Manchester City,0-0,0,0,1,1,0,0,D
1922-12-02,1922,Cardiff City,Stoke City,2-1,2,1,1,1,3,1,H
1922-12-02,1922,Chelsea,Huddersfield Town,2-2,2,2,1,1,4,0,D
1922-12-02,1922,Liverpool,Newcastle United,0-2,0,2,1,1,2,-2,A
1922-12-02,1922,Middlesbrough,Burnley,4-1,4,1,1,1,5,3,H
1922-12-02,1922,Preston North End,Oldham Athletic,5-1,5,1,1,1,6,4,H
1922-12-02,1922,Sheffield United,Aston Villa,1-1,1,1,1,1,2,0,D
1922-12-02,1922,Sunderland,Everton,3-1,3,1,1,1,4,2,H
1922-12-02,1922,Tottenham Hotspur,Nottingham Forest,2-1,2,1,1,1,3,1,H
1922-12-02,1922,West Bromwich Albion,Bolton Wanderers,1-1,1,1,1,1,2,0,D
1922-12-09,1922,Arsenal,Birmingham City,1-0,1,0,1,1,1,1,H
1922-12-09,1922,Aston Villa,Sheffield United,0-1,0,1,1,1,1,-1,A
1922-12-09,1922,Bolton Wanderers,West Bromwich Albion,3-0,3,0,1,1,3,3,H
1922-12-09,1922,Burnley,Middlesbrough,3-0,3,0,1,1,3,3,H
1922-12-09,1922,Everton,Sunderland,1-1,1,1,1,1,2,0,D
1922-12-09,1922,Huddersfield Town,Chelsea,3-0,3,0,1,1,3,3,H
1922-12-09,1922,Manchester City,Blackburn Rovers,2-1,2,1,1,1,3,1,H
1922-12-09,1922,Newcastle United,Liverpool,0-1,0,1,1,1,1,-1,A
1922-12-09,1922,Nottingham Forest,Tottenham Hotspur,0-1,0,1,1,1,1,-1,A
1922-12-09,1922,Oldham Athletic,Preston North End,2-1,2,1,1,1,3,1,H
1922-12-09,1922,Stoke City,Cardiff City,3-1,3,1,1,1,4,2,H
1922-12-16,1922,Arsenal,Huddersfield Town,1-1,1,1,1,1,2,0,D
1922-12-16,1922,Aston Villa,Newcastle United,1-1,1,1,1,1,2,0,D
1922-12-16,1922,Birmingham City,Everton,1-1,1,1,1,1,2,0,D
1922-12-16,1922,Blackburn Rovers,Bolton Wanderers,1-0,1,0,1,1,1,1,H
1922-12-16,1922,Burnley,Oldham Athletic,1-1,1,1,1,1,2,0,D
1922-12-16,1922,Cardiff City,Manchester City,3-1,3,1,1,1,4,2,H
1922-12-16,1922,Chelsea,Tottenham Hotspur,0-0,0,0,1,1,0,0,D
1922-12-16,1922,Liverpool,Nottingham Forest,2-1,2,1,1,1,3,1,H
1922-12-16,1922,Middlesbrough,Stoke City,3-1,3,1,1,1,4,2,H
1922-12-16,1922,Sheffield United,Preston North End,2-2,2,2,1,1,4,0,D
1922-12-16,1922,Sunderland,West Bromwich Albion,3-2,3,2,1,1,5,1,H
1922-12-23,1922,Bolton Wanderers,Blackburn Rovers,3-0,3,0,1,1,3,3,H
1922-12-23,1922,Everton,Birmingham City,2-1,2,1,1,1,3,1,H
1922-12-23,1922,Huddersfield Town,Arsenal,4-0,4,0,1,1,4,4,H
1922-12-23,1922,Manchester City,Cardiff City,5-1,5,1,1,1,6,4,H
1922-12-23,1922,Newcastle United,Aston Villa,0-0,0,0,1,1,0,0,D
1922-12-23,1922,Nottingham Forest,Liverpool,1-3,1,3,1,1,4,-2,A
1922-12-23,1922,Oldham Athletic,Burnley,1-1,1,1,1,1,2,0,D
1922-12-23,1922,Preston North End,Sheffield United,2-3,2,3,1,1,5,-1,A
1922-12-23,1922,Stoke City,Middlesbrough,0-0,0,0,1,1,0,0,D
1922-12-23,1922,Tottenham Hotspur,Chelsea,3-1,3,1,1,1,4,2,H
1922-12-23,1922,West Bromwich Albion,Sunderland,1-1,1,1,1,1,2,0,D
1922-12-25,1922,Birmingham City,Huddersfield Town,0-0,0,0,1,1,0,0,D
1922-12-25,1922,Blackburn Rovers,Preston North End,1-1,1,1,1,1,2,0,D
1922-12-25,1922,Bolton Wanderers,Arsenal,4-1,4,1,1,1,5,3,H
1922-12-25,1922,Burnley,Aston Villa,1-1,1,1,1,1,2,0,D
1922-12-25,1922,Chelsea,Nottingham Forest,2-2,2,2,1,1,4,0,D
1922-12-25,1922,Everton,Manchester City,0-0,0,0,1,1,0,0,D
1922-12-25,1922,Newcastle United,Middlesbrough,1-1,1,1,1,1,2,0,D
1922-12-25,1922,Oldham Athletic,Liverpool,0-2,0,2,1,1,2,-2,A
1922-12-25,1922,Tottenham Hotspur,Sheffield United,2-1,2,1,1,1,3,1,H
1922-12-26,1922,Arsenal,Bolton Wanderers,5-0,5,0,1,1,5,5,H
1922-12-26,1922,Aston Villa,Burnley,3-1,3,1,1,1,4,2,H
1922-12-26,1922,Cardiff City,West Bromwich Albion,3-0,3,0,1,1,3,3,H
1922-12-26,1922,Huddersfield Town,Birmingham City,4-0,4,0,1,1,4,4,H
1922-12-26,1922,Liverpool,Oldham Athletic,2-1,2,1,1,1,3,1,H
1922-12-26,1922,Manchester City,Everton,2-1,2,1,1,1,3,1,H
1922-12-26,1922,Middlesbrough,Newcastle United,1-1,1,1,1,1,2,0,D
1922-12-26,1922,Nottingham Forest,Chelsea,0-4,0,4,1,1,4,-4,A
1922-12-26,1922,Preston North End,Blackburn Rovers,1-0,1,0,1,1,1,1,H
1922-12-26,1922,Sheffield United,Tottenham Hotspur,2-0,2,0,1,1,2,2,H
1922-12-26,1922,Stoke City,Sunderland,1-2,1,2,1,1,3,-1,A
1922-12-27,1922,West Bromwich Albion,Cardiff City,3-0,3,0,1,1,3,3,H
1922-12-30,1922,Arsenal,Stoke City,3-0,3,0,1,1,3,3,H
1922-12-30,1922,Aston Villa,Preston North End,1-0,1,0,1,1,1,1,H
1922-12-30,1922,Blackburn Rovers,West Bromwich Albion,5-1,5,1,1,1,6,4,H
1922-12-30,1922,Bolton Wanderers,Cardiff City,0-0,0,0,1,1,0,0,D
1922-12-30,1922,Chelsea,Liverpool,0-0,0,0,1,1,0,0,D
1922-12-30,1922,Everton,Huddersfield Town,0-3,0,3,1,1,3,-3,A
1922-12-30,1922,Manchester City,Oldham Athletic,3-2,3,2,1,1,5,1,H
1922-12-30,1922,Middlesbrough,Tottenham Hotspur,2-0,2,0,1,1,2,2,H
1922-12-30,1922,Nottingham Forest,Newcastle United,0-1,0,1,1,1,1,-1,A
1922-12-30,1922,Sheffield United,Burnley,2-1,2,1,1,1,3,1,H
1922-12-30,1922,Sunderland,Birmingham City,5-3,5,3,1,1,8,2,H
1923-01-01,1922,Blackburn Rovers,Arsenal,0-5,0,5,1,1,5,-5,A
1923-01-01,1922,Everton,Tottenham Hotspur,3-1,3,1,1,1,4,2,H
1923-01-01,1922,Newcastle United,Oldham Athletic,1-0,1,0,1,1,1,1,H
1923-01-01,1922,Sunderland,Stoke City,2-0,2,0,1,1,2,2,H
1923-01-02,1922,Bolton Wanderers,Nottingham Forest,4-2,4,2,1,1,6,2,H
1923-01-06,1922,Birmingham City,Sunderland,1-2,1,2,1,1,3,-1,A
1923-01-06,1922,Burnley,Sheffield United,1-4,1,4,1,1,5,-3,A
1923-01-06,1922,Cardiff City,Bolton Wanderers,1-0,1,0,1,1,1,1,H
1923-01-06,1922,Huddersfield Town,Everton,1-0,1,0,1,1,1,1,H
1923-01-06,1922,Liverpool,Chelsea,1-0,1,0,1,1,1,1,H
1923-01-06,1922,Newcastle United,Nottingham Forest,1-0,1,0,1,1,1,1,H
1923-01-06,1922,Oldham Athletic,Manchester City,0-3,0,3,1,1,3,-3,A
1923-01-06,1922,Preston North End,Aston Villa,3-2,3,2,1,1,5,1,H
1923-01-06,1922,Stoke City,Arsenal,1-0,1,0,1,1,1,1,H
1923-01-06,1922,Tottenham Hotspur,Middlesbrough,2-0,2,0,1,1,2,2,H
1923-01-06,1922,West Bromwich Albion,Blackburn Rovers,3-0,3,0,1,1,3,3,H
1923-01-20,1922,Arsenal,Manchester City,1-0,1,0,1,1,1,1,H
1923-01-20,1922,Birmingham City,West Bromwich Albion,0-2,0,2,1,1,2,-2,A
1923-01-20,1922,Blackburn Rovers,Cardiff City,3-1,3,1,1,1,4,2,H
1923-01-20,1922,Bolton Wanderers,Sheffield United,1-1,1,1,1,1,2,0,D
1923-01-20,1922,Burnley,Preston North End,2-0,2,0,1,1,2,2,H
1923-01-20,1922,Chelsea,Newcastle United,3-0,3,0,1,1,3,3,H
1923-01-20,1922,Everton,Stoke City,4-0,4,0,1,1,4,4,H
1923-01-20,1922,Middlesbrough,Liverpool,0-2,0,2,1,1,2,-2,A
1923-01-20,1922,Nottingham Forest,Aston Villa,3-1,3,1,1,1,4,2,H
1923-01-20,1922,Oldham Athletic,Tottenham Hotspur,0-3,0,3,1,1,3,-3,A
1923-01-20,1922,Sunderland,Huddersfield Town,1-1,1,1,1,1,2,0,D
1923-01-22,1922,Blackburn Rovers,Stoke City,1-5,1,5,1,1,6,-4,A
1923-01-27,1922,Aston Villa,Nottingham Forest,4-0,4,0,1,1,4,4,H
1923-01-27,1922,Cardiff City,Blackburn Rovers,5-0,5,0,1,1,5,5,H
1923-01-27,1922,Huddersfield Town,Sunderland,0-1,0,1,1,1,1,-1,A
1923-01-27,1922,Liverpool,Middlesbrough,2-0,2,0,1,1,2,2,H
1923-01-27,1922,Manchester City,Arsenal,0-0,0,0,1,1,0,0,D
1923-01-27,1922,Newcastle United,Chelsea,0-0,0,0,1,1,0,0,D
1923-01-27,1922,Preston North End,Burnley,3-1,3,1,1,1,4,2,H
1923-01-27,1922,Sheffield United,Bolton Wanderers,2-2,2,2,1,1,4,0,D
1923-01-27,1922,Stoke City,Everton,4-1,4,1,1,1,5,3,H
1923-01-27,1922,Tottenham Hotspur,Oldham Athletic,3-0,3,0,1,1,3,3,H
1923-01-27,1922,West Bromwich Albion,Birmingham City,1-0,1,0,1,1,1,1,H
1923-02-03,1922,Aston Villa,Manchester City,2-0,2,0,1,1,2,2,H
1923-02-03,1922,Nottingham Forest,Arsenal,2-1,2,1,1,1,3,1,H
1923-02-03,1922,Oldham Athletic,Birmingham City,2-0,2,0,1,1,2,2,H
1923-02-07,1922,Liverpool,West Bromwich Albion,2-0,2,0,1,1,2,2,H
1923-02-08,1922,Preston North End,Stoke City,4-2,4,2,1,1,6,2,H
1923-02-10,1922,Arsenal,Nottingham Forest,2-0,2,0,1,1,2,2,H
1923-02-10,1922,Birmingham City,Oldham Athletic,2-3,2,3,1,1,5,-1,A
1923-02-10,1922,Blackburn Rovers,Tottenham Hotspur,1-0,1,0,1,1,1,1,H
1923-02-10,1922,Bolton Wanderers,Burnley,2-1,2,1,1,1,3,1,H
1923-02-10,1922,Cardiff City,Newcastle United,5-0,5,0,1,1,5,5,H
1923-02-10,1922,Everton,Chelsea,3-1,3,1,1,1,4,2,H
1923-02-10,1922,Huddersfield Town,Sheffield United,2-1,2,1,1,1,3,1,H
1923-02-10,1922,Manchester City,Aston Villa,1-1,1,1,1,1,2,0,D
1923-02-10,1922,Stoke City,Preston North End,4-2,4,2,1,1,6,2,H
1923-02-10,1922,Sunderland,Middlesbrough,2-1,2,1,1,1,3,1,H
1923-02-10,1922,West Bromwich Albion,Liverpool,0-0,0,0,1,1,0,0,D
1923-02-14,1922,Chelsea,Everton,3-1,3,1,1,1,4,2,H
1923-02-14,1922,Newcastle United,West Bromwich Albion,2-0,2,0,1,1,2,2,H
1923-02-14,1922,Tottenham Hotspur,Blackburn Rovers,2-0,2,0,1,1,2,2,H
1923-02-17,1922,Aston Villa,Stoke City,6-0,6,0,1,1,6,6,H
1923-02-17,1922,Burnley,Manchester City,2-0,2,0,1,1,2,2,H
1923-02-17,1922,Chelsea,Arsenal,0-0,0,0,1,1,0,0,D
1923-02-17,1922,Liverpool,Blackburn Rovers,3-0,3,0,1,1,3,3,H
1923-02-17,1922,Middlesbrough,Everton,2-4,2,4,1,1,6,-2,A
1923-02-17,1922,Nottingham Forest,Cardiff City,3-2,3,2,1,1,5,1,H
1923-02-17,1922,Oldham Athletic,Sunderland,0-0,0,0,1,1,0,0,D
1923-02-17,1922,Preston North End,Huddersfield Town,1-0,1,0,1,1,1,1,H
1923-02-17,1922,Sheffield United,Birmingham City,7-1,7,1,1,1,8,6,H
1923-02-17,1922,Tottenham Hotspur,Bolton Wanderers,0-1,0,1,1,1,1,-1,A
1923-02-24,1922,Arsenal,Chelsea,3-1,3,1,1,1,4,2,H
1923-02-24,1922,Manchester City,Burnley,1-0,1,0,1,1,1,1,H
1923-02-24,1922,Stoke City,Aston Villa,1-1,1,1,1,1,2,0,D
1923-02-24,1922,Sunderland,Oldham Athletic,2-0,2,0,1,1,2,2,H
1923-02-28,1922,Everton,Middlesbrough,5-3,5,3,1,1,8,2,H
1923-02-28,1922,Newcastle United,Cardiff City,3-1,3,1,1,1,4,2,H
1923-03-03,1922,Aston Villa,Huddersfield Town,2-1,2,1,1,1,3,1,H
1923-03-03,1922,Burnley,Stoke City,3-2,3,2,1,1,5,1,H
1923-03-03,1922,Chelsea,Cardiff City,1-1,1,1,1,1,2,0,D
1923-03-03,1922,Liverpool,Bolton Wanderers,3-0,3,0,1,1,3,3,H
1923-03-03,1922,Middlesbrough,Arsenal,2-0,2,0,1,1,2,2,H
1923-03-03,1922,Newcastle United,Blackburn Rovers,5-1,5,1,1,1,6,4,H
1923-03-03,1922,Nottingham Forest,West Bromwich Albion,0-4,0,4,1,1,4,-4,A
1923-03-03,1922,Oldham Athletic,Everton,1-0,1,0,1,1,1,1,H
1923-03-03,1922,Preston North End,Birmingham City,2-3,2,3,1,1,5,-1,A
1923-03-03,1922,Sheffield United,Sunderland,3-1,3,1,1,1,4,2,H
1923-03-03,1922,Tottenham Hotspur,Manchester City,3-1,3,1,1,1,4,2,H
1923-03-10,1922,Arsenal,Middlesbrough,3-0,3,0,1,1,3,3,H
1923-03-10,1922,Birmingham City,Preston North End,1-0,1,0,1,1,1,1,H
1923-03-10,1922,Blackburn Rovers,Newcastle United,1-1,1,1,1,1,2,0,D
1923-03-10,1922,Cardiff City,Chelsea,6-1,6,1,1,1,7,5,H
1923-03-10,1922,Everton,Oldham Athletic,0-0,0,0,1,1,0,0,D
1923-03-10,1922,Huddersfield Town,Aston Villa,3-5,3,5,1,1,8,-2,A
1923-03-10,1922,Stoke City,Burnley,0-1,0,1,1,1,1,-1,A
1923-03-10,1922,West Bromwich Albion,Nottingham Forest,0-0,0,0,1,1,0,0,D
1923-03-12,1922,Birmingham City,Sheffield United,4-2,4,2,1,1,6,2,H
1923-03-12,1922,Blackburn Rovers,Liverpool,1-0,1,0,1,1,1,1,H
1923-03-12,1922,Burnley,Bolton Wanderers,2-1,2,1,1,1,3,1,H
1923-03-14,1922,Manchester City,Tottenham Hotspur,3-0,3,0,1,1,3,3,H
1923-03-14,1922,West Bromwich Albion,Newcastle United,2-1,2,1,1,1,3,1,H
1923-03-17,1922,Arsenal,Oldham Athletic,2-0,2,0,1,1,2,2,H
1923-03-17,1922,Birmingham City,Aston Villa,1-0,1,0,1,1,1,1,H
1923-03-17,1922,Blackburn Rovers,Nottingham Forest,2-0,2,0,1,1,2,2,H
1923-03-17,1922,Bolton Wanderers,Newcastle United,1-0,1,0,1,1,1,1,H
1923-03-17,1922,Cardiff City,Middlesbrough,2-0,2,0,1,1,2,2,H
1923-03-17,1922,Everton,Sheffield United,5-1,5,1,1,1,6,4,H
1923-03-17,1922,Huddersfield Town,Burnley,2-0,2,0,1,1,2,2,H
1923-03-17,1922,Manchester City,Liverpool,1-0,1,0,1,1,1,1,H
1923-03-17,1922,Stoke City,Tottenham Hotspur,0-0,0,0,1,1,0,0,D
1923-03-17,1922,Sunderland,Preston North End,2-2,2,2,1,1,4,0,D
1923-03-17,1922,West Bromwich Albion,Chelsea,0-0,0,0,1,1,0,0,D
1923-03-21,1922,Huddersfield Town,Preston North End,2-0,2,0,1,1,2,2,H
1923-03-24,1922,Aston Villa,Birmingham City,3-0,3,0,1,1,3,3,H
1923-03-24,1922,Burnley,Huddersfield Town,0-2,0,2,1,1,2,-2,A
1923-03-24,1922,Liverpool,Manchester City,2-0,2,0,1,1,2,2,H
1923-03-24,1922,Middlesbrough,Cardiff City,0-1,0,1,1,1,1,-1,A
1923-03-24,1922,Nottingham Forest,Blackburn Rovers,1-0,1,0,1,1,1,1,H
1923-03-24,1922,Oldham Athletic,Arsenal,0-0,0,0,1,1,0,0,D
1923-03-24,1922,Preston North End,Sunderland,2-0,2,0,1,1,2,2,H
1923-03-24,1922,Tottenham Hotspur,Stoke City,3-1,3,1,1,1,4,2,H
1923-03-30,1922,Aston Villa,Chelsea,1-0,1,0,1,1,1,1,H
1923-03-30,1922,Bolton Wanderers,Everton,0-2,0,2,1,1,2,-2,A
1923-03-30,1922,Burnley,Cardiff City,1-5,1,5,1,1,6,-4,A
1923-03-30,1922,Liverpool,Sheffield United,2-1,2,1,1,1,3,1,H
1923-03-30,1922,Nottingham Forest,Middlesbrough,2-1,2,1,1,1,3,1,H
1923-03-30,1922,Oldham Athletic,Newcastle United,0-0,0,0,1,1,0,0,D
1923-03-30,1922,Sunderland,Manchester City,2-0,2,0,1,1,2,2,H
1923-03-30,1922,Tottenham Hotspur,Preston North End,1-1,1,1,1,1,2,0,D
1923-03-31,1922,Arsenal,Aston Villa,2-0,2,0,1,1,2,2,H
1923-03-31,1922,Birmingham City,Liverpool,0-1,0,1,1,1,1,-1,A
1923-03-31,1922,Blackburn Rovers,Oldham Athletic,1-0,1,0,1,1,1,1,H
1923-03-31,1922,Bolton Wanderers,Middlesbrough,1-1,1,1,1,1,2,0,D
1923-03-31,1922,Cardiff City,Preston North End,1-0,1,0,1,1,1,1,H
1923-03-31,1922,Everton,Burnley,1-0,1,0,1,1,1,1,H
1923-03-31,1922,Huddersfield Town,Newcastle United,2-0,2,0,1,1,2,2,H
1923-03-31,1922,Manchester City,Chelsea,3-0,3,0,1,1,3,3,H
1923-03-31,1922,Stoke City,Nottingham Forest,0-1,0,1,1,1,1,-1,A
1923-03-31,1922,Sunderland,Tottenham Hotspur,2-0,2,0,1,1,2,2,H
1923-03-31,1922,West Bromwich Albion,Sheffield United,4-0,4,0,1,1,4,4,H
1923-04-02,1922,Arsenal,Blackburn Rovers,1-1,1,1,1,1,2,0,D
1923-04-02,1922,Cardiff City,Burnley,2-2,2,2,1,1,4,0,D
1923-04-02,1922,Chelsea,Aston Villa,1-1,1,1,1,1,2,0,D
1923-04-02,1922,Everton,Bolton Wanderers,1-1,1,1,1,1,2,0,D
1923-04-02,1922,Manchester City,Sunderland,1-0,1,0,1,1,1,1,H
1923-04-02,1922,Middlesbrough,Nottingham Forest,4-0,4,0,1,1,4,4,H
1923-04-02,1922,Preston North End,Tottenham Hotspur,2-0,2,0,1,1,2,2,H
1923-04-02,1922,Sheffield United,Liverpool,4-1,4,1,1,1,5,3,H
1923-04-02,1922,Stoke City,Birmingham City,0-0,0,0,1,1,0,0,D
1923-04-02,1922,West Bromwich Albion,Huddersfield Town,0-2,0,2,1,1,2,-2,A
1923-04-03,1922,Huddersfield Town,West Bromwich Albion,4-1,4,1,1,1,5,3,H
1923-04-07,1922,Aston Villa,Arsenal,1-1,1,1,1,1,2,0,D
1923-04-07,1922,Burnley,Everton,0-1,0,1,1,1,1,-1,A
1923-04-07,1922,Chelsea,Manchester City,1-1,1,1,1,1,2,0,D
1923-04-07,1922,Liverpool,Birmingham City,0-0,0,0,1,1,0,0,D
1923-04-07,1922,Middlesbrough,Bolton Wanderers,1-2,1,2,1,1,3,-1,A
1923-04-07,1922,Newcastle United,Huddersfield Town,1-0,1,0,1,1,1,1,H
1923-04-07,1922,Nottingham Forest,Stoke City,0-1,0,1,1,1,1,-1,A
1923-04-07,1922,Oldham Athletic,Blackburn Rovers,1-0,1,0,1,1,1,1,H
1923-04-07,1922,Preston North End,Cardiff City,3-0,3,0,1,1,3,3,H
1923-04-07,1922,Sheffield United,West Bromwich Albion,3-1,3,1,1,1,4,2,H
1923-04-07,1922,Tottenham Hotspur,Sunderland,0-1,0,1,1,1,1,-1,A
1923-04-09,1922,Sheffield United,Huddersfield Town,0-2,0,2,1,1,2,-2,A
1923-04-11,1922,Bolton Wanderers,Tottenham Hotspur,0-2,0,2,1,1,2,-2,A
1923-04-11,1922,Sunderland,Sheffield United,3-5,3,5,1,1,8,-2,A
1923-04-14,1922,Arsenal,Preston North End,1-1,1,1,1,1,2,0,D
1923-04-14,1922,Birmingham City,Tottenham Hotspur,2-1,2,1,1,1,3,1,H
1923-04-14,1922,Blackburn Rovers,Middlesbrough,2-0,2,0,1,1,2,2,H
1923-04-14,1922,Bolton Wanderers,Chelsea,1-1,1,1,1,1,2,0,D
1923-04-14,1922,Cardiff City,Sheffield United,1-0,1,0,1,1,1,1,H
1923-04-14,1922,Everton,Aston Villa,2-1,2,1,1,1,3,1,H
1923-04-14,1922,Huddersfield Town,Liverpool,0-0,0,0,1,1,0,0,D
1923-04-14,1922,Manchester City,Nottingham Forest,1-1,1,1,1,1,2,0,D
1923-04-14,1922,Stoke City,Newcastle United,1-0,1,0,1,1,1,1,H
1923-04-14,1922,Sunderland,Burnley,3-1,3,1,1,1,4,2,H
1923-04-14,1922,West Bromwich Albion,Oldham Athletic,1-0,1,0,1,1,1,1,H
1923-04-16,1922,Newcastle United,Bolton Wanderers,1-0,1,0,1,1,1,1,H
1923-04-16,1922,Sheffield United,Everton,0-1,0,1,1,1,1,-1,A
1923-04-18,1922,Bolton Wanderers,Liverpool,1-1,1,1,1,1,2,0,D
1923-04-18,1922,Middlesbrough,Sunderland,2-0,2,0,1,1,2,2,H
1923-04-21,1922,Aston Villa,Everton,3-0,3,0,1,1,3,3,H
1923-04-21,1922,Burnley,Sunderland,2-0,2,0,1,1,2,2,H
1923-04-21,1922,Chelsea,Bolton Wanderers,3-0,3,0,1,1,3,3,H
1923-04-21,1922,Liverpool,Huddersfield Town,1-1,1,1,1,1,2,0,D
1923-04-21,1922,Middlesbrough,Blackburn Rovers,1-2,1,2,1,1,3,-1,A
1923-04-21,1922,Newcastle United,Stoke City,1-0,1,0,1,1,1,1,H
1923-04-21,1922,Nottingham Forest,Manchester City,2-0,2,0,1,1,2,2,H
1923-04-21,1922,Oldham Athletic,West Bromwich Albion,0-0,0,0,1,1,0,0,D
1923-04-21,1922,Preston North End,Arsenal,1-2,1,2,1,1,3,-1,A
1923-04-21,1922,Sheffield United,Cardiff City,0-0,0,0,1,1,0,0,D
1923-04-21,1922,Tottenham Hotspur,Birmingham City,2-0,2,0,1,1,2,2,H
1923-04-25,1922,Cardiff City,Nottingham Forest,3-1,3,1,1,1,4,2,H
1923-04-25,1922,Chelsea,West Bromwich Albion,2-2,2,2,1,1,4,0,D
1923-04-28,1922,Arsenal,Sheffield United,2-0,2,0,1,1,2,2,H
1923-04-28,1922,Birmingham City,Burnley,1-0,1,0,1,1,1,1,H
1923-04-28,1922,Blackburn Rovers,Chelsea,0-0,0,0,1,1,0,0,D
1923-04-28,1922,Cardiff City,Oldham Athletic,2-0,2,0,1,1,2,2,H
1923-04-28,1922,Everton,Preston North End,1-0,1,0,1,1,1,1,H
1923-04-28,1922,Huddersfield Town,Tottenham Hotspur,1-0,1,0,1,1,1,1,H
1923-04-28,1922,Manchester City,Newcastle United,0-0,0,0,1,1,0,0,D
1923-04-28,1922,Stoke City,Liverpool,0-0,0,0,1,1,0,0,D
1923-04-28,1922,Sunderland,Aston Villa,2-0,2,0,1,1,2,2,H
1923-04-28,1922,West Bromwich Albion,Middlesbrough,1-0,1,0,1,1,1,1,H
1923-05-05,1922,Aston Villa,Sunderland,1-0,1,0,1,1,1,1,H
1923-05-05,1922,Burnley,Birmingham City,0-2,0,2,1,1,2,-2,A
1923-05-05,1922,Chelsea,Blackburn Rovers,1-1,1,1,1,1,2,0,D
1923-05-05,1922,Liverpool,Stoke City,1-0,1,0,1,1,1,1,H
1923-05-05,1922,Middlesbrough,West Bromwich Albion,0-1,0,1,1,1,1,-1,A
1923-05-05,1922,Newcastle United,Manchester City,3-1,3,1,1,1,4,2,H
1923-05-05,1922,Oldham Athletic,Cardiff City,3-1,3,1,1,1,4,2,H
1923-05-05,1922,Preston North End,Everton,2-2,2,2,1,1,4,0,D
1923-05-05,1922,Tottenham Hotspur,Huddersfield Town,0-0,0,0,1,1,0,0,D
1923-08-25,1923,Arsenal,Newcastle United,1-4,1,4,1,1,5,-3,A
1923-08-25,1923,Birmingham City,Aston Villa,3-0,3,0,1,1,3,3,H
1923-08-25,1923,Blackburn Rovers,Chelsea,3-0,3,0,1,1,3,3,H
1923-08-25,1923,Cardiff City,Bolton Wanderers,3-2,3,2,1,1,5,1,H
1923-08-25,1923,Everton,Nottingham Forest,2-1,2,1,1,1,3,1,H
1923-08-25,1923,Huddersfield Town,Middlesbrough,1-0,1,0,1,1,1,1,H
1923-08-25,1923,Manchester City,Sheffield United,2-1,2,1,1,1,3,1,H
1923-08-25,1923,Notts County,Burnley,2-1,2,1,1,1,3,1,H
1923-08-25,1923,Sunderland,West Ham United,0-0,0,0,1,1,0,0,D
1923-08-25,1923,Tottenham Hotspur,Preston North End,2-0,2,0,1,1,2,2,H
1923-08-25,1923,West Bromwich Albion,Liverpool,2-0,2,0,1,1,2,2,H
1923-08-27,1923,Burnley,Everton,2-2,2,2,1,1,4,0,D
1923-08-27,1923,Cardiff City,Sunderland,2-1,2,1,1,1,3,1,H
1923-08-27,1923,Chelsea,Tottenham Hotspur,0-1,0,1,1,1,1,-1,A
1923-08-27,1923,Nottingham Forest,West Bromwich Albion,1-1,1,1,1,1,2,0,D
1923-08-27,1923,Preston North End,Huddersfield Town,1-3,1,3,1,1,4,-2,A
1923-08-27,1923,Sheffield United,Bolton Wanderers,0-0,0,0,1,1,0,0,D
1923-08-27,1923,West Ham United,Arsenal,1-0,1,0,1,1,1,1,H
1923-08-29,1923,Aston Villa,Manchester City,2-0,2,0,1,1,2,2,H
1923-08-29,1923,Liverpool,Birmingham City,6-2,6,2,1,1,8,4,H
1923-08-29,1923,Middlesbrough,Notts County,2-3,2,3,1,1,5,-1,A
1923-08-29,1923,Newcastle United,Blackburn Rovers,2-1,2,1,1,1,3,1,H
1923-09-01,1923,Aston Villa,Birmingham City,0-0,0,0,1,1,0,0,D
1923-09-01,1923,Bolton Wanderers,Cardiff City,2-2,2,2,1,1,4,0,D
1923-09-01,1923,Burnley,Notts County,1-1,1,1,1,1,2,0,D
1923-09-01,1923,Chelsea,Blackburn Rovers,2-0,2,0,1,1,2,2,H
1923-09-01,1923,Liverpool,West Bromwich Albion,0-0,0,0,1,1,0,0,D
1923-09-01,1923,Middlesbrough,Huddersfield Town,2-0,2,0,1,1,2,2,H
1923-09-01,1923,Newcastle United,Arsenal,1-0,1,0,1,1,1,1,H
1923-09-01,1923,Nottingham Forest,Everton,1-0,1,0,1,1,1,1,H
1923-09-01,1923,Preston North End,Tottenham Hotspur,2-2,2,2,1,1,4,0,D
1923-09-01,1923,Sheffield United,Manchester City,3-0,3,0,1,1,3,3,H
1923-09-01,1923,West Ham United,Sunderland,0-1,0,1,1,1,1,-1,A
1923-09-03,1923,Bolton Wanderers,Sheffield United,4-2,4,2,1,1,6,2,H
1923-09-03,1923,Everton,Burnley,3-3,3,3,1,1,6,0,D
1923-09-03,1923,Tottenham Hotspur,Chelsea,0-1,0,1,1,1,1,-1,A
1923-09-03,1923,West Bromwich Albion,Nottingham Forest,3-2,3,2,1,1,5,1,H
1923-09-04,1923,Huddersfield Town,Preston North End,4-0,4,0,1,1,4,4,H
1923-09-05,1923,Birmingham City,Liverpool,2-1,2,1,1,1,3,1,H
1923-09-05,1923,Manchester City,Aston Villa,1-2,1,2,1,1,3,-1,A
1923-09-05,1923,Sunderland,Cardiff City,0-3,0,3,1,1,3,-3,A
1923-09-08,1923,Birmingham City,Sunderland,0-2,0,2,1,1,2,-2,A
1923-09-08,1923,Burnley,Nottingham Forest,2-4,2,4,1,1,6,-2,A
1923-09-08,1923,Chelsea,Aston Villa,0-0,0,0,1,1,0,0,D
1923-09-08,1923,Everton,Blackburn Rovers,0-0,0,0,1,1,0,0,D
1923-09-08,1923,Manchester City,Bolton Wanderers,1-1,1,1,1,1,2,0,D
1923-09-08,1923,Newcastle United,Sheffield United,2-2,2,2,1,1,4,0,D
1923-09-08,1923,Notts County,Huddersfield Town,1-0,1,0,1,1,1,1,H
1923-09-08,1923,Preston North End,Liverpool,0-1,0,1,1,1,1,-1,A
1923-09-08,1923,Tottenham Hotspur,Middlesbrough,2-1,2,1,1,1,3,1,H
1923-09-08,1923,West Bromwich Albion,Arsenal,4-0,4,0,1,1,4,4,H
1923-09-08,1923,West Ham United,Cardiff City,0-0,0,0,1,1,0,0,D
1923-09-10,1923,Arsenal,West Ham United,4-1,4,1,1,1,5,3,H
1923-09-10,1923,Birmingham City,Bolton Wanderers,0-3,0,3,1,1,3,-3,A
1923-09-12,1923,Aston Villa,Everton,1-1,1,1,1,1,2,0,D
1923-09-12,1923,Newcastle United,Bolton Wanderers,1-0,1,0,1,1,1,1,H
1923-09-15,1923,Arsenal,West Bromwich Albion,1-0,1,0,1,1,1,1,H
1923-09-15,1923,Aston Villa,Chelsea,0-0,0,0,1,1,0,0,D
1923-09-15,1923,Blackburn Rovers,Everton,2-0,2,0,1,1,2,2,H
1923-09-15,1923,Bolton Wanderers,Manchester City,0-0,0,0,1,1,0,0,D
1923-09-15,1923,Cardiff City,West Ham United,1-0,1,0,1,1,1,1,H
1923-09-15,1923,Huddersfield Town,Notts County,0-0,0,0,1,1,0,0,D
1923-09-15,1923,Liverpool,Preston North End,3-1,3,1,1,1,4,2,H
1923-09-15,1923,Middlesbrough,Tottenham Hotspur,0-1,0,1,1,1,1,-1,A
1923-09-15,1923,Nottingham Forest,Burnley,0-0,0,0,1,1,0,0,D
1923-09-15,1923,Sheffield United,Newcastle United,2-1,2,1,1,1,3,1,H
1923-09-15,1923,Sunderland,Birmingham City,1-1,1,1,1,1,2,0,D
1923-09-17,1923,Blackburn Rovers,Newcastle United,2-1,2,1,1,1,3,1,H
1923-09-19,1923,Everton,Aston Villa,2-0,2,0,1,1,2,2,H
1923-09-22,1923,Birmingham City,Arsenal,0-2,0,2,1,1,2,-2,A
1923-09-22,1923,Burnley,Liverpool,2-0,2,0,1,1,2,2,H
1923-09-22,1923,Chelsea,Sheffield United,1-1,1,1,1,1,2,0,D
1923-09-22,1923,Everton,Huddersfield Town,1-1,1,1,1,1,2,0,D
1923-09-22,1923,Manchester City,Sunderland,4-1,4,1,1,1,5,3,H
1923-09-22,1923,Newcastle United,Cardiff City,1-1,1,1,1,1,2,0,D
1923-09-22,1923,Notts County,Nottingham Forest,2-1,2,1,1,1,3,1,H
1923-09-22,1923,Preston North End,Aston Villa,2-2,2,2,1,1,4,0,D
1923-09-22,1923,Tottenham Hotspur,Bolton Wanderers,0-0,0,0,1,1,0,0,D
1923-09-22,1923,West Bromwich Albion,Blackburn Rovers,3-3,3,3,1,1,6,0,D
1923-09-22,1923,West Ham United,Middlesbrough,1-1,1,1,1,1,2,0,D
1923-09-29,1923,Arsenal,Birmingham City,0-0,0,0,1,1,0,0,D
1923-09-29,1923,Aston Villa,Preston North End,5-1,5,1,1,1,6,4,H
1923-09-29,1923,Blackburn Rovers,West Bromwich Albion,4-0,4,0,1,1,4,4,H
1923-09-29,1923,Bolton Wanderers,Tottenham Hotspur,3-1,3,1,1,1,4,2,H
1923-09-29,1923,Cardiff City,Newcastle United,1-0,1,0,1,1,1,1,H
1923-09-29,1923,Huddersfield Town,Everton,2-0,2,0,1,1,2,2,H
1923-09-29,1923,Liverpool,Burnley,1-0,1,0,1,1,1,1,H
1923-09-29,1923,Middlesbrough,West Ham United,0-1,0,1,1,1,1,-1,A
1923-09-29,1923,Nottingham Forest,Notts County,1-0,1,0,1,1,1,1,H
1923-09-29,1923,Sheffield United,Chelsea,1-0,1,0,1,1,1,1,H
1923-09-29,1923,Sunderland,Manchester City,5-2,5,2,1,1,7,3,H
1923-10-04,1923,Notts County,Middlesbrough,1-0,1,0,1,1,1,1,H
1923-10-06,1923,Birmingham City,Blackburn Rovers,1-1,1,1,1,1,2,0,D
1923-10-06,1923,Burnley,Aston Villa,1-2,1,2,1,1,3,-1,A
1923-10-06,1923,Chelsea,Cardiff City,1-2,1,2,1,1,3,-1,A
1923-10-06,1923,Everton,Liverpool,1-0,1,0,1,1,1,1,H
1923-10-06,1923,Manchester City,Arsenal,1-0,1,0,1,1,1,1,H
1923-10-06,1923,Middlesbrough,Nottingham Forest,5-2,5,2,1,1,7,3,H
1923-10-06,1923,Notts County,Tottenham Hotspur,0-0,0,0,1,1,0,0,D
1923-10-06,1923,Preston North End,Sheffield United,1-1,1,1,1,1,2,0,D
1923-10-06,1923,Sunderland,Bolton Wanderers,2-2,2,2,1,1,4,0,D
1923-10-06,1923,West Bromwich Albion,Huddersfield Town,2-4,2,4,1,1,6,-2,A
1923-10-06,1923,West Ham United,Newcastle United,1-0,1,0,1,1,1,1,H
1923-10-13,1923,Arsenal,Manchester City,1-2,1,2,1,1,3,-1,A
1923-10-13,1923,Aston Villa,Burnley,1-1,1,1,1,1,2,0,D
1923-10-13,1923,Blackburn Rovers,Birmingham City,4-1,4,1,1,1,5,3,H
1923-10-13,1923,Bolton Wanderers,Sunderland,1-0,1,0,1,1,1,1,H
1923-10-13,1923,Cardiff City,Chelsea,1-1,1,1,1,1,2,0,D
1923-10-13,1923,Huddersfield Town,West Bromwich Albion,0-0,0,0,1,1,0,0,D
1923-10-13,1923,Liverpool,Everton,1-2,1,2,1,1,3,-1,A
1923-10-13,1923,Newcastle United,West Ham United,0-0,0,0,1,1,0,0,D
1923-10-13,1923,Nottingham Forest,Middlesbrough,3-1,3,1,1,1,4,2,H
1923-10-13,1923,Sheffield United,Preston North End,4-0,4,0,1,1,4,4,H
1923-10-13,1923,Tottenham Hotspur,Notts County,1-3,1,3,1,1,4,-2,A
1923-10-17,1923,Sunderland,Chelsea,2-0,2,0,1,1,2,2,H
1923-10-20,1923,Birmingham City,Huddersfield Town,0-1,0,1,1,1,1,-1,A
1923-10-20,1923,Blackburn Rovers,Manchester City,0-1,0,1,1,1,1,-1,A
1923-10-20,1923,Bolton Wanderers,Arsenal,1-2,1,2,1,1,3,-1,A
1923-10-20,1923,Cardiff City,Preston North End,1-1,1,1,1,1,2,0,D
1923-10-20,1923,Chelsea,West Ham United,0-0,0,0,1,1,0,0,D
1923-10-20,1923,Liverpool,Nottingham Forest,4-2,4,2,1,1,6,2,H
1923-10-20,1923,Middlesbrough,Newcastle United,1-0,1,0,1,1,1,1,H
1923-10-20,1923,Notts County,Everton,1-1,1,1,1,1,2,0,D
1923-10-20,1923,Sheffield United,Burnley,2-1,2,1,1,1,3,1,H
1923-10-20,1923,Sunderland,Tottenham Hotspur,1-0,1,0,1,1,1,1,H
1923-10-20,1923,West Bromwich Albion,Aston Villa,1-0,1,0,1,1,1,1,H
1923-10-27,1923,Arsenal,Bolton Wanderers,0-0,0,0,1,1,0,0,D
1923-10-27,1923,Aston Villa,West Bromwich Albion,4-0,4,0,1,1,4,4,H
1923-10-27,1923,Burnley,Sheffield United,2-0,2,0,1,1,2,2,H
1923-10-27,1923,Everton,Notts County,3-0,3,0,1,1,3,3,H
1923-10-27,1923,Huddersfield Town,Birmingham City,1-0,1,0,1,1,1,1,H
1923-10-27,1923,Manchester City,Blackburn Rovers,3-1,3,1,1,1,4,2,H
1923-10-27,1923,Newcastle United,Middlesbrough,3-2,3,2,1,1,5,1,H
1923-10-27,1923,Nottingham Forest,Liverpool,0-1,0,1,1,1,1,-1,A
1923-10-27,1923,Preston North End,Cardiff City,3-1,3,1,1,1,4,2,H
1923-10-27,1923,Tottenham Hotspur,Sunderland,1-1,1,1,1,1,2,0,D
1923-10-27,1923,West Ham United,Chelsea,2-0,2,0,1,1,2,2,H
1923-11-03,1923,Arsenal,Middlesbrough,2-1,2,1,1,1,3,1,H
1923-11-03,1923,Aston Villa,Notts County,0-0,0,0,1,1,0,0,D
1923-11-03,1923,Blackburn Rovers,Burnley,1-1,1,1,1,1,2,0,D
1923-11-03,1923,Cardiff City,West Bromwich Albion,3-0,3,0,1,1,3,3,H
1923-11-03,1923,Chelsea,Bolton Wanderers,0-0,0,0,1,1,0,0,D
1923-11-03,1923,Liverpool,Huddersfield Town,1-1,1,1,1,1,2,0,D
1923-11-03,1923,Manchester City,Newcastle United,1-1,1,1,1,1,2,0,D
1923-11-03,1923,Nottingham Forest,Tottenham Hotspur,0-0,0,0,1,1,0,0,D
1923-11-03,1923,Sheffield United,Everton,4-0,4,0,1,1,4,4,H
1923-11-03,1923,Sunderland,Preston North End,2-1,2,1,1,1,3,1,H
1923-11-03,1923,West Ham United,Birmingham City,4-1,4,1,1,1,5,3,H
1923-11-10,1923,Birmingham City,West Ham United,2-0,2,0,1,1,2,2,H
1923-11-10,1923,Bolton Wanderers,Chelsea,4-0,4,0,1,1,4,4,H
1923-11-10,1923,Burnley,Blackburn Rovers,1-2,1,2,1,1,3,-1,A
1923-11-10,1923,Everton,Sheffield United,2-0,2,0,1,1,2,2,H
1923-11-10,1923,Huddersfield Town,Liverpool,3-1,3,1,1,1,4,2,H
1923-11-10,1923,Middlesbrough,Arsenal,0-0,0,0,1,1,0,0,D
1923-11-10,1923,Newcastle United,Manchester City,4-1,4,1,1,1,5,3,H
1923-11-10,1923,Notts County,Aston Villa,0-1,0,1,1,1,1,-1,A
1923-11-10,1923,Preston North End,Sunderland,1-2,1,2,1,1,3,-1,A
1923-11-10,1923,Tottenham Hotspur,Nottingham Forest,3-0,3,0,1,1,3,3,H
1923-11-10,1923,West Bromwich Albion,Cardiff City,2-4,2,4,1,1,6,-2,A
1923-11-17,1923,Arsenal,Tottenham Hotspur,1-1,1,1,1,1,2,0,D
1923-11-17,1923,Aston Villa,Liverpool,0-0,0,0,1,1,0,0,D
1923-11-17,1923,Birmingham City,Notts County,0-0,0,0,1,1,0,0,D
1923-11-17,1923,Bolton Wanderers,Huddersfield Town,3-1,3,1,1,1,4,2,H
1923-11-17,1923,Burnley,West Ham United,5-1,5,1,1,1,6,4,H
1923-11-17,1923,Everton,West Bromwich Albion,2-0,2,0,1,1,2,2,H
1923-11-17,1923,Manchester City,Cardiff City,1-1,1,1,1,1,2,0,D
1923-11-17,1923,Middlesbrough,Chelsea,2-0,2,0,1,1,2,2,H
1923-11-17,1923,Nottingham Forest,Sheffield United,1-2,1,2,1,1,3,-1,A
1923-11-17,1923,Preston North End,Newcastle United,1-2,1,2,1,1,3,-1,A
1923-11-17,1923,Sunderland,Blackburn Rovers,5-1,5,1,1,1,6,4,H
1923-11-24,1923,Blackburn Rovers,Sunderland,3-2,3,2,1,1,5,1,H
1923-11-24,1923,Cardiff City,Manchester City,1-1,1,1,1,1,2,0,D
1923-11-24,1923,Chelsea,Middlesbrough,2-0,2,0,1,1,2,2,H
1923-11-24,1923,Huddersfield Town,Bolton Wanderers,1-0,1,0,1,1,1,1,H
1923-11-24,1923,Liverpool,Aston Villa,0-1,0,1,1,1,1,-1,A
1923-11-24,1923,Newcastle United,Preston North End,3-1,3,1,1,1,4,2,H
1923-11-24,1923,Notts County,Birmingham City,1-1,1,1,1,1,2,0,D
1923-11-24,1923,Sheffield United,Nottingham Forest,0-0,0,0,1,1,0,0,D
1923-11-24,1923,Tottenham Hotspur,Arsenal,3-0,3,0,1,1,3,3,H
1923-11-24,1923,West Bromwich Albion,Everton,5-0,5,0,1,1,5,5,H
1923-11-24,1923,West Ham United,Burnley,0-0,0,0,1,1,0,0,D
1923-12-01,1923,Arsenal,Blackburn Rovers,2-2,2,2,1,1,4,0,D
1923-12-01,1923,Aston Villa,Middlesbrough,0-0,0,0,1,1,0,0,D
1923-12-01,1923,Bolton Wanderers,West Ham United,1-1,1,1,1,1,2,0,D
1923-12-01,1923,Burnley,Newcastle United,3-2,3,2,1,1,5,1,H
1923-12-01,1923,Everton,Birmingham City,2-0,2,0,1,1,2,2,H
1923-12-01,1923,Manchester City,Notts County,1-0,1,0,1,1,1,1,H
1923-12-01,1923,Nottingham Forest,Cardiff City,0-1,0,1,1,1,1,-1,A
1923-12-01,1923,Preston North End,Chelsea,1-1,1,1,1,1,2,0,D
1923-12-01,1923,Sheffield United,Liverpool,1-1,1,1,1,1,2,0,D
1923-12-01,1923,Sunderland,Huddersfield Town,2-1,2,1,1,1,3,1,H
1923-12-01,1923,Tottenham Hotspur,West Bromwich Albion,0-0,0,0,1,1,0,0,D
1923-12-08,1923,Birmingham City,Everton,0-1,0,1,1,1,1,-1,A
1923-12-08,1923,Blackburn Rovers,Arsenal,2-0,2,0,1,1,2,2,H
1923-12-08,1923,Cardiff City,Nottingham Forest,4-1,4,1,1,1,5,3,H
1923-12-08,1923,Chelsea,Preston North End,1-2,1,2,1,1,3,-1,A
1923-12-08,1923,Huddersfield Town,Sunderland,3-2,3,2,1,1,5,1,H
1923-12-08,1923,Liverpool,Sheffield United,2-3,2,3,1,1,5,-1,A
1923-12-08,1923,Middlesbrough,Aston Villa,0-2,0,2,1,1,2,-2,A
1923-12-08,1923,Newcastle United,Burnley,2-0,2,0,1,1,2,2,H
1923-12-08,1923,Notts County,Manchester City,2-0,2,0,1,1,2,2,H
1923-12-08,1923,West Bromwich Albion,Tottenham Hotspur,4-1,4,1,1,1,5,3,H
1923-12-08,1923,West Ham United,Bolton Wanderers,0-1,0,1,1,1,1,-1,A
1923-12-15,1923,Arsenal,Huddersfield Town,1-3,1,3,1,1,4,-2,A
1923-12-15,1923,Bolton Wanderers,Notts County,7-1,7,1,1,1,8,6,H
1923-12-15,1923,Burnley,Chelsea,2-0,2,0,1,1,2,2,H
1923-12-15,1923,Liverpool,Cardiff City,0-2,0,2,1,1,2,-2,A
1923-12-15,1923,Manchester City,Everton,2-1,2,1,1,1,3,1,H
1923-12-15,1923,Nottingham Forest,West Ham United,2-1,2,1,1,1,3,1,H
1923-12-15,1923,Preston North End,Middlesbrough,4-0,4,0,1,1,4,4,H
1923-12-15,1923,Sheffield United,Aston Villa,2-1,2,1,1,1,3,1,H
1923-12-15,1923,Sunderland,Newcastle United,3-2,3,2,1,1,5,1,H
1923-12-15,1923,Tottenham Hotspur,Blackburn Rovers,2-1,2,1,1,1,3,1,H
1923-12-15,1923,West Bromwich Albion,Birmingham City,0-0,0,0,1,1,0,0,D
1923-12-22,1923,Aston Villa,Sheffield United,2-2,2,2,1,1,4,0,D
1923-12-22,1923,Birmingham City,West Bromwich Albion,0-0,0,0,1,1,0,0,D
1923-12-22,1923,Blackburn Rovers,Tottenham Hotspur,0-1,0,1,1,1,1,-1,A
1923-12-22,1923,Cardiff City,Liverpool,2-0,2,0,1,1,2,2,H
1923-12-22,1923,Chelsea,Burnley,3-2,3,2,1,1,5,1,H
1923-12-22,1923,Everton,Manchester City,6-1,6,1,1,1,7,5,H
1923-12-22,1923,Huddersfield Town,Arsenal,6-1,6,1,1,1,7,5,H
1923-12-22,1923,Middlesbrough,Preston North End,1-2,1,2,1,1,3,-1,A
1923-12-22,1923,Newcastle United,Sunderland,0-2,0,2,1,1,2,-2,A
1923-12-22,1923,Notts County,Bolton Wanderers,1-1,1,1,1,1,2,0,D
1923-12-22,1923,West Ham United,Nottingham Forest,3-2,3,2,1,1,5,1,H
1923-12-25,1923,Aston Villa,West Ham United,1-1,1,1,1,1,2,0,D
1923-12-25,1923,Blackburn Rovers,Preston North End,2-0,2,0,1,1,2,2,H
1923-12-25,1923,Bolton Wanderers,West Bromwich Albion,2-0,2,0,1,1,2,2,H
1923-12-25,1923,Burnley,Middlesbrough,0-0,0,0,1,1,0,0,D
1923-12-25,1923,Liverpool,Newcastle United,0-1,0,1,1,1,1,-1,A
1923-12-25,1923,Nottingham Forest,Chelsea,2-0,2,0,1,1,2,2,H
1923-12-25,1923,Sheffield United,Cardiff City,1-1,1,1,1,1,2,0,D
1923-12-25,1923,Tottenham Hotspur,Huddersfield Town,1-0,1,0,1,1,1,1,H
1923-12-26,1923,Birmingham City,Manchester City,3-0,3,0,1,1,3,3,H
1923-12-26,1923,Cardiff City,Sheffield United,3-1,3,1,1,1,4,2,H
1923-12-26,1923,Chelsea,Nottingham Forest,1-1,1,1,1,1,2,0,D
1923-12-26,1923,Everton,Sunderland,2-3,2,3,1,1,5,-1,A
1923-12-26,1923,Huddersfield Town,Tottenham Hotspur,2-1,2,1,1,1,3,1,H
1923-12-26,1923,Middlesbrough,Burnley,3-0,3,0,1,1,3,3,H
1923-12-26,1923,Newcastle United,Liverpool,2-1,2,1,1,1,3,1,H
1923-12-26,1923,Notts County,Arsenal,1-2,1,2,1,1,3,-1,A
1923-12-26,1923,Preston North End,Blackburn Rovers,0-1,0,1,1,1,1,-1,A
1923-12-26,1923,West Bromwich Albion,Bolton Wanderers,0-5,0,5,1,1,5,-5,A
1923-12-26,1923,West Ham United,Aston Villa,1-0,1,0,1,1,1,1,H
1923-12-27,1923,Arsenal,Notts County,0-0,0,0,1,1,0,0,D
1923-12-29,1923,Arsenal,Chelsea,1-0,1,0,1,1,1,1,H
1923-12-29,1923,Aston Villa,Cardiff City,2-1,2,1,1,1,3,1,H
1923-12-29,1923,Blackburn Rovers,Huddersfield Town,1-0,1,0,1,1,1,1,H
1923-12-29,1923,Bolton Wanderers,Everton,2-0,2,0,1,1,2,2,H
1923-12-29,1923,Burnley,Preston North End,1-0,1,0,1,1,1,1,H
1923-12-29,1923,Liverpool,West Ham United,2-0,2,0,1,1,2,2,H
1923-12-29,1923,Manchester City,West Bromwich Albion,3-3,3,3,1,1,6,0,D
1923-12-29,1923,Nottingham Forest,Newcastle United,0-0,0,0,1,1,0,0,D
1923-12-29,1923,Sheffield United,Middlesbrough,0-1,0,1,1,1,1,-1,A
1923-12-29,1923,Sunderland,Notts County,1-1,1,1,1,1,2,0,D
1923-12-29,1923,Tottenham Hotspur,Birmingham City,1-1,1,1,1,1,2,0,D
1924-01-01,1923,Blackburn Rovers,Notts County,4-1,4,1,1,1,5,3,H
1924-01-01,1923,Bolton Wanderers,Birmingham City,1-1,1,1,1,1,2,0,D
1924-01-01,1923,Liverpool,Chelsea,3-1,3,1,1,1,4,2,H
1924-01-01,1923,Manchester City,Tottenham Hotspur,1-0,1,0,1,1,1,1,H
1924-01-01,1923,Middlesbrough,Cardiff City,0-1,0,1,1,1,1,-1,A
1924-01-01,1923,Newcastle United,Aston Villa,4-1,4,1,1,1,5,3,H
1924-01-01,1923,Sheffield United,West Ham United,0-2,0,2,1,1,2,-2,A
1924-01-01,1923,Sunderland,Everton,3-0,3,0,1,1,3,3,H
1924-01-05,1923,Birmingham City,Tottenham Hotspur,3-2,3,2,1,1,5,1,H
1924-01-05,1923,Cardiff City,Aston Villa,0-2,0,2,1,1,2,-2,A
1924-01-05,1923,Chelsea,Arsenal,0-0,0,0,1,1,0,0,D
1924-01-05,1923,Everton,Bolton Wanderers,2-2,2,2,1,1,4,0,D
1924-01-05,1923,Huddersfield Town,Blackburn Rovers,1-0,1,0,1,1,1,1,H
1924-01-05,1923,Middlesbrough,Sheffield United,0-1,0,1,1,1,1,-1,A
1924-01-05,1923,Newcastle United,Nottingham Forest,4-0,4,0,1,1,4,4,H
1924-01-05,1923,Notts County,Sunderland,1-2,1,2,1,1,3,-1,A
1924-01-05,1923,Preston North End,Burnley,5-0,5,0,1,1,5,5,H
1924-01-05,1923,West Bromwich Albion,Manchester City,2-1,2,1,1,1,3,1,H
1924-01-05,1923,West Ham United,Liverpool,1-0,1,0,1,1,1,1,H
1924-01-19,1923,Arsenal,Cardiff City,1-2,1,2,1,1,3,-1,A
1924-01-19,1923,Birmingham City,Nottingham Forest,0-2,0,2,1,1,2,-2,A
1924-01-19,1923,Blackburn Rovers,West Ham United,0-0,0,0,1,1,0,0,D
1924-01-19,1923,Bolton Wanderers,Aston Villa,1-0,1,0,1,1,1,1,H
1924-01-19,1923,Everton,Middlesbrough,1-0,1,0,1,1,1,1,H
1924-01-19,1923,Huddersfield Town,Chelsea,0-1,0,1,1,1,1,-1,A
1924-01-19,1923,Manchester City,Liverpool,0-1,0,1,1,1,1,-1,A
1924-01-19,1923,Notts County,Preston North End,0-0,0,0,1,1,0,0,D
1924-01-19,1923,Sunderland,Sheffield United,2-2,2,2,1,1,4,0,D
1924-01-19,1923,Tottenham Hotspur,Newcastle United,2-0,2,0,1,1,2,2,H
1924-01-19,1923,West Bromwich Albion,Burnley,0-3,0,3,1,1,3,-3,A
1924-01-26,1923,Aston Villa,Bolton Wanderers,1-0,1,0,1,1,1,1,H
1924-01-26,1923,Burnley,West Bromwich Albion,4-0,4,0,1,1,4,4,H
1924-01-26,1923,Cardiff City,Arsenal,4-0,4,0,1,1,4,4,H
1924-01-26,1923,Chelsea,Huddersfield Town,0-1,0,1,1,1,1,-1,A
1924-01-26,1923,Liverpool,Manchester City,0-0,0,0,1,1,0,0,D
1924-01-26,1923,Middlesbrough,Everton,1-1,1,1,1,1,2,0,D
1924-01-26,1923,Newcastle United,Tottenham Hotspur,2-2,2,2,1,1,4,0,D
1924-01-26,1923,Nottingham Forest,Birmingham City,1-1,1,1,1,1,2,0,D
1924-01-26,1923,Preston North End,Notts County,2-1,2,1,1,1,3,1,H
1924-01-26,1923,Sheffield United,Sunderland,1-1,1,1,1,1,2,0,D
1924-01-26,1923,West Ham United,Blackburn Rovers,0-1,0,1,1,1,1,-1,A
1924-02-02,1923,Blackburn Rovers,Middlesbrough,2-0,2,0,1,1,2,2,H
1924-02-02,1923,Preston North End,Nottingham Forest,3-1,3,1,1,1,4,2,H
1924-02-06,1923,Everton,Preston North End,1-1,1,1,1,1,2,0,D
1924-02-09,1923,Aston Villa,Sunderland,0-1,0,1,1,1,1,-1,A
1924-02-09,1923,Burnley,Birmingham City,1-2,1,2,1,1,3,-1,A
1924-02-09,1923,Cardiff City,Blackburn Rovers,2-0,2,0,1,1,2,2,H
1924-02-09,1923,Chelsea,Notts County,0-6,0,6,1,1,6,-6,A
1924-02-09,1923,Liverpool,Bolton Wanderers,3-1,3,1,1,1,4,2,H
1924-02-09,1923,Middlesbrough,West Bromwich Albion,0-1,0,1,1,1,1,-1,A
1924-02-09,1923,Newcastle United,Huddersfield Town,0-1,0,1,1,1,1,-1,A
1924-02-09,1923,Nottingham Forest,Manchester City,1-2,1,2,1,1,3,-1,A
1924-02-09,1923,Preston North End,Everton,0-1,0,1,1,1,1,-1,A
1924-02-09,1923,Sheffield United,Arsenal,3-1,3,1,1,1,4,2,H
1924-02-09,1923,West Ham United,Tottenham Hotspur,0-0,0,0,1,1,0,0,D
1924-02-13,1923,Manchester City,Nottingham Forest,1-3,1,3,1,1,4,-2,A
1924-02-13,1923,Sunderland,Aston Villa,2-0,2,0,1,1,2,2,H
1924-02-16,1923,Arsenal,Aston Villa,0-1,0,1,1,1,1,-1,A
1924-02-16,1923,Birmingham City,Middlesbrough,2-1,2,1,1,1,3,1,H
1924-02-16,1923,Blackburn Rovers,Sheffield United,1-1,1,1,1,1,2,0,D
1924-02-16,1923,Bolton Wanderers,Nottingham Forest,4-0,4,0,1,1,4,4,H
1924-02-16,1923,Everton,Chelsea,2-0,2,0,1,1,2,2,H
1924-02-16,1923,Huddersfield Town,West Ham United,1-1,1,1,1,1,2,0,D
1924-02-16,1923,Manchester City,Burnley,2-2,2,2,1,1,4,0,D
1924-02-16,1923,Notts County,Newcastle United,1-0,1,0,1,1,1,1,H
1924-02-16,1923,Sunderland,Liverpool,0-0,0,0,1,1,0,0,D
1924-02-16,1923,Tottenham Hotspur,Cardiff City,1-1,1,1,1,1,2,0,D
1924-02-16,1923,West Bromwich Albion,Preston North End,1-2,1,2,1,1,3,-1,A
1924-02-23,1923,Chelsea,Everton,1-1,1,1,1,1,2,0,D
1924-02-23,1923,Middlesbrough,Birmingham City,0-1,0,1,1,1,1,-1,A
1924-02-23,1923,Nottingham Forest,Bolton Wanderers,1-0,1,0,1,1,1,1,H
1924-02-23,1923,Sheffield United,Blackburn Rovers,4-0,4,0,1,1,4,4,H
1924-02-25,1923,Arsenal,Sheffield United,1-3,1,3,1,1,4,-2,A
1924-02-27,1923,Birmingham City,Burnley,2-1,2,1,1,1,3,1,H
1924-02-27,1923,Huddersfield Town,Newcastle United,1-1,1,1,1,1,2,0,D
1924-03-01,1923,Arsenal,Liverpool,3-1,3,1,1,1,4,2,H
1924-03-01,1923,Birmingham City,Preston North End,2-0,2,0,1,1,2,2,H
1924-03-01,1923,Blackburn Rovers,Aston Villa,3-1,3,1,1,1,4,2,H
1924-03-01,1923,Bolton Wanderers,Burnley,0-0,0,0,1,1,0,0,D
1924-03-01,1923,Everton,Newcastle United,2-2,2,2,1,1,4,0,D
1924-03-01,1923,Huddersfield Town,Cardiff City,2-0,2,0,1,1,2,2,H
1924-03-01,1923,Manchester City,Middlesbrough,3-2,3,2,1,1,5,1,H
1924-03-01,1923,Notts County,West Ham United,1-1,1,1,1,1,2,0,D
1924-03-01,1923,Sunderland,Nottingham Forest,1-0,1,0,1,1,1,1,H
1924-03-01,1923,Tottenham Hotspur,Sheffield United,1-2,1,2,1,1,3,-1,A
1924-03-01,1923,West Bromwich Albion,Chelsea,2-2,2,2,1,1,4,0,D
1924-03-05,1923,Notts County,Chelsea,0-0,0,0,1,1,0,0,D
1924-03-08,1923,Middlesbrough,Blackburn Rovers,2-0,2,0,1,1,2,2,H
1924-03-08,1923,Nottingham Forest,Sunderland,1-2,1,2,1,1,3,-1,A
1924-03-08,1923,Preston North End,Birmingham City,1-0,1,0,1,1,1,1,H
1924-03-08,1923,Sheffield United,Tottenham Hotspur,6-2,6,2,1,1,8,4,H
1924-03-08,1923,West Ham United,Notts County,1-1,1,1,1,1,2,0,D
1924-03-12,1923,Aston Villa,Arsenal,2-1,2,1,1,1,3,1,H
1924-03-12,1923,Bolton Wanderers,Liverpool,4-1,4,1,1,1,5,3,H
1924-03-12,1923,Chelsea,West Bromwich Albion,0-0,0,0,1,1,0,0,D
1924-03-15,1923,Aston Villa,Tottenham Hotspur,0-0,0,0,1,1,0,0,D
1924-03-15,1923,Burnley,Sunderland,0-3,0,3,1,1,3,-3,A
1924-03-15,1923,Cardiff City,Notts County,0-2,0,2,1,1,2,-2,A
1924-03-15,1923,Chelsea,Birmingham City,1-1,1,1,1,1,2,0,D
1924-03-15,1923,Liverpool,Blackburn Rovers,0-0,0,0,1,1,0,0,D
1924-03-15,1923,Middlesbrough,Bolton Wanderers,1-2,1,2,1,1,3,-1,A
1924-03-15,1923,Newcastle United,West Bromwich Albion,1-1,1,1,1,1,2,0,D
1924-03-15,1923,Nottingham Forest,Arsenal,2-1,2,1,1,1,3,1,H
1924-03-15,1923,Preston North End,Manchester City,4-1,4,1,1,1,5,3,H
1924-03-15,1923,Sheffield United,Huddersfield Town,0-1,0,1,1,1,1,-1,A
1924-03-15,1923,West Ham United,Everton,2-1,2,1,1,1,3,1,H
1924-03-17,1923,Burnley,Manchester City,3-2,3,2,1,1,5,1,H
1924-03-19,1923,Liverpool,Sunderland,4-2,4,2,1,1,6,2,H
1924-03-19,1923,Newcastle United,Notts County,1-2,1,2,1,1,3,-1,A
1924-03-19,1923,Preston North End,West Bromwich Albion,1-2,1,2,1,1,3,-1,A
1924-03-20,1923,Blackburn Rovers,Cardiff City,2-1,2,1,1,1,3,1,H
1924-03-22,1923,Arsenal,Nottingham Forest,1-0,1,0,1,1,1,1,H
1924-03-22,1923,Birmingham City,Chelsea,1-0,1,0,1,1,1,1,H
1924-03-22,1923,Blackburn Rovers,Liverpool,0-0,0,0,1,1,0,0,D
1924-03-22,1923,Bolton Wanderers,Middlesbrough,2-0,2,0,1,1,2,2,H
1924-03-22,1923,Everton,West Ham United,2-1,2,1,1,1,3,1,H
1924-03-22,1923,Huddersfield Town,Sheffield United,1-0,1,0,1,1,1,1,H
1924-03-22,1923,Manchester City,Preston North End,2-2,2,2,1,1,4,0,D
1924-03-22,1923,Notts County,Cardiff City,1-0,1,0,1,1,1,1,H
1924-03-22,1923,Sunderland,Burnley,0-1,0,1,1,1,1,-1,A
1924-03-22,1923,Tottenham Hotspur,Aston Villa,2-3,2,3,1,1,5,-1,A
1924-03-22,1923,West Bromwich Albion,Newcastle United,0-0,0,0,1,1,0,0,D
1924-03-27,1923,West Ham United,Huddersfield Town,2-3,2,3,1,1,5,-1,A
1924-03-29,1923,Cardiff City,Everton,0-0,0,0,1,1,0,0,D
1924-03-29,1923,Liverpool,Tottenham Hotspur,1-0,1,0,1,1,1,1,H
1924-03-29,1923,Middlesbrough,Sunderland,1-3,1,3,1,1,4,-2,A
1924-03-29,1923,Nottingham Forest,Blackburn Rovers,0-0,0,0,1,1,0,0,D
1924-03-29,1923,Preston North End,Bolton Wanderers,0-2,0,2,1,1,2,-2,A
1924-03-29,1923,West Ham United,West Bromwich Albion,1-0,1,0,1,1,1,1,H
1924-04-01,1923,Burnley,Bolton Wanderers,1-0,1,0,1,1,1,1,H
1924-04-02,1923,Aston Villa,Blackburn Rovers,1-0,1,0,1,1,1,1,H
1924-04-02,1923,Liverpool,Arsenal,0-0,0,0,1,1,0,0,D
1924-04-02,1923,Middlesbrough,Manchester City,1-1,1,1,1,1,2,0,D
1924-04-02,1923,Newcastle United,Everton,3-1,3,1,1,1,4,2,H
1924-04-05,1923,Arsenal,Burnley,2-0,2,0,1,1,2,2,H
1924-04-05,1923,Birmingham City,Newcastle United,4-1,4,1,1,1,5,3,H
1924-04-05,1923,Blackburn Rovers,Nottingham Forest,1-1,1,1,1,1,2,0,D
1924-04-05,1923,Bolton Wanderers,Preston North End,0-0,0,0,1,1,0,0,D
1924-04-05,1923,Everton,Cardiff City,0-0,0,0,1,1,0,0,D
1924-04-05,1923,Huddersfield Town,Aston Villa,1-0,1,0,1,1,1,1,H
1924-04-05,1923,Manchester City,Chelsea,1-0,1,0,1,1,1,1,H
1924-04-05,1923,Notts County,Sheffield United,0-2,0,2,1,1,2,-2,A
1924-04-05,1923,Sunderland,Middlesbrough,3-2,3,2,1,1,5,1,H
1924-04-05,1923,Tottenham Hotspur,Liverpool,1-1,1,1,1,1,2,0,D
1924-04-05,1923,West Bromwich Albion,West Ham United,0-0,0,0,1,1,0,0,D
1924-04-07,1923,Cardiff City,Tottenham Hotspur,2-1,2,1,1,1,3,1,H
1924-04-07,1923,Sheffield United,Notts County,3-1,3,1,1,1,4,2,H
1924-04-09,1923,Newcastle United,Birmingham City,2-1,2,1,1,1,3,1,H
1924-04-09,1923,West Bromwich Albion,Middlesbrough,1-1,1,1,1,1,2,0,D
1924-04-12,1923,Arsenal,Sunderland,2-0,2,0,1,1,2,2,H
1924-04-12,1923,Blackburn Rovers,Bolton Wanderers,3-1,3,1,1,1,4,2,H
1924-04-12,1923,Cardiff City,Burnley,2-0,2,0,1,1,2,2,H
1924-04-12,1923,Huddersfield Town,Manchester City,1-1,1,1,1,1,2,0,D
1924-04-12,1923,Liverpool,Middlesbrough,3-1,3,1,1,1,4,2,H
1924-04-12,1923,Newcastle United,Chelsea,2-1,2,1,1,1,3,1,H
1924-04-12,1923,Nottingham Forest,Aston Villa,0-0,0,0,1,1,0,0,D
1924-04-12,1923,Sheffield United,Birmingham City,0-2,0,2,1,1,2,-2,A
1924-04-12,1923,Tottenham Hotspur,Everton,2-5,2,5,1,1,7,-3,A
1924-04-12,1923,West Bromwich Albion,Notts County,5-0,5,0,1,1,5,5,H
1924-04-12,1923,West Ham United,Preston North End,3-1,3,1,1,1,4,2,H
1924-04-14,1923,Cardiff City,Huddersfield Town,0-0,0,0,1,1,0,0,D
1924-04-18,1923,Bolton Wanderers,Newcastle United,0-1,0,1,1,1,1,-1,A
1924-04-18,1923,Burnley,Huddersfield Town,1-1,1,1,1,1,2,0,D
1924-04-18,1923,Chelsea,Liverpool,2-1,2,1,1,1,3,1,H
1924-04-18,1923,Everton,Arsenal,3-1,3,1,1,1,4,2,H
1924-04-18,1923,Manchester City,Birmingham City,1-0,1,0,1,1,1,1,H
1924-04-18,1923,Notts County,Blackburn Rovers,3-0,3,0,1,1,3,3,H
1924-04-18,1923,Sunderland,West Bromwich Albion,2-0,2,0,1,1,2,2,H
1924-04-19,1923,Aston Villa,Nottingham Forest,2-0,2,0,1,1,2,2,H
1924-04-19,1923,Birmingham City,Sheffield United,0-1,0,1,1,1,1,-1,A
1924-04-19,1923,Bolton Wanderers,Blackburn Rovers,3-0,3,0,1,1,3,3,H
1924-04-19,1923,Burnley,Cardiff City,1-2,1,2,1,1,3,-1,A
1924-04-19,1923,Chelsea,Newcastle United,1-0,1,0,1,1,1,1,H
1924-04-19,1923,Everton,Tottenham Hotspur,4-2,4,2,1,1,6,2,H
1924-04-19,1923,Manchester City,Huddersfield Town,1-1,1,1,1,1,2,0,D
1924-04-19,1923,Middlesbrough,Liverpool,1-1,1,1,1,1,2,0,D
1924-04-19,1923,Notts County,West Bromwich Albion,1-0,1,0,1,1,1,1,H
1924-04-19,1923,Preston North End,West Ham United,2-1,2,1,1,1,3,1,H
1924-04-19,1923,Sunderland,Arsenal,1-1,1,1,1,1,2,0,D
1924-04-21,1923,Arsenal,Everton,0-1,0,1,1,1,1,-1,A
1924-04-21,1923,Aston Villa,Newcastle United,6-1,6,1,1,1,7,5,H
1924-04-21,1923,Cardiff City,Middlesbrough,1-0,1,0,1,1,1,1,H
1924-04-21,1923,Nottingham Forest,Preston North End,1-1,1,1,1,1,2,0,D
1924-04-21,1923,Tottenham Hotspur,Manchester City,4-1,4,1,1,1,5,3,H
1924-04-21,1923,West Bromwich Albion,Sunderland,3-1,3,1,1,1,4,2,H
1924-04-21,1923,West Ham United,Sheffield United,2-2,2,2,1,1,4,0,D
1924-04-22,1923,Huddersfield Town,Burnley,1-0,1,0,1,1,1,1,H
1924-04-22,1923,Tottenham Hotspur,West Ham United,0-1,0,1,1,1,1,-1,A
1924-04-26,1923,Burnley,Tottenham Hotspur,2-2,2,2,1,1,4,0,D
1924-04-26,1923,Cardiff City,Birmingham City,2-0,2,0,1,1,2,2,H
1924-04-26,1923,Chelsea,Sunderland,4-1,4,1,1,1,5,3,H
1924-04-26,1923,Liverpool,Notts County,1-0,1,0,1,1,1,1,H
1924-04-26,1923,Nottingham Forest,Huddersfield Town,1-1,1,1,1,1,2,0,D
1924-04-26,1923,Preston North End,Arsenal,0-2,0,2,1,1,2,-2,A
1924-04-26,1923,Sheffield United,West Bromwich Albion,2-0,2,0,1,1,2,2,H
1924-04-26,1923,West Ham United,Manchester City,1-2,1,2,1,1,3,-1,A
1924-04-28,1923,Burnley,Arsenal,4-1,4,1,1,1,5,3,H
1924-04-30,1923,Aston Villa,Huddersfield Town,3-1,3,1,1,1,4,2,H
1924-04-30,1923,Chelsea,Manchester City,3-1,3,1,1,1,4,2,H
1924-05-03,1923,Arsenal,Preston North End,1-2,1,2,1,1,3,-1,A
1924-05-03,1923,Birmingham City,Cardiff City,0-0,0,0,1,1,0,0,D
1924-05-03,1923,Huddersfield Town,Nottingham Forest,3-0,3,0,1,1,3,3,H
1924-05-03,1923,Manchester City,West Ham United,2-1,2,1,1,1,3,1,H
1924-05-03,1923,Notts County,Liverpool,1-2,1,2,1,1,3,-1,A
1924-05-03,1923,Tottenham Hotspur,Burnley,1-0,1,0,1,1,1,1,H
1924-05-03,1923,West Bromwich Albion,Sheffield United,3-1,3,1,1,1,4,2,H
1924-08-30,1924,Birmingham City,Everton,2-2,2,2,1,1,4,0,D
1924-08-30,1924,Burnley,Cardiff City,0-0,0,0,1,1,0,0,D
1924-08-30,1924,Bury,Manchester City,0-2,0,2,1,1,2,-2,A
1924-08-30,1924,Leeds United,Sunderland,1-1,1,1,1,1,2,0,D
1924-08-30,1924,Liverpool,Aston Villa,2-4,2,4,1,1,6,-2,A
1924-08-30,1924,Newcastle United,Huddersfield Town,1-3,1,3,1,1,4,-2,A
1924-08-30,1924,Nottingham Forest,Arsenal,0-2,0,2,1,1,2,-2,A
1924-08-30,1924,Sheffield United,Blackburn Rovers,2-3,2,3,1,1,5,-1,A
1924-08-30,1924,Tottenham Hotspur,Bolton Wanderers,3-0,3,0,1,1,3,3,H
1924-08-30,1924,West Bromwich Albion,Notts County,1-2,1,2,1,1,3,-1,A
1924-08-30,1924,West Ham United,Preston North End,1-0,1,0,1,1,1,1,H
1924-09-01,1924,Arsenal,Manchester City,1-0,1,0,1,1,1,1,H
1924-09-01,1924,Aston Villa,Bury,3-3,3,3,1,1,6,0,D
1924-09-01,1924,Blackburn Rovers,Newcastle United,1-1,1,1,1,1,2,0,D
1924-09-01,1924,Bolton Wanderers,West Bromwich Albion,1-1,1,1,1,1,2,0,D
1924-09-01,1924,Cardiff City,Sheffield United,1-1,1,1,1,1,2,0,D
1924-09-01,1924,Notts County,Leeds United,1-0,1,0,1,1,1,1,H
1924-09-02,1924,Huddersfield Town,Nottingham Forest,3-0,3,0,1,1,3,3,H
1924-09-03,1924,Birmingham City,Tottenham Hotspur,0-2,0,2,1,1,2,-2,A
1924-09-03,1924,Sunderland,Preston North End,2-0,2,0,1,1,2,2,H
1924-09-06,1924,Arsenal,Liverpool,2-0,2,0,1,1,2,2,H
1924-09-06,1924,Aston Villa,Newcastle United,0-0,0,0,1,1,0,0,D
1924-09-06,1924,Blackburn Rovers,West Ham United,0-1,0,1,1,1,1,-1,A
1924-09-06,1924,Bolton Wanderers,Bury,3-3,3,3,1,1,6,0,D
1924-09-06,1924,Cardiff City,Leeds United,3-0,3,0,1,1,3,3,H
1924-09-06,1924,Everton,West Bromwich Albion,1-0,1,0,1,1,1,1,H
1924-09-06,1924,Huddersfield Town,Sheffield United,2-1,2,1,1,1,3,1,H
1924-09-06,1924,Manchester City,Nottingham Forest,4-2,4,2,1,1,6,2,H
1924-09-06,1924,Notts County,Tottenham Hotspur,0-0,0,0,1,1,0,0,D
1924-09-06,1924,Preston North End,Burnley,0-2,0,2,1,1,2,-2,A
1924-09-06,1924,Sunderland,Birmingham City,4-0,4,0,1,1,4,4,H
1924-09-08,1924,Birmingham City,Bolton Wanderers,1-0,1,0,1,1,1,1,H
1924-09-08,1924,Burnley,Everton,0-0,0,0,1,1,0,0,D
1924-09-08,1924,Bury,Aston Villa,4-3,4,3,1,1,7,1,H
1924-09-08,1924,Nottingham Forest,Huddersfield Town,0-1,0,1,1,1,1,-1,A
1924-09-08,1924,Sheffield United,Cardiff City,1-0,1,0,1,1,1,1,H
1924-09-08,1924,West Bromwich Albion,Tottenham Hotspur,2-0,2,0,1,1,2,2,H
1924-09-08,1924,West Ham United,Newcastle United,0-0,0,0,1,1,0,0,D
1924-09-10,1924,Leeds United,Notts County,1-1,1,1,1,1,2,0,D
1924-09-10,1924,Newcastle United,Blackburn Rovers,4-0,4,0,1,1,4,4,H
1924-09-13,1924,Birmingham City,Cardiff City,2-1,2,1,1,1,3,1,H
1924-09-13,1924,Bolton Wanderers,Notts County,1-0,1,0,1,1,1,1,H
1924-09-13,1924,Burnley,Blackburn Rovers,3-5,3,5,1,1,8,-2,A
1924-09-13,1924,Leeds United,Preston North End,4-0,4,0,1,1,4,4,H
1924-09-13,1924,Liverpool,Manchester City,5-3,5,3,1,1,8,2,H
1924-09-13,1924,Newcastle United,Arsenal,2-2,2,2,1,1,4,0,D
1924-09-13,1924,Nottingham Forest,Bury,2-0,2,0,1,1,2,2,H
1924-09-13,1924,Sheffield United,Aston Villa,2-2,2,2,1,1,4,0,D
1924-09-13,1924,Tottenham Hotspur,Everton,0-0,0,0,1,1,0,0,D
1924-09-13,1924,West Bromwich Albion,Sunderland,2-1,2,1,1,1,3,1,H
1924-09-13,1924,West Ham United,Huddersfield Town,0-0,0,0,1,1,0,0,D
1924-09-15,1924,Birmingham City,Notts County,1-0,1,0,1,1,1,1,H
1924-09-15,1924,Blackburn Rovers,Liverpool,3-1,3,1,1,1,4,2,H
1924-09-15,1924,Preston North End,Cardiff City,1-3,1,3,1,1,4,-2,A
1924-09-17,1924,Leeds United,Everton,1-0,1,0,1,1,1,1,H
1924-09-17,1924,Manchester City,Arsenal,2-0,2,0,1,1,2,2,H
1924-09-17,1924,Newcastle United,West Ham United,4-1,4,1,1,1,5,3,H
1924-09-20,1924,Arsenal,Sheffield United,2-0,2,0,1,1,2,2,H
1924-09-20,1924,Aston Villa,West Ham United,1-1,1,1,1,1,2,0,D
1924-09-20,1924,Burnley,Leeds United,1-1,1,1,1,1,2,0,D
1924-09-20,1924,Bury,Liverpool,0-0,0,0,1,1,0,0,D
1924-09-20,1924,Cardiff City,West Bromwich Albion,0-1,0,1,1,1,1,-1,A
1924-09-20,1924,Everton,Bolton Wanderers,2-2,2,2,1,1,4,0,D
1924-09-20,1924,Huddersfield Town,Blackburn Rovers,0-0,0,0,1,1,0,0,D
1924-09-20,1924,Manchester City,Newcastle United,3-1,3,1,1,1,4,2,H
1924-09-20,1924,Notts County,Nottingham Forest,0-0,0,0,1,1,0,0,D
1924-09-20,1924,Preston North End,Birmingham City,1-0,1,0,1,1,1,1,H
1924-09-20,1924,Sunderland,Tottenham Hotspur,4-1,4,1,1,1,5,3,H
1924-09-22,1924,Sheffield United,West Ham United,1-1,1,1,1,1,2,0,D
1924-09-22,1924,Tottenham Hotspur,West Bromwich Albion,0-1,0,1,1,1,1,-1,A
1924-09-27,1924,Birmingham City,Burnley,1-0,1,0,1,1,1,1,H
1924-09-27,1924,Blackburn Rovers,Aston Villa,1-1,1,1,1,1,2,0,D
1924-09-27,1924,Bolton Wanderers,Sunderland,1-2,1,2,1,1,3,-1,A
1924-09-27,1924,Leeds United,Huddersfield Town,1-1,1,1,1,1,2,0,D
1924-09-27,1924,Liverpool,Nottingham Forest,3-0,3,0,1,1,3,3,H
1924-09-27,1924,Newcastle United,Bury,2-2,2,2,1,1,4,0,D
1924-09-27,1924,Notts County,Everton,3-1,3,1,1,1,4,2,H
1924-09-27,1924,Sheffield United,Manchester City,0-5,0,5,1,1,5,-5,A
1924-09-27,1924,Tottenham Hotspur,Cardiff City,1-1,1,1,1,1,2,0,D
1924-09-27,1924,West Bromwich Albion,Preston North End,1-1,1,1,1,1,2,0,D
1924-09-27,1924,West Ham United,Arsenal,1-0,1,0,1,1,1,1,H
1924-09-29,1924,Burnley,Sunderland,1-2,1,2,1,1,3,-1,A
1924-10-02,1924,Nottingham Forest,Aston Villa,0-2,0,2,1,1,2,-2,A
1924-10-04,1924,Arsenal,Blackburn Rovers,1-0,1,0,1,1,1,1,H
1924-10-04,1924,Aston Villa,Huddersfield Town,1-1,1,1,1,1,2,0,D
1924-10-04,1924,Burnley,West Bromwich Albion,0-1,0,1,1,1,1,-1,A
1924-10-04,1924,Bury,Sheffield United,1-0,1,0,1,1,1,1,H
1924-10-04,1924,Cardiff City,Bolton Wanderers,1-2,1,2,1,1,3,-1,A
1924-10-04,1924,Everton,Liverpool,0-1,0,1,1,1,1,-1,A
1924-10-04,1924,Leeds United,Birmingham City,0-1,0,1,1,1,1,-1,A
1924-10-04,1924,Manchester City,West Ham United,3-1,3,1,1,1,4,2,H
1924-10-04,1924,Nottingham Forest,Newcastle United,1-1,1,1,1,1,2,0,D
1924-10-04,1924,Preston North End,Tottenham Hotspur,0-3,0,3,1,1,3,-3,A
1924-10-04,1924,Sunderland,Notts County,0-1,0,1,1,1,1,-1,A
1924-10-11,1924,Birmingham City,Aston Villa,1-0,1,0,1,1,1,1,H
1924-10-11,1924,Blackburn Rovers,Manchester City,3-1,3,1,1,1,4,2,H
1924-10-11,1924,Bolton Wanderers,Preston North End,6-1,6,1,1,1,7,5,H
1924-10-11,1924,Everton,Sunderland,0-3,0,3,1,1,3,-3,A
1924-10-11,1924,Huddersfield Town,Arsenal,4-0,4,0,1,1,4,4,H
1924-10-11,1924,Newcastle United,Liverpool,0-0,0,0,1,1,0,0,D
1924-10-11,1924,Notts County,Cardiff City,3-0,3,0,1,1,3,3,H
1924-10-11,1924,Sheffield United,Nottingham Forest,1-2,1,2,1,1,3,-1,A
1924-10-11,1924,Tottenham Hotspur,Burnley,1-1,1,1,1,1,2,0,D
1924-10-11,1924,West Bromwich Albion,Leeds United,3-1,3,1,1,1,4,2,H
1924-10-11,1924,West Ham United,Bury,1-1,1,1,1,1,2,0,D
1924-10-13,1924,Arsenal,Bury,0-1,0,1,1,1,1,-1,A
1924-10-15,1924,Liverpool,Blackburn Rovers,0-0,0,0,1,1,0,0,D
1924-10-18,1924,Arsenal,Aston Villa,1-1,1,1,1,1,2,0,D
1924-10-18,1924,Burnley,Bolton Wanderers,0-0,0,0,1,1,0,0,D
1924-10-18,1924,Bury,Blackburn Rovers,1-1,1,1,1,1,2,0,D
1924-10-18,1924,Cardiff City,Everton,2-1,2,1,1,1,3,1,H
1924-10-18,1924,Leeds United,Tottenham Hotspur,1-0,1,0,1,1,1,1,H
1924-10-18,1924,Liverpool,Sheffield United,4-1,4,1,1,1,5,3,H
1924-10-18,1924,Manchester City,Huddersfield Town,1-1,1,1,1,1,2,0,D
1924-10-18,1924,Nottingham Forest,West Ham United,2-1,2,1,1,1,3,1,H
1924-10-18,1924,Preston North End,Notts County,0-1,0,1,1,1,1,-1,A
1924-10-18,1924,Sunderland,Newcastle United,1-1,1,1,1,1,2,0,D
1924-10-18,1924,West Bromwich Albion,Birmingham City,1-1,1,1,1,1,2,0,D
1924-10-25,1924,Arsenal,Tottenham Hotspur,1-0,1,0,1,1,1,1,H
1924-10-25,1924,Aston Villa,West Bromwich Albion,1-0,1,0,1,1,1,1,H
1924-10-25,1924,Blackburn Rovers,Leeds United,2-3,2,3,1,1,5,-1,A
1924-10-25,1924,Bury,Notts County,2-1,2,1,1,1,3,1,H
1924-10-25,1924,Huddersfield Town,Birmingham City,0-1,0,1,1,1,1,-1,A
1924-10-25,1924,Liverpool,Sunderland,3-1,3,1,1,1,4,2,H
1924-10-25,1924,Manchester City,Bolton Wanderers,2-2,2,2,1,1,4,0,D
1924-10-25,1924,Newcastle United,Cardiff City,1-2,1,2,1,1,3,-1,A
1924-10-25,1924,Nottingham Forest,Everton,0-1,0,1,1,1,1,-1,A
1924-10-25,1924,Sheffield United,Preston North End,3-0,3,0,1,1,3,3,H
1924-10-25,1924,West Ham United,Burnley,2-0,2,0,1,1,2,2,H
1924-10-29,1924,Everton,Manchester City,3-1,3,1,1,1,4,2,H
1924-11-01,1924,Birmingham City,Blackburn Rovers,1-1,1,1,1,1,2,0,D
1924-11-01,1924,Bolton Wanderers,Arsenal,4-1,4,1,1,1,5,3,H
1924-11-01,1924,Burnley,Sheffield United,1-1,1,1,1,1,2,0,D
1924-11-01,1924,Everton,Bury,0-0,0,0,1,1,0,0,D
1924-11-01,1924,Leeds United,West Ham United,2-1,2,1,1,1,3,1,H
1924-11-01,1924,Notts County,Manchester City,2-0,2,0,1,1,2,2,H
1924-11-01,1924,Preston North End,Newcastle United,0-1,0,1,1,1,1,-1,A
1924-11-01,1924,Sunderland,Nottingham Forest,3-1,3,1,1,1,4,2,H
1924-11-01,1924,Tottenham Hotspur,Aston Villa,1-3,1,3,1,1,4,-2,A
1924-11-01,1924,West Bromwich Albion,Huddersfield Town,1-0,1,0,1,1,1,1,H
1924-11-08,1924,Arsenal,Notts County,0-1,0,1,1,1,1,-1,A
1924-11-08,1924,Aston Villa,Bolton Wanderers,2-2,2,2,1,1,4,0,D
1924-11-08,1924,Blackburn Rovers,West Bromwich Albion,1-0,1,0,1,1,1,1,H
1924-11-08,1924,Bury,Sunderland,3-0,3,0,1,1,3,3,H
1924-11-08,1924,Huddersfield Town,Tottenham Hotspur,1-2,1,2,1,1,3,-1,A
1924-11-08,1924,Liverpool,Preston North End,3-1,3,1,1,1,4,2,H
1924-11-08,1924,Manchester City,Everton,2-2,2,2,1,1,4,0,D
1924-11-08,1924,Newcastle United,Burnley,3-0,3,0,1,1,3,3,H
1924-11-08,1924,Nottingham Forest,Cardiff City,2-1,2,1,1,1,3,1,H
1924-11-08,1924,Sheffield United,Leeds United,1-1,1,1,1,1,2,0,D
1924-11-08,1924,West Ham United,Birmingham City,0-1,0,1,1,1,1,-1,A
1924-11-10,1924,Tottenham Hotspur,Manchester City,1-1,1,1,1,1,2,0,D
1924-11-12,1924,Liverpool,Huddersfield Town,2-3,2,3,1,1,5,-1,A
1924-11-15,1924,Birmingham City,Sheffield United,1-1,1,1,1,1,2,0,D
1924-11-15,1924,Bolton Wanderers,Huddersfield Town,1-0,1,0,1,1,1,1,H
1924-11-15,1924,Burnley,Liverpool,2-1,2,1,1,1,3,1,H
1924-11-15,1924,Cardiff City,Bury,4-1,4,1,1,1,5,3,H
1924-11-15,1924,Everton,Arsenal,2-3,2,3,1,1,5,-1,A
1924-11-15,1924,Leeds United,Newcastle United,1-1,1,1,1,1,2,0,D
1924-11-15,1924,Notts County,Aston Villa,0-0,0,0,1,1,0,0,D
1924-11-15,1924,Preston North End,Nottingham Forest,3-1,3,1,1,1,4,2,H
1924-11-15,1924,Sunderland,Manchester City,3-2,3,2,1,1,5,1,H
1924-11-15,1924,Tottenham Hotspur,Blackburn Rovers,5-0,5,0,1,1,5,5,H
1924-11-15,1924,West Bromwich Albion,West Ham United,4-1,4,1,1,1,5,3,H
1924-11-20,1924,Preston North End,Sunderland,1-2,1,2,1,1,3,-1,A
1924-11-22,1924,Arsenal,Sunderland,0-0,0,0,1,1,0,0,D
1924-11-22,1924,Aston Villa,Everton,3-1,3,1,1,1,4,2,H
1924-11-22,1924,Blackburn Rovers,Bolton Wanderers,0-2,0,2,1,1,2,-2,A
1924-11-22,1924,Bury,Preston North End,1-1,1,1,1,1,2,0,D
1924-11-22,1924,Huddersfield Town,Notts County,0-0,0,0,1,1,0,0,D
1924-11-22,1924,Liverpool,Leeds United,1-0,1,0,1,1,1,1,H
1924-11-22,1924,Manchester City,Cardiff City,2-2,2,2,1,1,4,0,D
1924-11-22,1924,Newcastle United,Birmingham City,4-0,4,0,1,1,4,4,H
1924-11-22,1924,Nottingham Forest,Burnley,0-0,0,0,1,1,0,0,D
1924-11-22,1924,Sheffield United,West Bromwich Albion,2-0,2,0,1,1,2,2,H
1924-11-22,1924,West Ham United,Tottenham Hotspur,1-1,1,1,1,1,2,0,D
1924-11-29,1924,Birmingham City,Liverpool,5-2,5,2,1,1,7,3,H
1924-11-29,1924,Bolton Wanderers,West Ham United,5-0,5,0,1,1,5,5,H
1924-11-29,1924,Burnley,Bury,4-0,4,0,1,1,4,4,H
1924-11-29,1924,Cardiff City,Arsenal,1-1,1,1,1,1,2,0,D
1924-11-29,1924,Everton,Huddersfield Town,0-2,0,2,1,1,2,-2,A
1924-11-29,1924,Leeds United,Nottingham Forest,1-1,1,1,1,1,2,0,D
1924-11-29,1924,Notts County,Blackburn Rovers,0-0,0,0,1,1,0,0,D
1924-11-29,1924,Preston North End,Manchester City,2-3,2,3,1,1,5,-1,A
1924-11-29,1924,Sunderland,Aston Villa,1-1,1,1,1,1,2,0,D
1924-11-29,1924,Tottenham Hotspur,Sheffield United,4-1,4,1,1,1,5,3,H
1924-11-29,1924,West Bromwich Albion,Newcastle United,2-0,2,0,1,1,2,2,H
1924-12-06,1924,Arsenal,Preston North End,4-0,4,0,1,1,4,4,H
1924-12-06,1924,Aston Villa,Cardiff City,1-2,1,2,1,1,3,-1,A
1924-12-06,1924,Blackburn Rovers,Everton,3-0,3,0,1,1,3,3,H
1924-12-06,1924,Bury,Leeds United,1-0,1,0,1,1,1,1,H
1924-12-06,1924,Huddersfield Town,Sunderland,4-0,4,0,1,1,4,4,H
1924-12-06,1924,Liverpool,West Bromwich Albion,1-1,1,1,1,1,2,0,D
1924-12-06,1924,Manchester City,Burnley,3-3,3,3,1,1,6,0,D
1924-12-06,1924,Newcastle United,Tottenham Hotspur,1-1,1,1,1,1,2,0,D
1924-12-06,1924,Nottingham Forest,Birmingham City,1-1,1,1,1,1,2,0,D
1924-12-06,1924,Sheffield United,Bolton Wanderers,2-0,2,0,1,1,2,2,H
1924-12-06,1924,West Ham United,Notts County,3-0,3,0,1,1,3,3,H
1924-12-13,1924,Birmingham City,Bury,0-1,0,1,1,1,1,-1,A
1924-12-13,1924,Bolton Wanderers,Newcastle United,3-2,3,2,1,1,5,1,H
1924-12-13,1924,Burnley,Arsenal,1-0,1,0,1,1,1,1,H
1924-12-13,1924,Cardiff City,Huddersfield Town,2-2,2,2,1,1,4,0,D
1924-12-13,1924,Everton,West Ham United,1-0,1,0,1,1,1,1,H
1924-12-13,1924,Leeds United,Manchester City,0-3,0,3,1,1,3,-3,A
1924-12-13,1924,Notts County,Sheffield United,2-0,2,0,1,1,2,2,H
1924-12-13,1924,Preston North End,Aston Villa,3-2,3,2,1,1,5,1,H
1924-12-13,1924,Sunderland,Blackburn Rovers,1-0,1,0,1,1,1,1,H
1924-12-13,1924,Tottenham Hotspur,Liverpool,1-1,1,1,1,1,2,0,D
1924-12-13,1924,West Bromwich Albion,Nottingham Forest,5-1,5,1,1,1,6,4,H
1924-12-15,1924,Cardiff City,Liverpool,1-3,1,3,1,1,4,-2,A
1924-12-20,1924,Arsenal,Leeds United,6-1,6,1,1,1,7,5,H
1924-12-20,1924,Aston Villa,Burnley,3-0,3,0,1,1,3,3,H
1924-12-20,1924,Blackburn Rovers,Cardiff City,3-1,3,1,1,1,4,2,H
1924-12-20,1924,Bury,West Bromwich Albion,0-2,0,2,1,1,2,-2,A
1924-12-20,1924,Huddersfield Town,Preston North End,1-0,1,0,1,1,1,1,H
1924-12-20,1924,Liverpool,Bolton Wanderers,0-0,0,0,1,1,0,0,D
1924-12-20,1924,Manchester City,Birmingham City,2-2,2,2,1,1,4,0,D
1924-12-20,1924,Newcastle United,Notts County,1-0,1,0,1,1,1,1,H
1924-12-20,1924,Nottingham Forest,Tottenham Hotspur,1-0,1,0,1,1,1,1,H
1924-12-20,1924,Sheffield United,Everton,1-1,1,1,1,1,2,0,D
1924-12-20,1924,West Ham United,Sunderland,4-1,4,1,1,1,5,3,H
1924-12-25,1924,Birmingham City,Arsenal,2-1,2,1,1,1,3,1,H
1924-12-25,1924,Blackburn Rovers,Preston North End,0-1,0,1,1,1,1,-1,A
1924-12-25,1924,Bolton Wanderers,Nottingham Forest,1-0,1,0,1,1,1,1,H
1924-12-25,1924,Burnley,Huddersfield Town,1-5,1,5,1,1,6,-4,A
1924-12-25,1924,Everton,Newcastle United,0-1,0,1,1,1,1,-1,A
1924-12-25,1924,Leeds United,Aston Villa,6-0,6,0,1,1,6,6,H
1924-12-25,1924,Manchester City,West Bromwich Albion,1-2,1,2,1,1,3,-1,A
1924-12-25,1924,Notts County,Liverpool,1-2,1,2,1,1,3,-1,A
1924-12-25,1924,Sunderland,Sheffield United,0-1,0,1,1,1,1,-1,A
1924-12-25,1924,Tottenham Hotspur,Bury,1-1,1,1,1,1,2,0,D
1924-12-25,1924,West Ham United,Cardiff City,3-2,3,2,1,1,5,1,H
1924-12-26,1924,Arsenal,Birmingham City,0-1,0,1,1,1,1,-1,A
1924-12-26,1924,Aston Villa,Leeds United,2-1,2,1,1,1,3,1,H
1924-12-26,1924,Cardiff City,West Ham United,2-1,2,1,1,1,3,1,H
1924-12-26,1924,Huddersfield Town,Burnley,2-0,2,0,1,1,2,2,H
1924-12-26,1924,Liverpool,Notts County,1-0,1,0,1,1,1,1,H
1924-12-26,1924,Newcastle United,Everton,1-1,1,1,1,1,2,0,D
1924-12-26,1924,Nottingham Forest,Bolton Wanderers,1-1,1,1,1,1,2,0,D
1924-12-26,1924,Preston North End,Blackburn Rovers,3-2,3,2,1,1,5,1,H
1924-12-26,1924,Sheffield United,Sunderland,2-1,2,1,1,1,3,1,H
1924-12-26,1924,West Bromwich Albion,Manchester City,3-1,3,1,1,1,4,2,H
1924-12-27,1924,Arsenal,Nottingham Forest,2-1,2,1,1,1,3,1,H
1924-12-27,1924,Blackburn Rovers,Sheffield United,2-2,2,2,1,1,4,0,D
1924-12-27,1924,Bolton Wanderers,Tottenham Hotspur,3-0,3,0,1,1,3,3,H
1924-12-27,1924,Everton,Birmingham City,2-1,2,1,1,1,3,1,H
1924-12-27,1924,Huddersfield Town,Newcastle United,0-0,0,0,1,1,0,0,D
1924-12-27,1924,Notts County,West Bromwich Albion,0-2,0,2,1,1,2,-2,A
1924-12-27,1924,Preston North End,West Ham United,3-2,3,2,1,1,5,1,H
1924-12-27,1924,Sunderland,Leeds United,2-1,2,1,1,1,3,1,H
1925-01-01,1924,Bolton Wanderers,Birmingham City,3-0,3,0,1,1,3,3,H
1925-01-01,1924,Bury,Tottenham Hotspur,5-2,5,2,1,1,7,3,H
1925-01-01,1924,Everton,Burnley,3-2,3,2,1,1,5,1,H
1925-01-01,1924,Newcastle United,Sheffield United,0-0,0,0,1,1,0,0,D
1925-01-01,1924,Sunderland,Cardiff City,1-0,1,0,1,1,1,1,H
1925-01-03,1924,Birmingham City,Sunderland,2-1,2,1,1,1,3,1,H
1925-01-03,1924,Burnley,Preston North End,1-0,1,0,1,1,1,1,H
1925-01-03,1924,Bury,Bolton Wanderers,1-0,1,0,1,1,1,1,H
1925-01-03,1924,Leeds United,Cardiff City,0-0,0,0,1,1,0,0,D
1925-01-03,1924,Liverpool,Arsenal,2-1,2,1,1,1,3,1,H
1925-01-03,1924,Newcastle United,Aston Villa,4-1,4,1,1,1,5,3,H
1925-01-03,1924,Nottingham Forest,Manchester City,0-3,0,3,1,1,3,-3,A
1925-01-03,1924,Sheffield United,Huddersfield Town,1-1,1,1,1,1,2,0,D
1925-01-03,1924,Tottenham Hotspur,Notts County,1-1,1,1,1,1,2,0,D
1925-01-03,1924,West Bromwich Albion,Everton,3-0,3,0,1,1,3,3,H
1925-01-03,1924,West Ham United,Blackburn Rovers,2-0,2,0,1,1,2,2,H
1925-01-17,1924,Arsenal,Newcastle United,0-2,0,2,1,1,2,-2,A
1925-01-17,1924,Aston Villa,Sheffield United,1-1,1,1,1,1,2,0,D
1925-01-17,1924,Blackburn Rovers,Burnley,0-3,0,3,1,1,3,-3,A
1925-01-17,1924,Bury,Nottingham Forest,3-0,3,0,1,1,3,3,H
1925-01-17,1924,Cardiff City,Birmingham City,1-0,1,0,1,1,1,1,H
1925-01-17,1924,Everton,Tottenham Hotspur,1-0,1,0,1,1,1,1,H
1925-01-17,1924,Huddersfield Town,West Ham United,1-2,1,2,1,1,3,-1,A
1925-01-17,1924,Manchester City,Liverpool,5-0,5,0,1,1,5,5,H
1925-01-17,1924,Notts County,Bolton Wanderers,0-1,0,1,1,1,1,-1,A
1925-01-17,1924,Preston North End,Leeds United,1-4,1,4,1,1,5,-3,A
1925-01-17,1924,Sunderland,West Bromwich Albion,3-0,3,0,1,1,3,3,H
1925-01-21,1924,Aston Villa,Liverpool,1-4,1,4,1,1,5,-3,A
1925-01-24,1924,Birmingham City,Preston North End,3-0,3,0,1,1,3,3,H
1925-01-24,1924,Blackburn Rovers,Huddersfield Town,2-3,2,3,1,1,5,-1,A
1925-01-24,1924,Bolton Wanderers,Everton,1-0,1,0,1,1,1,1,H
1925-01-24,1924,Leeds United,Burnley,0-2,0,2,1,1,2,-2,A
1925-01-24,1924,Liverpool,Bury,4-0,4,0,1,1,4,4,H
1925-01-24,1924,Newcastle United,Manchester City,2-0,2,0,1,1,2,2,H
1925-01-24,1924,Nottingham Forest,Notts County,0-0,0,0,1,1,0,0,D
1925-01-24,1924,Sheffield United,Arsenal,2-1,2,1,1,1,3,1,H
1925-01-24,1924,Tottenham Hotspur,Sunderland,1-0,1,0,1,1,1,1,H
1925-01-24,1924,West Bromwich Albion,Cardiff City,1-0,1,0,1,1,1,1,H
1925-01-24,1924,West Ham United,Aston Villa,2-0,2,0,1,1,2,2,H
1925-01-31,1924,Huddersfield Town,Leeds United,2-0,2,0,1,1,2,2,H
1925-01-31,1924,Manchester City,Bury,0-0,0,0,1,1,0,0,D
1925-02-02,1924,Burnley,Birmingham City,3-2,3,2,1,1,5,1,H
1925-02-04,1924,Nottingham Forest,Liverpool,0-1,0,1,1,1,1,-1,A
1925-02-07,1924,Birmingham City,Leeds United,0-0,0,0,1,1,0,0,D
1925-02-07,1924,Blackburn Rovers,Arsenal,1-0,1,0,1,1,1,1,H
1925-02-07,1924,Bolton Wanderers,Cardiff City,3-0,3,0,1,1,3,3,H
1925-02-07,1924,Huddersfield Town,Aston Villa,4-1,4,1,1,1,5,3,H
1925-02-07,1924,Liverpool,Everton,3-1,3,1,1,1,4,2,H
1925-02-07,1924,Newcastle United,Nottingham Forest,4-1,4,1,1,1,5,3,H
1925-02-07,1924,Notts County,Sunderland,4-1,4,1,1,1,5,3,H
1925-02-07,1924,Sheffield United,Bury,0-1,0,1,1,1,1,-1,A
1925-02-07,1924,Tottenham Hotspur,Preston North End,2-0,2,0,1,1,2,2,H
1925-02-07,1924,West Bromwich Albion,Burnley,1-4,1,4,1,1,5,-3,A
1925-02-07,1924,West Ham United,Manchester City,4-0,4,0,1,1,4,4,H
1925-02-11,1924,Bury,Newcastle United,0-0,0,0,1,1,0,0,D
1925-02-11,1924,Cardiff City,Burnley,4-0,4,0,1,1,4,4,H
1925-02-11,1924,Sunderland,Bolton Wanderers,1-0,1,0,1,1,1,1,H
1925-02-12,1924,Preston North End,West Bromwich Albion,1-2,1,2,1,1,3,-1,A
1925-02-14,1924,Arsenal,Huddersfield Town,0-5,0,5,1,1,5,-5,A
1925-02-14,1924,Aston Villa,Birmingham City,1-0,1,0,1,1,1,1,H
1925-02-14,1924,Burnley,Tottenham Hotspur,1-4,1,4,1,1,5,-3,A
1925-02-14,1924,Bury,West Ham United,4-2,4,2,1,1,6,2,H
1925-02-14,1924,Cardiff City,Notts County,1-1,1,1,1,1,2,0,D
1925-02-14,1924,Leeds United,West Bromwich Albion,0-1,0,1,1,1,1,-1,A
1925-02-14,1924,Liverpool,Newcastle United,1-1,1,1,1,1,2,0,D
1925-02-14,1924,Manchester City,Blackburn Rovers,1-3,1,3,1,1,4,-2,A
1925-02-14,1924,Nottingham Forest,Sheffield United,2-3,2,3,1,1,5,-1,A
1925-02-14,1924,Preston North End,Bolton Wanderers,1-0,1,0,1,1,1,1,H
1925-02-14,1924,Sunderland,Everton,4-1,4,1,1,1,5,3,H
1925-02-21,1924,Bolton Wanderers,Burnley,5-0,5,0,1,1,5,5,H
1925-02-21,1924,Huddersfield Town,Manchester City,1-1,1,1,1,1,2,0,D
1925-02-21,1924,Newcastle United,Sunderland,2-0,2,0,1,1,2,2,H
1925-02-23,1924,Manchester City,Sheffield United,2-1,2,1,1,1,3,1,H
1925-02-25,1924,Everton,Cardiff City,1-2,1,2,1,1,3,-1,A
1925-02-28,1924,Birmingham City,Huddersfield Town,0-1,0,1,1,1,1,-1,A
1925-02-28,1924,Bolton Wanderers,Manchester City,4-2,4,2,1,1,6,2,H
1925-02-28,1924,Burnley,West Ham United,5-4,5,4,1,1,9,1,H
1925-02-28,1924,Cardiff City,Newcastle United,3-0,3,0,1,1,3,3,H
1925-02-28,1924,Everton,Nottingham Forest,3-1,3,1,1,1,4,2,H
1925-02-28,1924,Leeds United,Blackburn Rovers,1-1,1,1,1,1,2,0,D
1925-02-28,1924,Notts County,Bury,1-1,1,1,1,1,2,0,D
1925-02-28,1924,Preston North End,Sheffield United,0-1,0,1,1,1,1,-1,A
1925-02-28,1924,Sunderland,Liverpool,3-0,3,0,1,1,3,3,H
1925-02-28,1924,Tottenham Hotspur,Arsenal,2-0,2,0,1,1,2,2,H
1925-02-28,1924,West Bromwich Albion,Aston Villa,4-1,4,1,1,1,5,3,H
1925-03-07,1924,Arsenal,Bolton Wanderers,1-0,1,0,1,1,1,1,H
1925-03-07,1924,Aston Villa,Tottenham Hotspur,0-1,0,1,1,1,1,-1,A
1925-03-07,1924,Bury,Everton,1-0,1,0,1,1,1,1,H
1925-03-07,1924,Manchester City,Notts County,2-1,2,1,1,1,3,1,H
1925-03-07,1924,Newcastle United,Preston North End,3-1,3,1,1,1,4,2,H
1925-03-07,1924,Nottingham Forest,Sunderland,1-1,1,1,1,1,2,0,D
1925-03-07,1924,West Ham United,Leeds United,0-0,0,0,1,1,0,0,D
1925-03-09,1924,Tottenham Hotspur,Leeds United,2-1,2,1,1,1,3,1,H
1925-03-11,1924,Huddersfield Town,West Bromwich Albion,1-1,1,1,1,1,2,0,D
1925-03-14,1924,Birmingham City,West Ham United,1-1,1,1,1,1,2,0,D
1925-03-14,1924,Bolton Wanderers,Aston Villa,4-0,4,0,1,1,4,4,H
1925-03-14,1924,Burnley,Newcastle United,1-3,1,3,1,1,4,-2,A
1925-03-14,1924,Cardiff City,Nottingham Forest,2-0,2,0,1,1,2,2,H
1925-03-14,1924,Leeds United,Sheffield United,1-1,1,1,1,1,2,0,D
1925-03-14,1924,Notts County,Arsenal,2-1,2,1,1,1,3,1,H
1925-03-14,1924,Preston North End,Liverpool,4-0,4,0,1,1,4,4,H
1925-03-14,1924,Sunderland,Bury,1-1,1,1,1,1,2,0,D
1925-03-14,1924,Tottenham Hotspur,Huddersfield Town,1-2,1,2,1,1,3,-1,A
1925-03-14,1924,West Bromwich Albion,Blackburn Rovers,1-1,1,1,1,1,2,0,D
1925-03-16,1924,Birmingham City,West Bromwich Albion,0-0,0,0,1,1,0,0,D
1925-03-16,1924,Sheffield United,Liverpool,0-1,0,1,1,1,1,-1,A
1925-03-18,1924,Cardiff City,Tottenham Hotspur,0-2,0,2,1,1,2,-2,A
1925-03-18,1924,Everton,Notts County,1-0,1,0,1,1,1,1,H
1925-03-19,1924,Blackburn Rovers,Bury,0-1,0,1,1,1,1,-1,A
1925-03-21,1924,Arsenal,Everton,3-1,3,1,1,1,4,2,H
1925-03-21,1924,Aston Villa,Notts County,0-0,0,0,1,1,0,0,D
1925-03-21,1924,Blackburn Rovers,Tottenham Hotspur,1-1,1,1,1,1,2,0,D
1925-03-21,1924,Bury,Cardiff City,4-1,4,1,1,1,5,3,H
1925-03-21,1924,Huddersfield Town,Bolton Wanderers,0-0,0,0,1,1,0,0,D
1925-03-21,1924,Liverpool,Burnley,3-0,3,0,1,1,3,3,H
1925-03-21,1924,Manchester City,Sunderland,1-3,1,3,1,1,4,-2,A
1925-03-21,1924,Newcastle United,Leeds United,4-1,4,1,1,1,5,3,H
1925-03-21,1924,Nottingham Forest,Preston North End,0-1,0,1,1,1,1,-1,A
1925-03-21,1924,Sheffield United,Birmingham City,4-3,4,3,1,1,7,1,H
1925-03-21,1924,West Ham United,West Bromwich Albion,2-1,2,1,1,1,3,1,H
1925-03-23,1924,Arsenal,West Ham United,1-2,1,2,1,1,3,-1,A
1925-03-28,1924,Birmingham City,Newcastle United,1-1,1,1,1,1,2,0,D
1925-03-28,1924,Burnley,Nottingham Forest,0-0,0,0,1,1,0,0,D
1925-03-28,1924,Everton,Aston Villa,2-0,2,0,1,1,2,2,H
1925-03-28,1924,Leeds United,Liverpool,4-1,4,1,1,1,5,3,H
1925-03-28,1924,Preston North End,Bury,1-1,1,1,1,1,2,0,D
1925-03-28,1924,Sunderland,Arsenal,2-0,2,0,1,1,2,2,H
1925-03-28,1924,Tottenham Hotspur,West Ham United,1-1,1,1,1,1,2,0,D
1925-03-30,1924,West Bromwich Albion,Sheffield United,2-1,2,1,1,1,3,1,H
1925-04-01,1924,Aston Villa,Arsenal,4-0,4,0,1,1,4,4,H
1925-04-01,1924,Cardiff City,Manchester City,0-2,0,2,1,1,2,-2,A
1925-04-01,1924,Notts County,Preston North End,1-0,1,0,1,1,1,1,H
1925-04-02,1924,Blackburn Rovers,Birmingham City,7-1,7,1,1,1,8,6,H
1925-04-02,1924,West Ham United,Nottingham Forest,0-0,0,0,1,1,0,0,D
1925-04-04,1924,Arsenal,Cardiff City,1-1,1,1,1,1,2,0,D
1925-04-04,1924,Aston Villa,Sunderland,1-4,1,4,1,1,5,-3,A
1925-04-04,1924,Blackburn Rovers,Notts County,0-2,0,2,1,1,2,-2,A
1925-04-04,1924,Bury,Burnley,1-0,1,0,1,1,1,1,H
1925-04-04,1924,Huddersfield Town,Everton,2-0,2,0,1,1,2,2,H
1925-04-04,1924,Liverpool,Birmingham City,1-1,1,1,1,1,2,0,D
1925-04-04,1924,Manchester City,Preston North End,2-1,2,1,1,1,3,1,H
1925-04-04,1924,Newcastle United,West Bromwich Albion,0-1,0,1,1,1,1,-1,A
1925-04-04,1924,Nottingham Forest,Leeds United,4-0,4,0,1,1,4,4,H
1925-04-04,1924,Sheffield United,Tottenham Hotspur,2-0,2,0,1,1,2,2,H
1925-04-04,1924,West Ham United,Bolton Wanderers,1-1,1,1,1,1,2,0,D
1925-04-06,1924,Sheffield United,Burnley,4-0,4,0,1,1,4,4,H
1925-04-10,1924,Aston Villa,Manchester City,2-1,2,1,1,1,3,1,H
1925-04-10,1924,Bolton Wanderers,Leeds United,1-0,1,0,1,1,1,1,H
1925-04-10,1924,Burnley,Notts County,1-1,1,1,1,1,2,0,D
1925-04-10,1924,Bury,Huddersfield Town,0-1,0,1,1,1,1,-1,A
1925-04-10,1924,Liverpool,West Ham United,2-0,2,0,1,1,2,2,H
1925-04-10,1924,Nottingham Forest,Blackburn Rovers,0-2,0,2,1,1,2,-2,A
1925-04-10,1924,Preston North End,Everton,1-1,1,1,1,1,2,0,D
1925-04-10,1924,Tottenham Hotspur,Birmingham City,0-1,0,1,1,1,1,-1,A
1925-04-11,1924,Birmingham City,Nottingham Forest,1-1,1,1,1,1,2,0,D
1925-04-11,1924,Bolton Wanderers,Sheffield United,3-1,3,1,1,1,4,2,H
1925-04-11,1924,Burnley,Manchester City,1-0,1,0,1,1,1,1,H
1925-04-11,1924,Cardiff City,Aston Villa,2-1,2,1,1,1,3,1,H
1925-04-11,1924,Everton,Blackburn Rovers,1-0,1,0,1,1,1,1,H
1925-04-11,1924,Leeds United,Bury,1-0,1,0,1,1,1,1,H
1925-04-11,1924,Notts County,West Ham United,4-1,4,1,1,1,5,3,H
1925-04-11,1924,Preston North End,Arsenal,2-0,2,0,1,1,2,2,H
1925-04-11,1924,Sunderland,Huddersfield Town,1-1,1,1,1,1,2,0,D
1925-04-11,1924,Tottenham Hotspur,Newcastle United,3-0,3,0,1,1,3,3,H
1925-04-11,1924,West Bromwich Albion,Liverpool,0-0,0,0,1,1,0,0,D
1925-04-13,1924,Blackburn Rovers,Nottingham Forest,0-0,0,0,1,1,0,0,D
1925-04-13,1924,Cardiff City,Sunderland,2-0,2,0,1,1,2,2,H
1925-04-13,1924,Everton,Preston North End,0-0,0,0,1,1,0,0,D
1925-04-13,1924,Manchester City,Aston Villa,1-0,1,0,1,1,1,1,H
1925-04-13,1924,Notts County,Burnley,2-0,2,0,1,1,2,2,H
1925-04-13,1924,Sheffield United,Newcastle United,1-2,1,2,1,1,3,-1,A
1925-04-13,1924,West Bromwich Albion,Arsenal,2-0,2,0,1,1,2,2,H
1925-04-13,1924,West Ham United,Liverpool,0-1,0,1,1,1,1,-1,A
1925-04-14,1924,Arsenal,West Bromwich Albion,2-0,2,0,1,1,2,2,H
1925-04-14,1924,Huddersfield Town,Bury,2-0,2,0,1,1,2,2,H
1925-04-14,1924,Leeds United,Bolton Wanderers,2-1,2,1,1,1,3,1,H
1925-04-14,1924,West Ham United,Sheffield United,6-2,6,2,1,1,8,4,H
1925-04-15,1924,Cardiff City,Blackburn Rovers,3-0,3,0,1,1,3,3,H
1925-04-18,1924,Arsenal,Burnley,5-0,5,0,1,1,5,5,H
1925-04-18,1924,Aston Villa,Preston North End,1-0,1,0,1,1,1,1,H
1925-04-18,1924,Blackburn Rovers,Sunderland,1-1,1,1,1,1,2,0,D
1925-04-18,1924,Bury,Birmingham City,1-4,1,4,1,1,5,-3,A
1925-04-18,1924,Huddersfield Town,Cardiff City,0-0,0,0,1,1,0,0,D
1925-04-18,1924,Liverpool,Tottenham Hotspur,1-0,1,0,1,1,1,1,H
1925-04-18,1924,Manchester City,Leeds United,4-2,4,2,1,1,6,2,H
1925-04-18,1924,Newcastle United,Bolton Wanderers,0-1,0,1,1,1,1,-1,A
1925-04-18,1924,Nottingham Forest,West Bromwich Albion,0-1,0,1,1,1,1,-1,A
1925-04-18,1924,Sheffield United,Notts County,2-0,2,0,1,1,2,2,H
1925-04-18,1924,West Ham United,Everton,4-1,4,1,1,1,5,3,H
1925-04-22,1924,Bolton Wanderers,Blackburn Rovers,6-0,6,0,1,1,6,6,H
1925-04-25,1924,Birmingham City,Manchester City,2-1,2,1,1,1,3,1,H
1925-04-25,1924,Bolton Wanderers,Liverpool,2-0,2,0,1,1,2,2,H
1925-04-25,1924,Burnley,Aston Villa,1-1,1,1,1,1,2,0,D
1925-04-25,1924,Leeds United,Arsenal,1-0,1,0,1,1,1,1,H
1925-04-25,1924,Notts County,Newcastle United,2-0,2,0,1,1,2,2,H
1925-04-25,1924,Preston North End,Huddersfield Town,1-4,1,4,1,1,5,-3,A
1925-04-25,1924,Sunderland,West Ham United,1-1,1,1,1,1,2,0,D
1925-04-25,1924,Tottenham Hotspur,Nottingham Forest,1-0,1,0,1,1,1,1,H
1925-04-25,1924,West Bromwich Albion,Bury,1-1,1,1,1,1,2,0,D
1925-04-27,1924,Everton,Sheffield United,1-1,1,1,1,1,2,0,D
1925-04-29,1924,Aston Villa,Blackburn Rovers,4-3,4,3,1,1,7,1,H
1925-04-29,1924,Liverpool,Cardiff City,1-2,1,2,1,1,3,-1,A
1925-04-29,1924,Notts County,Huddersfield Town,1-1,1,1,1,1,2,0,D
1925-05-02,1924,Aston Villa,Nottingham Forest,2-0,2,0,1,1,2,2,H
1925-05-02,1924,Bury,Arsenal,2-0,2,0,1,1,2,2,H
1925-05-02,1924,Cardiff City,Preston North End,0-0,0,0,1,1,0,0,D
1925-05-02,1924,Everton,Leeds United,1-0,1,0,1,1,1,1,H
1925-05-02,1924,Huddersfield Town,Liverpool,1-1,1,1,1,1,2,0,D
1925-05-02,1924,Manchester City,Tottenham Hotspur,1-0,1,0,1,1,1,1,H
1925-05-02,1924,Notts County,Birmingham City,0-1,0,1,1,1,1,-1,A
1925-05-02,1924,Sunderland,Burnley,1-1,1,1,1,1,2,0,D
1925-05-02,1924,West Bromwich Albion,Bolton Wanderers,0-0,0,0,1,1,0,0,D
1925-08-29,1925,Arsenal,Tottenham Hotspur,0-1,0,1,1,1,1,-1,A
1925-08-29,1925,Aston Villa,Burnley,10-0,10,0,1,1,10,10,H
1925-08-29,1925,Blackburn Rovers,Bury,1-2,1,2,1,1,3,-1,A
1925-08-29,1925,Bolton Wanderers,Newcastle United,2-2,2,2,1,1,4,0,D
1925-08-29,1925,Everton,Sheffield United,2-2,2,2,1,1,4,0,D
1925-08-29,1925,Huddersfield Town,West Bromwich Albion,1-1,1,1,1,1,2,0,D
1925-08-29,1925,Leicester City,Liverpool,3-1,3,1,1,1,4,2,H
1925-08-29,1925,Manchester City,Cardiff City,3-2,3,2,1,1,5,1,H
1925-08-29,1925,Notts County,Leeds United,1-0,1,0,1,1,1,1,H
1925-08-29,1925,Sunderland,Birmingham City,3-1,3,1,1,1,4,2,H
1925-08-29,1925,West Ham United,Manchester United,1-0,1,0,1,1,1,1,H
1925-08-31,1925,Arsenal,Leicester City,2-2,2,2,1,1,4,0,D
1925-08-31,1925,Birmingham City,Manchester City,1-0,1,0,1,1,1,1,H
1925-08-31,1925,Leeds United,Bolton Wanderers,2-1,2,1,1,1,3,1,H
1925-08-31,1925,Sheffield United,Tottenham Hotspur,2-3,2,3,1,1,5,-1,A
1925-08-31,1925,West Ham United,Cardiff City,3-1,3,1,1,1,4,2,H
1925-09-02,1925,Liverpool,Notts County,2-0,2,0,1,1,2,2,H
1925-09-02,1925,Manchester United,Aston Villa,3-0,3,0,1,1,3,3,H
1925-09-02,1925,Sunderland,Blackburn Rovers,6-2,6,2,1,1,8,4,H
1925-09-02,1925,West Bromwich Albion,Everton,1-1,1,1,1,1,2,0,D
1925-09-05,1925,Birmingham City,Blackburn Rovers,2-0,2,0,1,1,2,2,H
1925-09-05,1925,Burnley,Leicester City,4-0,4,0,1,1,4,4,H
1925-09-05,1925,Bury,Bolton Wanderers,0-5,0,5,1,1,5,-5,A
1925-09-05,1925,Cardiff City,Everton,2-1,2,1,1,1,3,1,H
1925-09-05,1925,Leeds United,Aston Villa,2-2,2,2,1,1,4,0,D
1925-09-05,1925,Liverpool,West Ham United,0-0,0,0,1,1,0,0,D
1925-09-05,1925,Manchester United,Arsenal,0-1,0,1,1,1,1,-1,A
1925-09-05,1925,Newcastle United,Notts County,6-3,6,3,1,1,9,3,H
1925-09-05,1925,Sheffield United,Huddersfield Town,2-3,2,3,1,1,5,-1,A
1925-09-05,1925,Tottenham Hotspur,Manchester City,1-0,1,0,1,1,1,1,H
1925-09-05,1925,West Bromwich Albion,Sunderland,2-5,2,5,1,1,7,-3,A
1925-09-07,1925,Aston Villa,Manchester United,2-2,2,2,1,1,4,0,D
1925-09-07,1925,Bolton Wanderers,Leeds United,1-0,1,0,1,1,1,1,H
1925-09-07,1925,Burnley,Notts County,0-0,0,0,1,1,0,0,D
1925-09-07,1925,Cardiff City,West Ham United,0-1,0,1,1,1,1,-1,A
1925-09-07,1925,Leicester City,Arsenal,0-1,0,1,1,1,1,-1,A
1925-09-07,1925,Tottenham Hotspur,Sheffield United,3-2,3,2,1,1,5,1,H
1925-09-08,1925,Huddersfield Town,Bury,2-1,2,1,1,1,3,1,H
1925-09-09,1925,Burnley,Bolton Wanderers,1-1,1,1,1,1,2,0,D
1925-09-09,1925,Everton,Birmingham City,2-2,2,2,1,1,4,0,D
1925-09-09,1925,Newcastle United,Blackburn Rovers,1-7,1,7,1,1,8,-6,A
1925-09-12,1925,Arsenal,Liverpool,1-1,1,1,1,1,2,0,D
1925-09-12,1925,Aston Villa,Newcastle United,2-2,2,2,1,1,4,0,D
1925-09-12,1925,Blackburn Rovers,West Bromwich Albion,1-2,1,2,1,1,3,-1,A
1925-09-12,1925,Bury,Birmingham City,2-1,2,1,1,1,3,1,H
1925-09-12,1925,Everton,Tottenham Hotspur,1-1,1,1,1,1,2,0,D
1925-09-12,1925,Huddersfield Town,Cardiff City,1-1,1,1,1,1,2,0,D
1925-09-12,1925,Leicester City,Leeds United,1-3,1,3,1,1,4,-2,A
1925-09-12,1925,Manchester City,Manchester United,1-1,1,1,1,1,2,0,D
1925-09-12,1925,Notts County,Bolton Wanderers,3-0,3,0,1,1,3,3,H
1925-09-12,1925,Sunderland,Sheffield United,6-1,6,1,1,1,7,5,H
1925-09-12,1925,West Ham United,Burnley,2-0,2,0,1,1,2,2,H
1925-09-14,1925,Tottenham Hotspur,Cardiff City,1-2,1,2,1,1,3,-1,A
1925-09-16,1925,Birmingham City,Huddersfield Town,1-3,1,3,1,1,4,-2,A
1925-09-16,1925,Bolton Wanderers,Burnley,4-2,4,2,1,1,6,2,H
1925-09-16,1925,Everton,West Bromwich Albion,4-0,4,0,1,1,4,4,H
1925-09-16,1925,Leeds United,Newcastle United,2-0,2,0,1,1,2,2,H
1925-09-16,1925,Manchester United,Leicester City,3-2,3,2,1,1,5,1,H
1925-09-19,1925,Birmingham City,Notts County,0-1,0,1,1,1,1,-1,A
1925-09-19,1925,Bolton Wanderers,Aston Villa,1-3,1,3,1,1,4,-2,A
1925-09-19,1925,Burnley,Arsenal,2-2,2,2,1,1,4,0,D
1925-09-19,1925,Leeds United,West Ham United,5-2,5,2,1,1,7,3,H
1925-09-19,1925,Liverpool,Manchester United,5-0,5,0,1,1,5,5,H
1925-09-19,1925,Manchester City,Everton,4-4,4,4,1,1,8,0,D
1925-09-19,1925,Newcastle United,Leicester City,3-2,3,2,1,1,5,1,H
1925-09-19,1925,Sheffield United,Blackburn Rovers,1-1,1,1,1,1,2,0,D
1925-09-19,1925,Tottenham Hotspur,Huddersfield Town,5-5,5,5,1,1,10,0,D
1925-09-21,1925,Arsenal,West Ham United,3-2,3,2,1,1,5,1,H
1925-09-21,1925,Birmingham City,Everton,3-1,3,1,1,1,4,2,H
1925-09-21,1925,Blackburn Rovers,Sunderland,3-0,3,0,1,1,3,3,H
1925-09-21,1925,Cardiff City,Tottenham Hotspur,0-1,0,1,1,1,1,-1,A
1925-09-21,1925,Notts County,Burnley,0-1,0,1,1,1,1,-1,A
1925-09-23,1925,Cardiff City,Sunderland,0-1,0,1,1,1,1,-1,A
1925-09-23,1925,West Bromwich Albion,Manchester City,4-1,4,1,1,1,5,3,H
1925-09-26,1925,Arsenal,Leeds United,4-1,4,1,1,1,5,3,H
1925-09-26,1925,Aston Villa,Notts County,2-1,2,1,1,1,3,1,H
1925-09-26,1925,Birmingham City,West Bromwich Albion,3-0,3,0,1,1,3,3,H
1925-09-26,1925,Blackburn Rovers,Cardiff City,6-3,6,3,1,1,9,3,H
1925-09-26,1925,Bury,Sheffield United,7-4,7,4,1,1,11,3,H
1925-09-26,1925,Huddersfield Town,Manchester City,2-2,2,2,1,1,4,0,D
1925-09-26,1925,Leicester City,Bolton Wanderers,5-2,5,2,1,1,7,3,H
1925-09-26,1925,Liverpool,Everton,5-1,5,1,1,1,6,4,H
1925-09-26,1925,Manchester United,Burnley,6-1,6,1,1,1,7,5,H
1925-09-26,1925,Sunderland,Tottenham Hotspur,3-0,3,0,1,1,3,3,H
1925-09-26,1925,West Ham United,Newcastle United,1-0,1,0,1,1,1,1,H
1925-10-01,1925,Notts County,Liverpool,1-2,1,2,1,1,3,-1,A
1925-10-03,1925,Bolton Wanderers,West Ham United,1-0,1,0,1,1,1,1,H
1925-10-03,1925,Burnley,Liverpool,2-1,2,1,1,1,3,1,H
1925-10-03,1925,Cardiff City,Bury,3-2,3,2,1,1,5,1,H
1925-10-03,1925,Everton,Huddersfield Town,2-3,2,3,1,1,5,-1,A
1925-10-03,1925,Leeds United,Manchester United,2-0,2,0,1,1,2,2,H
1925-10-03,1925,Manchester City,Sunderland,4-1,4,1,1,1,5,3,H
1925-10-03,1925,Newcastle United,Arsenal,7-0,7,0,1,1,7,7,H
1925-10-03,1925,Notts County,Leicester City,2-2,2,2,1,1,4,0,D
1925-10-03,1925,Sheffield United,Birmingham City,4-1,4,1,1,1,5,3,H
1925-10-03,1925,Tottenham Hotspur,Blackburn Rovers,4-2,4,2,1,1,6,2,H
1925-10-03,1925,West Bromwich Albion,Aston Villa,1-1,1,1,1,1,2,0,D
1925-10-05,1925,Aston Villa,Sunderland,4-2,4,2,1,1,6,2,H
1925-10-05,1925,West Ham United,Arsenal,0-4,0,4,1,1,4,-4,A
1925-10-10,1925,Arsenal,Bolton Wanderers,2-3,2,3,1,1,5,-1,A
1925-10-10,1925,Birmingham City,Cardiff City,3-2,3,2,1,1,5,1,H
1925-10-10,1925,Blackburn Rovers,Manchester City,3-3,3,3,1,1,6,0,D
1925-10-10,1925,Bury,Tottenham Hotspur,3-0,3,0,1,1,3,3,H
1925-10-10,1925,Huddersfield Town,Burnley,2-1,2,1,1,1,3,1,H
1925-10-10,1925,Leicester City,Aston Villa,1-2,1,2,1,1,3,-1,A
1925-10-10,1925,Liverpool,Leeds United,1-1,1,1,1,1,2,0,D
1925-10-10,1925,Manchester United,Newcastle United,2-1,2,1,1,1,3,1,H
1925-10-10,1925,Sunderland,Everton,7-3,7,3,1,1,10,4,H
1925-10-10,1925,West Bromwich Albion,Sheffield United,2-0,2,0,1,1,2,2,H
1925-10-10,1925,West Ham United,Notts County,1-0,1,0,1,1,1,1,H
1925-10-12,1925,Blackburn Rovers,Newcastle United,1-2,1,2,1,1,3,-1,A
1925-10-14,1925,Sunderland,Bury,1-0,1,0,1,1,1,1,H
1925-10-17,1925,Arsenal,Cardiff City,5-0,5,0,1,1,5,5,H
1925-10-17,1925,Aston Villa,Birmingham City,3-3,3,3,1,1,6,0,D
1925-10-17,1925,Bolton Wanderers,Blackburn Rovers,2-2,2,2,1,1,4,0,D
1925-10-17,1925,Burnley,Everton,1-3,1,3,1,1,4,-2,A
1925-10-17,1925,Leeds United,Huddersfield Town,0-4,0,4,1,1,4,-4,A
1925-10-17,1925,Leicester City,West Bromwich Albion,3-0,3,0,1,1,3,3,H
1925-10-17,1925,Liverpool,Manchester City,2-1,2,1,1,1,3,1,H
1925-10-17,1925,Manchester United,Tottenham Hotspur,0-0,0,0,1,1,0,0,D
1925-10-17,1925,Newcastle United,Sunderland,0-0,0,0,1,1,0,0,D
1925-10-17,1925,Notts County,Bury,4-1,4,1,1,1,5,3,H
1925-10-17,1925,West Ham United,Sheffield United,1-3,1,3,1,1,4,-2,A
1925-10-24,1925,Birmingham City,Leicester City,1-1,1,1,1,1,2,0,D
1925-10-24,1925,Blackburn Rovers,Notts County,4-1,4,1,1,1,5,3,H
1925-10-24,1925,Bury,Aston Villa,2-3,2,3,1,1,5,-1,A
1925-10-24,1925,Cardiff City,Manchester United,0-2,0,2,1,1,2,-2,A
1925-10-24,1925,Everton,Leeds United,4-2,4,2,1,1,6,2,H
1925-10-24,1925,Huddersfield Town,Newcastle United,0-1,0,1,1,1,1,-1,A
1925-10-24,1925,Manchester City,Burnley,8-3,8,3,1,1,11,5,H
1925-10-24,1925,Sheffield United,Arsenal,4-0,4,0,1,1,4,4,H
1925-10-24,1925,Sunderland,Bolton Wanderers,2-1,2,1,1,1,3,1,H
1925-10-24,1925,Tottenham Hotspur,Liverpool,3-1,3,1,1,1,4,2,H
1925-10-24,1925,West Bromwich Albion,West Ham United,7-1,7,1,1,1,8,6,H
1925-10-26,1925,Sheffield United,Manchester City,8-3,8,3,1,1,11,5,H
1925-10-28,1925,Bury,Sunderland,2-2,2,2,1,1,4,0,D
1925-10-31,1925,Arsenal,Everton,4-1,4,1,1,1,5,3,H
1925-10-31,1925,Aston Villa,Cardiff City,0-2,0,2,1,1,2,-2,A
1925-10-31,1925,Bolton Wanderers,West Bromwich Albion,2-2,2,2,1,1,4,0,D
1925-10-31,1925,Burnley,Blackburn Rovers,1-3,1,3,1,1,4,-2,A
1925-10-31,1925,Leeds United,Bury,2-3,2,3,1,1,5,-1,A
1925-10-31,1925,Leicester City,Tottenham Hotspur,5-3,5,3,1,1,8,2,H
1925-10-31,1925,Liverpool,Sunderland,2-2,2,2,1,1,4,0,D
1925-10-31,1925,Manchester United,Huddersfield Town,1-1,1,1,1,1,2,0,D
1925-10-31,1925,Newcastle United,Birmingham City,1-3,1,3,1,1,4,-2,A
1925-10-31,1925,Notts County,Sheffield United,2-0,2,0,1,1,2,2,H
1925-10-31,1925,West Ham United,Manchester City,3-1,3,1,1,1,4,2,H
1925-11-04,1925,Manchester City,Sheffield United,2-4,2,4,1,1,6,-2,A
1925-11-07,1925,Birmingham City,Bolton Wanderers,0-1,0,1,1,1,1,-1,A
1925-11-07,1925,Blackburn Rovers,Leeds United,2-2,2,2,1,1,4,0,D
1925-11-07,1925,Bury,Newcastle United,1-1,1,1,1,1,2,0,D
1925-11-07,1925,Cardiff City,Leicester City,5-2,5,2,1,1,7,3,H
1925-11-07,1925,Everton,Manchester United,1-3,1,3,1,1,4,-2,A
1925-11-07,1925,Manchester City,Arsenal,2-5,2,5,1,1,7,-3,A
1925-11-07,1925,Sheffield United,Aston Villa,4-1,4,1,1,1,5,3,H
1925-11-07,1925,Sunderland,Burnley,2-2,2,2,1,1,4,0,D
1925-11-07,1925,Tottenham Hotspur,West Ham United,4-2,4,2,1,1,6,2,H
1925-11-07,1925,West Bromwich Albion,Notts County,4-4,4,4,1,1,8,0,D
1925-11-09,1925,West Bromwich Albion,Bury,4-0,4,0,1,1,4,4,H
1925-11-14,1925,Arsenal,Bury,6-1,6,1,1,1,7,5,H
1925-11-14,1925,Aston Villa,Huddersfield Town,3-0,3,0,1,1,3,3,H
1925-11-14,1925,Bolton Wanderers,Manchester City,5-1,5,1,1,1,6,4,H
1925-11-14,1925,Burnley,Sheffield United,1-1,1,1,1,1,2,0,D
1925-11-14,1925,Leeds United,Cardiff City,1-0,1,0,1,1,1,1,H
1925-11-14,1925,Leicester City,Sunderland,4-1,4,1,1,1,5,3,H
1925-11-14,1925,Liverpool,West Bromwich Albion,2-0,2,0,1,1,2,2,H
1925-11-14,1925,Manchester United,Birmingham City,3-1,3,1,1,1,4,2,H
1925-11-14,1925,Newcastle United,Tottenham Hotspur,3-1,3,1,1,1,4,2,H
1925-11-14,1925,Notts County,Everton,0-3,0,3,1,1,3,-3,A
1925-11-14,1925,West Ham United,Blackburn Rovers,2-1,2,1,1,1,3,1,H
1925-11-21,1925,Birmingham City,Liverpool,2-0,2,0,1,1,2,2,H
1925-11-21,1925,Blackburn Rovers,Arsenal,2-3,2,3,1,1,5,-1,A
1925-11-21,1925,Bury,Manchester United,1-3,1,3,1,1,4,-2,A
1925-11-21,1925,Cardiff City,Newcastle United,0-0,0,0,1,1,0,0,D
1925-11-21,1925,Everton,Aston Villa,1-1,1,1,1,1,2,0,D
1925-11-21,1925,Huddersfield Town,Leicester City,3-0,3,0,1,1,3,3,H
1925-11-21,1925,Manchester City,Notts County,1-1,1,1,1,1,2,0,D
1925-11-21,1925,Sheffield United,Leeds United,2-0,2,0,1,1,2,2,H
1925-11-21,1925,Sunderland,West Ham United,4-1,4,1,1,1,5,3,H
1925-11-21,1925,Tottenham Hotspur,Bolton Wanderers,2-3,2,3,1,1,5,-1,A
1925-11-21,1925,West Bromwich Albion,Burnley,5-3,5,3,1,1,8,2,H
1925-11-25,1925,Huddersfield Town,Liverpool,0-0,0,0,1,1,0,0,D
1925-11-28,1925,Arsenal,Sunderland,2-0,2,0,1,1,2,2,H
1925-11-28,1925,Aston Villa,Manchester City,3-1,3,1,1,1,4,2,H
1925-11-28,1925,Bolton Wanderers,Cardiff City,0-1,0,1,1,1,1,-1,A
1925-11-28,1925,Leeds United,West Bromwich Albion,0-1,0,1,1,1,1,-1,A
1925-11-28,1925,Leicester City,Everton,1-1,1,1,1,1,2,0,D
1925-11-28,1925,Liverpool,Bury,0-1,0,1,1,1,1,-1,A
1925-11-28,1925,Manchester United,Blackburn Rovers,2-0,2,0,1,1,2,2,H
1925-11-28,1925,Notts County,Tottenham Hotspur,4-2,4,2,1,1,6,2,H
1925-11-28,1925,West Ham United,Huddersfield Town,2-3,2,3,1,1,5,-1,A
1925-12-05,1925,Birmingham City,Leeds United,2-1,2,1,1,1,3,1,H
1925-12-05,1925,Blackburn Rovers,Liverpool,1-1,1,1,1,1,2,0,D
1925-12-05,1925,Cardiff City,Notts County,2-1,2,1,1,1,3,1,H
1925-12-05,1925,Everton,West Ham United,2-0,2,0,1,1,2,2,H
1925-12-05,1925,Huddersfield Town,Arsenal,2-2,2,2,1,1,4,0,D
1925-12-05,1925,Manchester City,Leicester City,5-1,5,1,1,1,6,4,H
1925-12-05,1925,Sheffield United,Bolton Wanderers,2-0,2,0,1,1,2,2,H
1925-12-05,1925,Sunderland,Manchester United,2-1,2,1,1,1,3,1,H
1925-12-05,1925,Tottenham Hotspur,Aston Villa,2-2,2,2,1,1,4,0,D
1925-12-05,1925,West Bromwich Albion,Newcastle United,4-0,4,0,1,1,4,4,H
1925-12-07,1925,Burnley,Birmingham City,3-1,3,1,1,1,4,2,H
1925-12-09,1925,Newcastle United,Sheffield United,3-1,3,1,1,1,4,2,H
1925-12-12,1925,Arsenal,West Bromwich Albion,1-0,1,0,1,1,1,1,H
1925-12-12,1925,Aston Villa,Blackburn Rovers,1-2,1,2,1,1,3,-1,A
1925-12-12,1925,Bolton Wanderers,Huddersfield Town,6-1,6,1,1,1,7,5,H
1925-12-12,1925,Burnley,Tottenham Hotspur,1-2,1,2,1,1,3,-1,A
1925-12-12,1925,Leeds United,Manchester City,3-4,3,4,1,1,7,-1,A
1925-12-12,1925,Leicester City,Bury,0-2,0,2,1,1,2,-2,A
1925-12-12,1925,Liverpool,Cardiff City,0-2,0,2,1,1,2,-2,A
1925-12-12,1925,Manchester United,Sheffield United,1-2,1,2,1,1,3,-1,A
1925-12-12,1925,Newcastle United,Everton,3-3,3,3,1,1,6,0,D
1925-12-12,1925,Notts County,Sunderland,2-0,2,0,1,1,2,2,H
1925-12-12,1925,West Ham United,Birmingham City,2-2,2,2,1,1,4,0,D
1925-12-16,1925,Bury,Burnley,8-1,8,1,1,1,9,7,H
1925-12-19,1925,Birmingham City,Arsenal,1-0,1,0,1,1,1,1,H
1925-12-19,1925,Blackburn Rovers,Leicester City,0-0,0,0,1,1,0,0,D
1925-12-19,1925,Bury,West Ham United,4-1,4,1,1,1,5,3,H
1925-12-19,1925,Cardiff City,Burnley,2-3,2,3,1,1,5,-1,A
1925-12-19,1925,Everton,Bolton Wanderers,2-1,2,1,1,1,3,1,H
1925-12-19,1925,Huddersfield Town,Notts County,2-0,2,0,1,1,2,2,H
1925-12-19,1925,Manchester City,Newcastle United,2-2,2,2,1,1,4,0,D
1925-12-19,1925,Sheffield United,Liverpool,3-1,3,1,1,1,4,2,H
1925-12-19,1925,Sunderland,Aston Villa,3-2,3,2,1,1,5,1,H
1925-12-19,1925,Tottenham Hotspur,Leeds United,3-2,3,2,1,1,5,1,H
1925-12-19,1925,West Bromwich Albion,Manchester United,5-1,5,1,1,1,6,4,H
1925-12-25,1925,Arsenal,Notts County,3-0,3,0,1,1,3,3,H
1925-12-25,1925,Birmingham City,Tottenham Hotspur,3-1,3,1,1,1,4,2,H
1925-12-25,1925,Blackburn Rovers,Everton,2-2,2,2,1,1,4,0,D
1925-12-25,1925,Bury,Manchester City,6-5,6,5,1,1,11,1,H
1925-12-25,1925,Cardiff City,West Bromwich Albion,3-2,3,2,1,1,5,1,H
1925-12-25,1925,Leeds United,Burnley,2-2,2,2,1,1,4,0,D
1925-12-25,1925,Liverpool,Newcastle United,6-3,6,3,1,1,9,3,H
1925-12-25,1925,Manchester United,Bolton Wanderers,2-1,2,1,1,1,3,1,H
1925-12-25,1925,Sheffield United,Leicester City,2-4,2,4,1,1,6,-2,A
1925-12-25,1925,West Ham United,Aston Villa,5-2,5,2,1,1,7,3,H
1925-12-26,1925,Aston Villa,West Ham United,2-0,2,0,1,1,2,2,H
1925-12-26,1925,Burnley,Leeds United,6-3,6,3,1,1,9,3,H
1925-12-26,1925,Everton,Blackburn Rovers,3-0,3,0,1,1,3,3,H
1925-12-26,1925,Huddersfield Town,Sunderland,1-1,1,1,1,1,2,0,D
1925-12-26,1925,Leicester City,Sheffield United,2-2,2,2,1,1,4,0,D
1925-12-26,1925,Manchester City,Bury,0-2,0,2,1,1,2,-2,A
1925-12-26,1925,Newcastle United,Liverpool,3-0,3,0,1,1,3,3,H
1925-12-26,1925,Notts County,Arsenal,4-1,4,1,1,1,5,3,H
1925-12-26,1925,Tottenham Hotspur,Birmingham City,2-1,2,1,1,1,3,1,H
1925-12-26,1925,West Bromwich Albion,Cardiff City,3-0,3,0,1,1,3,3,H
1925-12-28,1925,Huddersfield Town,Birmingham City,4-1,4,1,1,1,5,3,H
1925-12-28,1925,Leicester City,Manchester United,1-3,1,3,1,1,4,-2,A
1926-01-01,1925,Bolton Wanderers,Birmingham City,5-3,5,3,1,1,8,2,H
1926-01-01,1925,Bury,Everton,1-0,1,0,1,1,1,1,H
1926-01-01,1925,Liverpool,Aston Villa,3-1,3,1,1,1,4,2,H
1926-01-01,1925,Manchester City,West Bromwich Albion,3-1,3,1,1,1,4,2,H
1926-01-01,1925,Newcastle United,Burnley,1-3,1,3,1,1,4,-2,A
1926-01-01,1925,Sheffield United,Cardiff City,11-2,11,2,1,1,13,9,H
1926-01-01,1925,Sunderland,Leeds United,1-3,1,3,1,1,4,-2,A
1926-01-02,1925,Birmingham City,Sunderland,2-1,2,1,1,1,3,1,H
1926-01-02,1925,Burnley,Aston Villa,2-3,2,3,1,1,5,-1,A
1926-01-02,1925,Bury,Blackburn Rovers,3-1,3,1,1,1,4,2,H
1926-01-02,1925,Cardiff City,Manchester City,2-2,2,2,1,1,4,0,D
1926-01-02,1925,Leeds United,Notts County,2-1,2,1,1,1,3,1,H
1926-01-02,1925,Liverpool,Leicester City,0-3,0,3,1,1,3,-3,A
1926-01-02,1925,Manchester United,West Ham United,2-1,2,1,1,1,3,1,H
1926-01-02,1925,Newcastle United,Bolton Wanderers,5-1,5,1,1,1,6,4,H
1926-01-02,1925,Sheffield United,Everton,1-1,1,1,1,1,2,0,D
1926-01-02,1925,Tottenham Hotspur,Arsenal,1-1,1,1,1,1,2,0,D
1926-01-02,1925,West Bromwich Albion,Huddersfield Town,2-2,2,2,1,1,4,0,D
1926-01-16,1925,Arsenal,Manchester United,3-2,3,2,1,1,5,1,H
1926-01-16,1925,Blackburn Rovers,Birmingham City,4-4,4,4,1,1,8,0,D
1926-01-16,1925,Bolton Wanderers,Bury,3-2,3,2,1,1,5,1,H
1926-01-16,1925,Everton,Cardiff City,1-1,1,1,1,1,2,0,D
1926-01-16,1925,Huddersfield Town,Sheffield United,4-1,4,1,1,1,5,3,H
1926-01-16,1925,Leicester City,Burnley,3-2,3,2,1,1,5,1,H
1926-01-16,1925,Manchester City,Tottenham Hotspur,0-0,0,0,1,1,0,0,D
1926-01-16,1925,Notts County,Newcastle United,1-3,1,3,1,1,4,-2,A
1926-01-16,1925,Sunderland,West Bromwich Albion,4-0,4,0,1,1,4,4,H
1926-01-16,1925,West Ham United,Liverpool,1-2,1,2,1,1,3,-1,A
1926-01-20,1925,Sunderland,Huddersfield Town,4-1,4,1,1,1,5,3,H
1926-01-23,1925,Birmingham City,Bury,2-3,2,3,1,1,5,-1,A
1926-01-23,1925,Bolton Wanderers,Notts County,2-1,2,1,1,1,3,1,H
1926-01-23,1925,Burnley,West Ham United,2-2,2,2,1,1,4,0,D
1926-01-23,1925,Cardiff City,Huddersfield Town,1-2,1,2,1,1,3,-1,A
1926-01-23,1925,Leeds United,Leicester City,1-0,1,0,1,1,1,1,H
1926-01-23,1925,Liverpool,Arsenal,3-0,3,0,1,1,3,3,H
1926-01-23,1925,Manchester United,Manchester City,1-6,1,6,1,1,7,-5,A
1926-01-23,1925,Newcastle United,Aston Villa,2-2,2,2,1,1,4,0,D
1926-01-23,1925,Sheffield United,Sunderland,4-1,4,1,1,1,5,3,H
1926-01-23,1925,Tottenham Hotspur,Everton,1-1,1,1,1,1,2,0,D
1926-01-23,1925,West Bromwich Albion,Blackburn Rovers,1-1,1,1,1,1,2,0,D
1926-01-30,1925,Everton,Leicester City,1-0,1,0,1,1,1,1,H
1926-01-30,1925,West Ham United,Leeds United,4-2,4,2,1,1,6,2,H
1926-02-03,1925,Arsenal,Burnley,1-2,1,2,1,1,3,-1,A
1926-02-03,1925,Aston Villa,Leeds United,3-1,3,1,1,1,4,2,H
1926-02-06,1925,Bolton Wanderers,Leicester City,2-2,2,2,1,1,4,0,D
1926-02-06,1925,Burnley,Manchester United,0-1,0,1,1,1,1,-1,A
1926-02-06,1925,Cardiff City,Blackburn Rovers,4-1,4,1,1,1,5,3,H
1926-02-06,1925,Everton,Liverpool,3-3,3,3,1,1,6,0,D
1926-02-06,1925,Leeds United,Arsenal,4-2,4,2,1,1,6,2,H
1926-02-06,1925,Manchester City,Huddersfield Town,1-5,1,5,1,1,6,-4,A
1926-02-06,1925,Newcastle United,West Ham United,4-1,4,1,1,1,5,3,H
1926-02-06,1925,Notts County,Aston Villa,1-0,1,0,1,1,1,1,H
1926-02-06,1925,Sheffield United,Bury,3-1,3,1,1,1,4,2,H
1926-02-06,1925,Tottenham Hotspur,Sunderland,0-2,0,2,1,1,2,-2,A
1926-02-06,1925,West Bromwich Albion,Birmingham City,5-1,5,1,1,1,6,4,H
1926-02-10,1925,Everton,Manchester City,1-1,1,1,1,1,2,0,D
1926-02-11,1925,Blackburn Rovers,Huddersfield Town,2-1,2,1,1,1,3,1,H
1926-02-13,1925,Arsenal,Newcastle United,3-0,3,0,1,1,3,3,H
1926-02-13,1925,Aston Villa,West Bromwich Albion,2-1,2,1,1,1,3,1,H
1926-02-13,1925,Birmingham City,Sheffield United,2-0,2,0,1,1,2,2,H
1926-02-13,1925,Blackburn Rovers,Tottenham Hotspur,4-2,4,2,1,1,6,2,H
1926-02-13,1925,Bury,Cardiff City,4-1,4,1,1,1,5,3,H
1926-02-13,1925,Huddersfield Town,Everton,3-0,3,0,1,1,3,3,H
1926-02-13,1925,Leicester City,Notts County,1-0,1,0,1,1,1,1,H
1926-02-13,1925,Liverpool,Burnley,3-2,3,2,1,1,5,1,H
1926-02-13,1925,Manchester United,Leeds United,2-1,2,1,1,1,3,1,H
1926-02-13,1925,Sunderland,Manchester City,5-3,5,3,1,1,8,2,H
1926-02-13,1925,West Ham United,Bolton Wanderers,6-0,6,0,1,1,6,6,H
1926-02-20,1925,Burnley,Huddersfield Town,1-1,1,1,1,1,2,0,D
1926-02-20,1925,Cardiff City,Birmingham City,2-0,2,0,1,1,2,2,H
1926-02-20,1925,Leeds United,Liverpool,1-1,1,1,1,1,2,0,D
1926-02-20,1925,Leicester City,Blackburn Rovers,2-1,2,1,1,1,3,1,H
1926-02-20,1925,Sheffield United,West Bromwich Albion,3-2,3,2,1,1,5,1,H
1926-02-20,1925,Tottenham Hotspur,Bury,4-2,4,2,1,1,6,2,H
1926-02-22,1925,Leicester City,Newcastle United,3-2,3,2,1,1,5,1,H
1926-02-24,1925,Bury,West Bromwich Albion,2-0,2,0,1,1,2,2,H
1926-02-27,1925,Birmingham City,Aston Villa,2-1,2,1,1,1,3,1,H
1926-02-27,1925,Blackburn Rovers,Bolton Wanderers,3-0,3,0,1,1,3,3,H
1926-02-27,1925,Bury,Notts County,3-1,3,1,1,1,4,2,H
1926-02-27,1925,Cardiff City,Arsenal,0-0,0,0,1,1,0,0,D
1926-02-27,1925,Everton,Burnley,1-1,1,1,1,1,2,0,D
1926-02-27,1925,Huddersfield Town,Leeds United,3-1,3,1,1,1,4,2,H
1926-02-27,1925,Manchester City,Liverpool,1-1,1,1,1,1,2,0,D
1926-02-27,1925,Sheffield United,West Ham United,1-1,1,1,1,1,2,0,D
1926-02-27,1925,Sunderland,Newcastle United,2-2,2,2,1,1,4,0,D
1926-02-27,1925,Tottenham Hotspur,Manchester United,0-1,0,1,1,1,1,-1,A
1926-02-27,1925,West Bromwich Albion,Leicester City,3-1,3,1,1,1,4,2,H
1926-03-01,1925,Blackburn Rovers,Sheffield United,3-1,3,1,1,1,4,2,H
1926-03-03,1925,Huddersfield Town,Tottenham Hotspur,2-1,2,1,1,1,3,1,H
1926-03-03,1925,Notts County,Birmingham City,3-0,3,0,1,1,3,3,H
1926-03-06,1925,Aston Villa,Bury,1-1,1,1,1,1,2,0,D
1926-03-06,1925,Leeds United,Everton,1-1,1,1,1,1,2,0,D
1926-03-06,1925,Leicester City,Birmingham City,1-0,1,0,1,1,1,1,H
1926-03-06,1925,Liverpool,Tottenham Hotspur,0-0,0,0,1,1,0,0,D
1926-03-06,1925,Newcastle United,Huddersfield Town,0-2,0,2,1,1,2,-2,A
1926-03-06,1925,Notts County,Blackburn Rovers,1-1,1,1,1,1,2,0,D
1926-03-06,1925,West Ham United,West Bromwich Albion,3-0,3,0,1,1,3,3,H
1926-03-10,1925,Aston Villa,Leicester City,2-2,2,2,1,1,4,0,D
1926-03-10,1925,Manchester United,Liverpool,3-3,3,3,1,1,6,0,D
1926-03-13,1925,Birmingham City,Newcastle United,1-1,1,1,1,1,2,0,D
1926-03-13,1925,Blackburn Rovers,Burnley,6-3,6,3,1,1,9,3,H
1926-03-13,1925,Bury,Leeds United,0-2,0,2,1,1,2,-2,A
1926-03-13,1925,Cardiff City,Aston Villa,2-0,2,0,1,1,2,2,H
1926-03-13,1925,Everton,Arsenal,2-3,2,3,1,1,5,-1,A
1926-03-13,1925,Huddersfield Town,Manchester United,5-0,5,0,1,1,5,5,H
1926-03-13,1925,Manchester City,West Ham United,2-0,2,0,1,1,2,2,H
1926-03-13,1925,Sheffield United,Notts County,3-0,3,0,1,1,3,3,H
1926-03-13,1925,Sunderland,Liverpool,3-2,3,2,1,1,5,1,H
1926-03-13,1925,Tottenham Hotspur,Leicester City,1-3,1,3,1,1,4,-2,A
1926-03-13,1925,West Bromwich Albion,Bolton Wanderers,0-3,0,3,1,1,3,-3,A
1926-03-17,1925,Arsenal,Sheffield United,4-0,4,0,1,1,4,4,H
1926-03-17,1925,Bolton Wanderers,Manchester United,3-1,3,1,1,1,4,2,H
1926-03-17,1925,Everton,Sunderland,2-1,2,1,1,1,3,1,H
1926-03-17,1925,Manchester City,Blackburn Rovers,0-1,0,1,1,1,1,-1,A
1926-03-20,1925,Arsenal,Manchester City,1-0,1,0,1,1,1,1,H
1926-03-20,1925,Aston Villa,Sheffield United,2-2,2,2,1,1,4,0,D
1926-03-20,1925,Burnley,Sunderland,5-2,5,2,1,1,7,3,H
1926-03-20,1925,Leeds United,Blackburn Rovers,2-1,2,1,1,1,3,1,H
1926-03-20,1925,Leicester City,Cardiff City,1-2,1,2,1,1,3,-1,A
1926-03-20,1925,Liverpool,Huddersfield Town,1-2,1,2,1,1,3,-1,A
1926-03-20,1925,Manchester United,Everton,0-0,0,0,1,1,0,0,D
1926-03-20,1925,Newcastle United,Bury,4-0,4,0,1,1,4,4,H
1926-03-20,1925,Notts County,West Bromwich Albion,0-0,0,0,1,1,0,0,D
1926-03-20,1925,West Ham United,Tottenham Hotspur,3-1,3,1,1,1,4,2,H
1926-03-22,1925,Notts County,West Ham United,1-1,1,1,1,1,2,0,D
1926-03-25,1925,Tottenham Hotspur,Newcastle United,1-0,1,0,1,1,1,1,H
1926-03-27,1925,Blackburn Rovers,West Ham United,1-0,1,0,1,1,1,1,H
1926-03-27,1925,Bury,Arsenal,2-2,2,2,1,1,4,0,D
1926-03-27,1925,Cardiff City,Leeds United,0-0,0,0,1,1,0,0,D
1926-03-27,1925,Everton,Notts County,3-0,3,0,1,1,3,3,H
1926-03-27,1925,Huddersfield Town,Aston Villa,5-1,5,1,1,1,6,4,H
1926-03-27,1925,Sunderland,Leicester City,3-0,3,0,1,1,3,3,H
1926-03-27,1925,West Bromwich Albion,Liverpool,0-3,0,3,1,1,3,-3,A
1926-03-29,1925,Manchester City,Bolton Wanderers,1-1,1,1,1,1,2,0,D
1926-03-31,1925,Sunderland,Cardiff City,1-3,1,3,1,1,4,-2,A
1926-04-02,1925,Aston Villa,Arsenal,3-0,3,0,1,1,3,3,H
1926-04-02,1925,Bolton Wanderers,Liverpool,0-1,0,1,1,1,1,-1,A
1926-04-02,1925,Burnley,Newcastle United,1-0,1,0,1,1,1,1,H
1926-04-02,1925,Everton,Bury,1-1,1,1,1,1,2,0,D
1926-04-02,1925,Manchester City,Birmingham City,2-4,2,4,1,1,6,-2,A
1926-04-02,1925,Notts County,Manchester United,0-3,0,3,1,1,3,-3,A
1926-04-02,1925,Tottenham Hotspur,West Bromwich Albion,3-2,3,2,1,1,5,1,H
1926-04-02,1925,West Ham United,Leicester City,1-1,1,1,1,1,2,0,D
1926-04-03,1925,Arsenal,Blackburn Rovers,4-2,4,2,1,1,6,2,H
1926-04-03,1925,Aston Villa,Everton,3-1,3,1,1,1,4,2,H
1926-04-03,1925,Bolton Wanderers,Tottenham Hotspur,1-1,1,1,1,1,2,0,D
1926-04-03,1925,Burnley,West Bromwich Albion,3-4,3,4,1,1,7,-1,A
1926-04-03,1925,Leeds United,Sheffield United,2-0,2,0,1,1,2,2,H
1926-04-03,1925,Leicester City,Huddersfield Town,2-0,2,0,1,1,2,2,H
1926-04-03,1925,Liverpool,Birmingham City,2-2,2,2,1,1,4,0,D
1926-04-03,1925,Manchester United,Bury,0-1,0,1,1,1,1,-1,A
1926-04-03,1925,Newcastle United,Cardiff City,0-1,0,1,1,1,1,-1,A
1926-04-03,1925,Notts County,Manchester City,1-0,1,0,1,1,1,1,H
1926-04-03,1925,West Ham United,Sunderland,3-2,3,2,1,1,5,1,H
1926-04-05,1925,Arsenal,Aston Villa,2-0,2,0,1,1,2,2,H
1926-04-05,1925,Bury,Huddersfield Town,0-0,0,0,1,1,0,0,D
1926-04-05,1925,Cardiff City,Sheffield United,0-1,0,1,1,1,1,-1,A
1926-04-05,1925,Leicester City,West Ham United,1-1,1,1,1,1,2,0,D
1926-04-05,1925,Liverpool,Bolton Wanderers,2-2,2,2,1,1,4,0,D
1926-04-05,1925,Manchester United,Notts County,0-1,0,1,1,1,1,-1,A
1926-04-05,1925,Newcastle United,Leeds United,3-0,3,0,1,1,3,3,H
1926-04-05,1925,West Bromwich Albion,Tottenham Hotspur,1-0,1,0,1,1,1,1,H
1926-04-06,1925,Aston Villa,Liverpool,3-0,3,0,1,1,3,3,H
1926-04-06,1925,Burnley,Manchester City,1-2,1,2,1,1,3,-1,A
1926-04-06,1925,Huddersfield Town,Blackburn Rovers,3-1,3,1,1,1,4,2,H
1926-04-06,1925,Leeds United,Sunderland,0-2,0,2,1,1,2,-2,A
1926-04-07,1925,Bolton Wanderers,Sunderland,3-2,3,2,1,1,5,1,H
1926-04-10,1925,Birmingham City,Burnley,1-7,1,7,1,1,8,-6,A
1926-04-10,1925,Blackburn Rovers,Manchester United,7-0,7,0,1,1,7,7,H
1926-04-10,1925,Bury,Liverpool,0-1,0,1,1,1,1,-1,A
1926-04-10,1925,Cardiff City,Bolton Wanderers,0-1,0,1,1,1,1,-1,A
1926-04-10,1925,Huddersfield Town,West Ham United,2-1,2,1,1,1,3,1,H
1926-04-10,1925,Manchester City,Aston Villa,4-2,4,2,1,1,6,2,H
1926-04-10,1925,Sheffield United,Newcastle United,4-3,4,3,1,1,7,1,H
1926-04-10,1925,Sunderland,Arsenal,2-1,2,1,1,1,3,1,H
1926-04-10,1925,Tottenham Hotspur,Notts County,4-0,4,0,1,1,4,4,H
1926-04-10,1925,West Bromwich Albion,Leeds United,3-0,3,0,1,1,3,3,H
1926-04-12,1925,Huddersfield Town,Bolton Wanderers,3-0,3,0,1,1,3,3,H
1926-04-14,1925,Newcastle United,Manchester United,4-1,4,1,1,1,5,3,H
1926-04-17,1925,Arsenal,Huddersfield Town,3-1,3,1,1,1,4,2,H
1926-04-17,1925,Aston Villa,Tottenham Hotspur,3-0,3,0,1,1,3,3,H
1926-04-17,1925,Bolton Wanderers,Sheffield United,2-1,2,1,1,1,3,1,H
1926-04-17,1925,Burnley,Bury,2-2,2,2,1,1,4,0,D
1926-04-17,1925,Leeds United,Birmingham City,0-0,0,0,1,1,0,0,D
1926-04-17,1925,Leicester City,Manchester City,2-3,2,3,1,1,5,-1,A
1926-04-17,1925,Liverpool,Blackburn Rovers,2-2,2,2,1,1,4,0,D
1926-04-17,1925,Newcastle United,West Bromwich Albion,3-0,3,0,1,1,3,3,H
1926-04-17,1925,Notts County,Cardiff City,2-4,2,4,1,1,6,-2,A
1926-04-17,1925,West Ham United,Everton,1-0,1,0,1,1,1,1,H
1926-04-19,1925,Birmingham City,Manchester United,2-1,2,1,1,1,3,1,H
1926-04-19,1925,Sheffield United,Burnley,6-1,6,1,1,1,7,5,H
1926-04-21,1925,Manchester United,Sunderland,5-1,5,1,1,1,6,4,H
1926-04-24,1925,Birmingham City,West Ham United,1-0,1,0,1,1,1,1,H
1926-04-24,1925,Blackburn Rovers,Aston Villa,3-1,3,1,1,1,4,2,H
1926-04-24,1925,Bury,Leicester City,4-0,4,0,1,1,4,4,H
1926-04-24,1925,Cardiff City,Liverpool,2-2,2,2,1,1,4,0,D
1926-04-24,1925,Everton,Newcastle United,3-0,3,0,1,1,3,3,H
1926-04-24,1925,Sheffield United,Manchester United,2-0,2,0,1,1,2,2,H
1926-04-24,1925,Sunderland,Notts County,3-1,3,1,1,1,4,2,H
1926-04-24,1925,Tottenham Hotspur,Burnley,0-2,0,2,1,1,2,-2,A
1926-04-24,1925,West Bromwich Albion,Arsenal,2-1,2,1,1,1,3,1,H
1926-04-26,1925,Aston Villa,Bolton Wanderers,2-2,2,2,1,1,4,0,D
1926-04-27,1925,Manchester City,Leeds United,2-1,2,1,1,1,3,1,H
1926-04-28,1925,Bolton Wanderers,Arsenal,1-1,1,1,1,1,2,0,D
1926-04-28,1925,Manchester United,Cardiff City,1-0,1,0,1,1,1,1,H
1926-05-01,1925,Arsenal,Birmingham City,3-0,3,0,1,1,3,3,H
1926-05-01,1925,Bolton Wanderers,Everton,0-2,0,2,1,1,2,-2,A
1926-05-01,1925,Burnley,Cardiff City,4-1,4,1,1,1,5,3,H
1926-05-01,1925,Leeds United,Tottenham Hotspur,4-1,4,1,1,1,5,3,H
1926-05-01,1925,Liverpool,Sheffield United,2-2,2,2,1,1,4,0,D
1926-05-01,1925,Manchester United,West Bromwich Albion,3-2,3,2,1,1,5,1,H
1926-05-01,1925,Newcastle United,Manchester City,3-2,3,2,1,1,5,1,H
1926-05-01,1925,Notts County,Huddersfield Town,4-2,4,2,1,1,6,2,H
1926-05-01,1925,West Ham United,Bury,0-2,0,2,1,1,2,-2,A
1926-08-28,1926,Arsenal,Derby County,2-1,2,1,1,1,3,1,H
1926-08-28,1926,Birmingham City,Blackburn Rovers,3-1,3,1,1,1,4,2,H
1926-08-28,1926,Burnley,Cardiff City,4-3,4,3,1,1,7,1,H
1926-08-28,1926,Bury,Huddersfield Town,2-2,2,2,1,1,4,0,D
1926-08-28,1926,Leeds United,Bolton Wanderers,2-5,2,5,1,1,7,-3,A
1926-08-28,1926,Liverpool,Manchester United,4-2,4,2,1,1,6,2,H
1926-08-28,1926,Newcastle United,Aston Villa,4-0,4,0,1,1,4,4,H
1926-08-28,1926,Sheffield Wednesday,Sheffield United,2-3,2,3,1,1,5,-1,A
1926-08-28,1926,Tottenham Hotspur,Everton,2-1,2,1,1,1,3,1,H
1926-08-28,1926,West Bromwich Albion,Sunderland,3-0,3,0,1,1,3,3,H
1926-08-28,1926,West Ham United,Leicester City,3-3,3,3,1,1,6,0,D
1926-08-30,1926,Aston Villa,Liverpool,1-1,1,1,1,1,2,0,D
1926-08-30,1926,Huddersfield Town,West Bromwich Albion,4-1,4,1,1,1,5,3,H
1926-08-30,1926,Leeds United,Cardiff City,0-0,0,0,1,1,0,0,D
1926-08-30,1926,Leicester City,Birmingham City,5-2,5,2,1,1,7,3,H
1926-08-30,1926,Sheffield United,Manchester United,2-2,2,2,1,1,4,0,D
1926-08-30,1926,Tottenham Hotspur,Sheffield Wednesday,7-3,7,3,1,1,10,4,H
1926-09-01,1926,Arsenal,Bolton Wanderers,2-1,2,1,1,1,3,1,H
1926-09-01,1926,Bury,Everton,5-2,5,2,1,1,7,3,H
1926-09-01,1926,Newcastle United,Burnley,1-5,1,5,1,1,6,-4,A
1926-09-04,1926,Aston Villa,Burnley,1-1,1,1,1,1,2,0,D
1926-09-04,1926,Blackburn Rovers,Tottenham Hotspur,1-0,1,0,1,1,1,1,H
1926-09-04,1926,Bolton Wanderers,Newcastle United,2-1,2,1,1,1,3,1,H
1926-09-04,1926,Cardiff City,West Bromwich Albion,1-1,1,1,1,1,2,0,D
1926-09-04,1926,Derby County,Liverpool,2-1,2,1,1,1,3,1,H
1926-09-04,1926,Everton,West Ham United,0-3,0,3,1,1,3,-3,A
1926-09-04,1926,Huddersfield Town,Birmingham City,0-2,0,2,1,1,2,-2,A
1926-09-04,1926,Leicester City,Sheffield Wednesday,5-3,5,3,1,1,8,2,H
1926-09-04,1926,Manchester United,Leeds United,2-2,2,2,1,1,4,0,D
1926-09-04,1926,Sheffield United,Arsenal,4-0,4,0,1,1,4,4,H
1926-09-04,1926,Sunderland,Bury,3-0,3,0,1,1,3,3,H
1926-09-06,1926,Bolton Wanderers,Arsenal,2-2,2,2,1,1,4,0,D
1926-09-06,1926,Burnley,Newcastle United,3-3,3,3,1,1,6,0,D
1926-09-06,1926,Cardiff City,Leeds United,3-1,3,1,1,1,4,2,H
1926-09-06,1926,Sheffield Wednesday,West Ham United,1-0,1,0,1,1,1,1,H
1926-09-06,1926,Tottenham Hotspur,Leicester City,2-2,2,2,1,1,4,0,D
1926-09-06,1926,West Bromwich Albion,Everton,3-2,3,2,1,1,5,1,H
1926-09-08,1926,Liverpool,Aston Villa,2-1,2,1,1,1,3,1,H
1926-09-08,1926,Sunderland,Huddersfield Town,1-1,1,1,1,1,2,0,D
1926-09-11,1926,Arsenal,Leicester City,2-2,2,2,1,1,4,0,D
1926-09-11,1926,Birmingham City,Sunderland,2-0,2,0,1,1,2,2,H
1926-09-11,1926,Burnley,Bolton Wanderers,4-3,4,3,1,1,7,1,H
1926-09-11,1926,Bury,West Bromwich Albion,7-3,7,3,1,1,10,4,H
1926-09-11,1926,Cardiff City,Aston Villa,2-3,2,3,1,1,5,-1,A
1926-09-11,1926,Leeds United,Derby County,1-0,1,0,1,1,1,1,H
1926-09-11,1926,Liverpool,Sheffield United,5-1,5,1,1,1,6,4,H
1926-09-11,1926,Newcastle United,Manchester United,4-2,4,2,1,1,6,2,H
1926-09-11,1926,Sheffield Wednesday,Everton,4-0,4,0,1,1,4,4,H
1926-09-11,1926,Tottenham Hotspur,Huddersfield Town,3-3,3,3,1,1,6,0,D
1926-09-11,1926,West Ham United,Blackburn Rovers,1-5,1,5,1,1,6,-4,A
1926-09-13,1926,Birmingham City,Sheffield Wednesday,0-0,0,0,1,1,0,0,D
1926-09-13,1926,Leicester City,Tottenham Hotspur,2-2,2,2,1,1,4,0,D
1926-09-13,1926,Sheffield United,Derby County,1-0,1,0,1,1,1,1,H
1926-09-14,1926,Huddersfield Town,Sunderland,0-0,0,0,1,1,0,0,D
1926-09-15,1926,Bury,Blackburn Rovers,0-2,0,2,1,1,2,-2,A
1926-09-15,1926,Everton,West Bromwich Albion,0-0,0,0,1,1,0,0,D
1926-09-15,1926,Leeds United,Aston Villa,3-1,3,1,1,1,4,2,H
1926-09-15,1926,Manchester United,Arsenal,2-2,2,2,1,1,4,0,D
1926-09-18,1926,Arsenal,Liverpool,2-0,2,0,1,1,2,2,H
1926-09-18,1926,Aston Villa,Bury,1-2,1,2,1,1,3,-1,A
1926-09-18,1926,Blackburn Rovers,Sheffield Wednesday,2-2,2,2,1,1,4,0,D
1926-09-18,1926,Bolton Wanderers,Cardiff City,2-0,2,0,1,1,2,2,H
1926-09-18,1926,Derby County,Newcastle United,1-1,1,1,1,1,2,0,D
1926-09-18,1926,Everton,Leicester City,3-4,3,4,1,1,7,-1,A
1926-09-18,1926,Huddersfield Town,West Ham United,2-1,2,1,1,1,3,1,H
1926-09-18,1926,Manchester United,Burnley,2-1,2,1,1,1,3,1,H
1926-09-18,1926,Sheffield United,Leeds United,1-0,1,0,1,1,1,1,H
1926-09-18,1926,Sunderland,Tottenham Hotspur,3-2,3,2,1,1,5,1,H
1926-09-18,1926,West Bromwich Albion,Birmingham City,1-2,1,2,1,1,3,-1,A
1926-09-20,1926,Birmingham City,Everton,1-0,1,0,1,1,1,1,H
1926-09-20,1926,Blackburn Rovers,Sunderland,0-2,0,2,1,1,2,-2,A
1926-09-20,1926,Cardiff City,Newcastle United,1-1,1,1,1,1,2,0,D
1926-09-25,1926,Aston Villa,Bolton Wanderers,3-4,3,4,1,1,7,-1,A
1926-09-25,1926,Birmingham City,Bury,2-2,2,2,1,1,4,0,D
1926-09-25,1926,Burnley,Derby County,1-0,1,0,1,1,1,1,H
1926-09-25,1926,Cardiff City,Manchester United,0-2,0,2,1,1,2,-2,A
1926-09-25,1926,Everton,Liverpool,1-0,1,0,1,1,1,1,H
1926-09-25,1926,Leeds United,Arsenal,4-1,4,1,1,1,5,3,H
1926-09-25,1926,Leicester City,Blackburn Rovers,4-0,4,0,1,1,4,4,H
1926-09-25,1926,Newcastle United,Sheffield United,2-0,2,0,1,1,2,2,H
1926-09-25,1926,Sheffield Wednesday,Huddersfield Town,1-1,1,1,1,1,2,0,D
1926-09-25,1926,Tottenham Hotspur,West Bromwich Albion,3-0,3,0,1,1,3,3,H
1926-09-25,1926,West Ham United,Sunderland,1-2,1,2,1,1,3,-1,A
1926-09-27,1926,Derby County,Sheffield United,1-0,1,0,1,1,1,1,H
1926-09-29,1926,Everton,Bury,2-2,2,2,1,1,4,0,D
1926-10-02,1926,Arsenal,Newcastle United,2-2,2,2,1,1,4,0,D
1926-10-02,1926,Blackburn Rovers,Everton,3-3,3,3,1,1,6,0,D
1926-10-02,1926,Bolton Wanderers,Birmingham City,1-0,1,0,1,1,1,1,H
1926-10-02,1926,Bury,Tottenham Hotspur,0-0,0,0,1,1,0,0,D
1926-10-02,1926,Derby County,Cardiff City,6-3,6,3,1,1,9,3,H
1926-10-02,1926,Huddersfield Town,Leicester City,5-3,5,3,1,1,8,2,H
1926-10-02,1926,Liverpool,Leeds United,2-4,2,4,1,1,6,-2,A
1926-10-02,1926,Manchester United,Aston Villa,2-1,2,1,1,1,3,1,H
1926-10-02,1926,Sheffield United,Burnley,2-2,2,2,1,1,4,0,D
1926-10-02,1926,Sunderland,Sheffield Wednesday,4-1,4,1,1,1,5,3,H
1926-10-02,1926,West Bromwich Albion,West Ham United,1-3,1,3,1,1,4,-2,A
1926-10-04,1926,Blackburn Rovers,Bury,2-2,2,2,1,1,4,0,D
1926-10-04,1926,West Ham United,Sheffield Wednesday,1-1,1,1,1,1,2,0,D
1926-10-06,1926,Sunderland,Burnley,7-1,7,1,1,1,8,6,H
1926-10-09,1926,Aston Villa,Derby County,3-1,3,1,1,1,4,2,H
1926-10-09,1926,Bolton Wanderers,Manchester United,4-0,4,0,1,1,4,4,H
1926-10-09,1926,Burnley,Arsenal,2-0,2,0,1,1,2,2,H
1926-10-09,1926,Cardiff City,Sheffield United,3-0,3,0,1,1,3,3,H
1926-10-09,1926,Everton,Huddersfield Town,0-0,0,0,1,1,0,0,D
1926-10-09,1926,Leeds United,Blackburn Rovers,4-1,4,1,1,1,5,3,H
1926-10-09,1926,Leicester City,Sunderland,2-1,2,1,1,1,3,1,H
1926-10-09,1926,Newcastle United,Liverpool,1-0,1,0,1,1,1,1,H
1926-10-09,1926,Sheffield Wednesday,West Bromwich Albion,2-1,2,1,1,1,3,1,H
1926-10-09,1926,Tottenham Hotspur,Birmingham City,6-1,6,1,1,1,7,5,H
1926-10-09,1926,West Ham United,Bury,1-2,1,2,1,1,3,-1,A
1926-10-12,1926,Burnley,Sunderland,4-2,4,2,1,1,6,2,H
1926-10-16,1926,Arsenal,West Ham United,2-2,2,2,1,1,4,0,D
1926-10-16,1926,Birmingham City,Derby County,1-0,1,0,1,1,1,1,H
1926-10-16,1926,Blackburn Rovers,Burnley,1-5,1,5,1,1,6,-4,A
1926-10-16,1926,Bury,Manchester United,0-3,0,3,1,1,3,-3,A
1926-10-16,1926,Everton,Newcastle United,1-3,1,3,1,1,4,-2,A
1926-10-16,1926,Huddersfield Town,Cardiff City,0-0,0,0,1,1,0,0,D
1926-10-16,1926,Leicester City,Leeds United,3-2,3,2,1,1,5,1,H
1926-10-16,1926,Sheffield Wednesday,Liverpool,3-2,3,2,1,1,5,1,H
1926-10-16,1926,Sunderland,Aston Villa,1-1,1,1,1,1,2,0,D
1926-10-16,1926,Tottenham Hotspur,Sheffield United,3-1,3,1,1,1,4,2,H
1926-10-16,1926,West Bromwich Albion,Bolton Wanderers,1-1,1,1,1,1,2,0,D
1926-10-23,1926,Arsenal,Sheffield Wednesday,6-2,6,2,1,1,8,4,H
1926-10-23,1926,Aston Villa,West Bromwich Albion,2-0,2,0,1,1,2,2,H
1926-10-23,1926,Bolton Wanderers,Bury,2-2,2,2,1,1,4,0,D
1926-10-23,1926,Burnley,Huddersfield Town,2-2,2,2,1,1,4,0,D
1926-10-23,1926,Cardiff City,Sunderland,3-0,3,0,1,1,3,3,H
1926-10-23,1926,Derby County,Tottenham Hotspur,4-1,4,1,1,1,5,3,H
1926-10-23,1926,Leeds United,Everton,1-3,1,3,1,1,4,-2,A
1926-10-23,1926,Liverpool,Leicester City,1-0,1,0,1,1,1,1,H
1926-10-23,1926,Manchester United,Birmingham City,0-1,0,1,1,1,1,-1,A
1926-10-23,1926,Newcastle United,Blackburn Rovers,6-1,6,1,1,1,7,5,H
1926-10-23,1926,Sheffield United,West Ham United,0-2,0,2,1,1,2,-2,A
1926-10-30,1926,Birmingham City,Aston Villa,1-2,1,2,1,1,3,-1,A
1926-10-30,1926,Blackburn Rovers,Liverpool,2-1,2,1,1,1,3,1,H
1926-10-30,1926,Bury,Cardiff City,2-3,2,3,1,1,5,-1,A
1926-10-30,1926,Everton,Arsenal,3-1,3,1,1,1,4,2,H
1926-10-30,1926,Huddersfield Town,Leeds United,4-1,4,1,1,1,5,3,H
1926-10-30,1926,Leicester City,Sheffield United,2-2,2,2,1,1,4,0,D
1926-10-30,1926,Sheffield Wednesday,Derby County,2-1,2,1,1,1,3,1,H
1926-10-30,1926,Sunderland,Newcastle United,2-0,2,0,1,1,2,2,H
1926-10-30,1926,Tottenham Hotspur,Bolton Wanderers,1-0,1,0,1,1,1,1,H
1926-10-30,1926,West Bromwich Albion,Burnley,4-2,4,2,1,1,6,2,H
1926-10-30,1926,West Ham United,Manchester United,4-0,4,0,1,1,4,4,H
1926-11-06,1926,Arsenal,Blackburn Rovers,2-2,2,2,1,1,4,0,D
1926-11-06,1926,Aston Villa,Tottenham Hotspur,2-3,2,3,1,1,5,-1,A
1926-11-06,1926,Bolton Wanderers,West Ham United,2-0,2,0,1,1,2,2,H
1926-11-06,1926,Burnley,Bury,0-0,0,0,1,1,0,0,D
1926-11-06,1926,Cardiff City,Birmingham City,1-0,1,0,1,1,1,1,H
1926-11-06,1926,Derby County,Leicester City,4-1,4,1,1,1,5,3,H
1926-11-06,1926,Leeds United,Sunderland,2-2,2,2,1,1,4,0,D
1926-11-06,1926,Liverpool,Huddersfield Town,2-3,2,3,1,1,5,-1,A
1926-11-06,1926,Manchester United,Sheffield Wednesday,0-0,0,0,1,1,0,0,D
1926-11-06,1926,Newcastle United,West Bromwich Albion,5-2,5,2,1,1,7,3,H
1926-11-06,1926,Sheffield United,Everton,3-3,3,3,1,1,6,0,D
1926-11-13,1926,Birmingham City,Burnley,1-0,1,0,1,1,1,1,H
1926-11-13,1926,Blackburn Rovers,Sheffield United,3-4,3,4,1,1,7,-1,A
1926-11-13,1926,Bury,Newcastle United,3-2,3,2,1,1,5,1,H
1926-11-13,1926,Everton,Derby County,3-2,3,2,1,1,5,1,H
1926-11-13,1926,Huddersfield Town,Arsenal,3-3,3,3,1,1,6,0,D
1926-11-13,1926,Leicester City,Manchester United,2-3,2,3,1,1,5,-1,A
1926-11-13,1926,Sheffield Wednesday,Bolton Wanderers,2-1,2,1,1,1,3,1,H
1926-11-13,1926,Sunderland,Liverpool,2-1,2,1,1,1,3,1,H
1926-11-13,1926,Tottenham Hotspur,Cardiff City,4-1,4,1,1,1,5,3,H
1926-11-13,1926,West Bromwich Albion,Leeds United,2-4,2,4,1,1,6,-2,A
1926-11-13,1926,West Ham United,Aston Villa,5-1,5,1,1,1,6,4,H
1926-11-20,1926,Arsenal,Sunderland,2-3,2,3,1,1,5,-1,A
1926-11-20,1926,Aston Villa,Sheffield Wednesday,2-2,2,2,1,1,4,0,D
1926-11-20,1926,Bolton Wanderers,Leicester City,2-0,2,0,1,1,2,2,H
1926-11-20,1926,Burnley,Tottenham Hotspur,5-0,5,0,1,1,5,5,H
1926-11-20,1926,Cardiff City,West Ham United,1-2,1,2,1,1,3,-1,A
1926-11-20,1926,Derby County,Blackburn Rovers,4-5,4,5,1,1,9,-1,A
1926-11-20,1926,Leeds United,Bury,4-1,4,1,1,1,5,3,H
1926-11-20,1926,Liverpool,West Bromwich Albion,2-1,2,1,1,1,3,1,H
1926-11-20,1926,Manchester United,Everton,2-1,2,1,1,1,3,1,H
1926-11-20,1926,Newcastle United,Birmingham City,5-1,5,1,1,1,6,4,H
1926-11-20,1926,Sheffield United,Huddersfield Town,3-3,3,3,1,1,6,0,D
1926-11-27,1926,Birmingham City,Leeds United,2-0,2,0,1,1,2,2,H
1926-11-27,1926,Blackburn Rovers,Manchester United,2-1,2,1,1,1,3,1,H
1926-11-27,1926,Bury,Liverpool,0-2,0,2,1,1,2,-2,A
1926-11-27,1926,Everton,Bolton Wanderers,1-1,1,1,1,1,2,0,D
1926-11-27,1926,Huddersfield Town,Derby County,4-2,4,2,1,1,6,2,H
1926-11-27,1926,Leicester City,Aston Villa,5-1,5,1,1,1,6,4,H
1926-11-27,1926,Sunderland,Sheffield United,3-0,3,0,1,1,3,3,H
1926-11-27,1926,Tottenham Hotspur,Newcastle United,1-3,1,3,1,1,4,-2,A
1926-11-27,1926,West Bromwich Albion,Arsenal,1-3,1,3,1,1,4,-2,A
1926-11-27,1926,West Ham United,Burnley,2-1,2,1,1,1,3,1,H
1926-11-29,1926,Sheffield Wednesday,Cardiff City,3-0,3,0,1,1,3,3,H
1926-12-04,1926,Arsenal,Bury,1-0,1,0,1,1,1,1,H
1926-12-04,1926,Aston Villa,Everton,5-3,5,3,1,1,8,2,H
1926-12-04,1926,Bolton Wanderers,Blackburn Rovers,5-1,5,1,1,1,6,4,H
1926-12-04,1926,Burnley,Sheffield Wednesday,1-0,1,0,1,1,1,1,H
1926-12-04,1926,Cardiff City,Leicester City,0-1,0,1,1,1,1,-1,A
1926-12-04,1926,Derby County,Sunderland,4-2,4,2,1,1,6,2,H
1926-12-04,1926,Leeds United,Tottenham Hotspur,1-1,1,1,1,1,2,0,D
1926-12-04,1926,Liverpool,Birmingham City,2-1,2,1,1,1,3,1,H
1926-12-04,1926,Manchester United,Huddersfield Town,0-0,0,0,1,1,0,0,D
1926-12-04,1926,Newcastle United,West Ham United,2-0,2,0,1,1,2,2,H
1926-12-04,1926,Sheffield United,West Bromwich Albion,2-1,2,1,1,1,3,1,H
1926-12-11,1926,Birmingham City,Arsenal,0-0,0,0,1,1,0,0,D
1926-12-11,1926,Blackburn Rovers,Aston Villa,0-2,0,2,1,1,2,-2,A
1926-12-11,1926,Bury,Sheffield United,4-4,4,4,1,1,8,0,D
1926-12-11,1926,Everton,Cardiff City,0-1,0,1,1,1,1,-1,A
1926-12-11,1926,Huddersfield Town,Bolton Wanderers,1-0,1,0,1,1,1,1,H
1926-12-11,1926,Leicester City,Burnley,0-3,0,3,1,1,3,-3,A
1926-12-11,1926,Sheffield Wednesday,Newcastle United,3-2,3,2,1,1,5,1,H
1926-12-11,1926,Sunderland,Manchester United,6-0,6,0,1,1,6,6,H
1926-12-11,1926,Tottenham Hotspur,Liverpool,1-2,1,2,1,1,3,-1,A
1926-12-11,1926,West Bromwich Albion,Derby County,3-1,3,1,1,1,4,2,H
1926-12-11,1926,West Ham United,Leeds United,3-2,3,2,1,1,5,1,H
1926-12-18,1926,Arsenal,Tottenham Hotspur,2-4,2,4,1,1,6,-2,A
1926-12-18,1926,Aston Villa,Huddersfield Town,3-0,3,0,1,1,3,3,H
1926-12-18,1926,Bolton Wanderers,Sunderland,2-2,2,2,1,1,4,0,D
1926-12-18,1926,Burnley,Everton,5-1,5,1,1,1,6,4,H
1926-12-18,1926,Cardiff City,Blackburn Rovers,0-1,0,1,1,1,1,-1,A
1926-12-18,1926,Derby County,Bury,2-0,2,0,1,1,2,2,H
1926-12-18,1926,Leeds United,Sheffield Wednesday,4-1,4,1,1,1,5,3,H
1926-12-18,1926,Liverpool,West Ham United,0-0,0,0,1,1,0,0,D
1926-12-18,1926,Manchester United,West Bromwich Albion,2-0,2,0,1,1,2,2,H
1926-12-18,1926,Newcastle United,Leicester City,1-1,1,1,1,1,2,0,D
1926-12-18,1926,Sheffield United,Birmingham City,4-3,4,3,1,1,7,1,H
1926-12-25,1926,Aston Villa,Sheffield United,4-0,4,0,1,1,4,4,H
1926-12-25,1926,Blackburn Rovers,Huddersfield Town,4-2,4,2,1,1,6,2,H
1926-12-25,1926,Bolton Wanderers,Derby County,3-1,3,1,1,1,4,2,H
1926-12-25,1926,Burnley,Liverpool,4-0,4,0,1,1,4,4,H
1926-12-25,1926,Bury,Sheffield Wednesday,2-0,2,0,1,1,2,2,H
1926-12-25,1926,Everton,Sunderland,5-4,5,4,1,1,9,1,H
1926-12-25,1926,Leicester City,West Bromwich Albion,5-0,5,0,1,1,5,5,H
1926-12-25,1926,Newcastle United,Cardiff City,5-0,5,0,1,1,5,5,H
1926-12-25,1926,Tottenham Hotspur,Manchester United,1-1,1,1,1,1,2,0,D
1926-12-25,1926,West Ham United,Birmingham City,1-0,1,0,1,1,1,1,H
1926-12-27,1926,Birmingham City,West Ham United,0-2,0,2,1,1,2,-2,A
1926-12-27,1926,Cardiff City,Arsenal,2-0,2,0,1,1,2,2,H
1926-12-27,1926,Derby County,Bolton Wanderers,2-0,2,0,1,1,2,2,H
1926-12-27,1926,Huddersfield Town,Blackburn Rovers,5-0,5,0,1,1,5,5,H
1926-12-27,1926,Leeds United,Newcastle United,1-2,1,2,1,1,3,-1,A
1926-12-27,1926,Liverpool,Burnley,2-2,2,2,1,1,4,0,D
1926-12-27,1926,Manchester United,Tottenham Hotspur,2-1,2,1,1,1,3,1,H
1926-12-27,1926,Sheffield United,Aston Villa,3-1,3,1,1,1,4,2,H
1926-12-27,1926,Sunderland,Everton,3-2,3,2,1,1,5,1,H
1926-12-27,1926,West Bromwich Albion,Leicester City,0-1,0,1,1,1,1,-1,A
1926-12-28,1926,Arsenal,Manchester United,1-0,1,0,1,1,1,1,H
1926-12-28,1926,Aston Villa,Leeds United,5-1,5,1,1,1,6,4,H
1926-12-28,1926,Derby County,West Ham United,3-0,3,0,1,1,3,3,H
1926-12-28,1926,Liverpool,Bolton Wanderers,3-2,3,2,1,1,5,1,H
1926-12-28,1926,Sheffield Wednesday,Tottenham Hotspur,3-1,3,1,1,1,4,2,H
1927-01-01,1926,Arsenal,Cardiff City,3-2,3,2,1,1,5,1,H
1927-01-01,1926,Birmingham City,Leicester City,2-1,2,1,1,1,3,1,H
1927-01-01,1926,Bolton Wanderers,Liverpool,2-1,2,1,1,1,3,1,H
1927-01-01,1926,Everton,Burnley,3-2,3,2,1,1,5,1,H
1927-01-01,1926,Manchester United,Sheffield United,5-0,5,0,1,1,5,5,H
1927-01-01,1926,Newcastle United,Leeds United,1-0,1,0,1,1,1,1,H
1927-01-01,1926,Sheffield Wednesday,Bury,1-3,1,3,1,1,4,-2,A
1927-01-01,1926,Sunderland,Blackburn Rovers,2-5,2,5,1,1,7,-3,A
1927-01-01,1926,West Bromwich Albion,Huddersfield Town,2-2,2,2,1,1,4,0,D
1927-01-01,1926,West Ham United,Derby County,1-2,1,2,1,1,3,-1,A
1927-01-15,1926,Aston Villa,Newcastle United,1-2,1,2,1,1,3,-1,A
1927-01-15,1926,Blackburn Rovers,Birmingham City,3-2,3,2,1,1,5,1,H
1927-01-15,1926,Bolton Wanderers,Leeds United,3-0,3,0,1,1,3,3,H
1927-01-15,1926,Cardiff City,Burnley,0-0,0,0,1,1,0,0,D
1927-01-15,1926,Derby County,Arsenal,0-2,0,2,1,1,2,-2,A
1927-01-15,1926,Everton,Tottenham Hotspur,1-2,1,2,1,1,3,-1,A
1927-01-15,1926,Huddersfield Town,Bury,3-1,3,1,1,1,4,2,H
1927-01-15,1926,Leicester City,West Ham United,3-0,3,0,1,1,3,3,H
1927-01-15,1926,Manchester United,Liverpool,0-1,0,1,1,1,1,-1,A
1927-01-15,1926,Sheffield United,Sheffield Wednesday,2-0,2,0,1,1,2,2,H
1927-01-15,1926,Sunderland,West Bromwich Albion,4-1,4,1,1,1,5,3,H
1927-01-22,1926,Arsenal,Sheffield United,1-1,1,1,1,1,2,0,D
1927-01-22,1926,Birmingham City,Huddersfield Town,1-3,1,3,1,1,4,-2,A
1927-01-22,1926,Burnley,Aston Villa,6-3,6,3,1,1,9,3,H
1927-01-22,1926,Leeds United,Manchester United,2-3,2,3,1,1,5,-1,A
1927-01-22,1926,Liverpool,Derby County,3-2,3,2,1,1,5,1,H
1927-01-22,1926,Newcastle United,Bolton Wanderers,1-0,1,0,1,1,1,1,H
1927-01-22,1926,Sheffield Wednesday,Leicester City,2-2,2,2,1,1,4,0,D
1927-01-22,1926,Tottenham Hotspur,Blackburn Rovers,1-1,1,1,1,1,2,0,D
1927-01-22,1926,West Ham United,Everton,2-1,2,1,1,1,3,1,H
1927-01-29,1926,Aston Villa,Blackburn Rovers,4-3,4,3,1,1,7,1,H
1927-01-29,1926,Huddersfield Town,Tottenham Hotspur,2-0,2,0,1,1,2,2,H
1927-01-29,1926,Sunderland,Leicester City,3-0,3,0,1,1,3,3,H
1927-01-29,1926,West Bromwich Albion,Bury,3-1,3,1,1,1,4,2,H
1927-01-31,1926,Aston Villa,Cardiff City,0-0,0,0,1,1,0,0,D
1927-02-05,1926,Birmingham City,West Bromwich Albion,1-0,1,0,1,1,1,1,H
1927-02-05,1926,Burnley,Manchester United,1-0,1,0,1,1,1,1,H
1927-02-05,1926,Bury,Aston Villa,0-1,0,1,1,1,1,-1,A
1927-02-05,1926,Cardiff City,Bolton Wanderers,1-0,1,0,1,1,1,1,H
1927-02-05,1926,Leeds United,Sheffield United,1-1,1,1,1,1,2,0,D
1927-02-05,1926,Leicester City,Everton,6-2,6,2,1,1,8,4,H
1927-02-05,1926,Liverpool,Arsenal,3-0,3,0,1,1,3,3,H
1927-02-05,1926,Newcastle United,Derby County,3-0,3,0,1,1,3,3,H
1927-02-05,1926,Sheffield Wednesday,Blackburn Rovers,0-3,0,3,1,1,3,-3,A
1927-02-05,1926,Tottenham Hotspur,Sunderland,0-2,0,2,1,1,2,-2,A
1927-02-05,1926,West Ham United,Huddersfield Town,3-2,3,2,1,1,5,1,H
1927-02-07,1926,Sheffield United,Liverpool,1-4,1,4,1,1,5,-3,A
1927-02-09,1926,Manchester United,Newcastle United,3-1,3,1,1,1,4,2,H
1927-02-10,1926,Leicester City,Arsenal,2-1,2,1,1,1,3,1,H
1927-02-12,1926,Arsenal,Leeds United,1-0,1,0,1,1,1,1,H
1927-02-12,1926,Blackburn Rovers,Leicester City,2-1,2,1,1,1,3,1,H
1927-02-12,1926,Bolton Wanderers,Aston Villa,0-2,0,2,1,1,2,-2,A
1927-02-12,1926,Bury,Birmingham City,3-1,3,1,1,1,4,2,H
1927-02-12,1926,Derby County,Burnley,4-1,4,1,1,1,5,3,H
1927-02-12,1926,Huddersfield Town,Sheffield Wednesday,4-3,4,3,1,1,7,1,H
1927-02-12,1926,Liverpool,Everton,1-0,1,0,1,1,1,1,H
1927-02-12,1926,Manchester United,Cardiff City,1-1,1,1,1,1,2,0,D
1927-02-12,1926,Sheffield United,Newcastle United,2-1,2,1,1,1,3,1,H
1927-02-12,1926,Sunderland,West Ham United,2-3,2,3,1,1,5,-1,A
1927-02-12,1926,West Bromwich Albion,Tottenham Hotspur,5-0,5,0,1,1,5,5,H
1927-02-14,1926,Blackburn Rovers,West Ham United,4-1,4,1,1,1,5,3,H
1927-02-16,1926,Sunderland,Birmingham City,4-1,4,1,1,1,5,3,H
1927-02-19,1926,Aston Villa,Manchester United,2-0,2,0,1,1,2,2,H
1927-02-19,1926,Derby County,Leeds United,1-0,1,0,1,1,1,1,H
1927-02-19,1926,Everton,Blackburn Rovers,1-0,1,0,1,1,1,1,H
1927-02-19,1926,Leicester City,Huddersfield Town,2-4,2,4,1,1,6,-2,A
1927-02-19,1926,Sheffield Wednesday,Sunderland,4-1,4,1,1,1,5,3,H
1927-02-19,1926,Tottenham Hotspur,Bury,1-0,1,0,1,1,1,1,H
1927-02-19,1926,West Ham United,West Bromwich Albion,1-2,1,2,1,1,3,-1,A
1927-02-21,1926,West Bromwich Albion,Cardiff City,1-2,1,2,1,1,3,-1,A
1927-02-23,1926,Leeds United,Liverpool,0-0,0,0,1,1,0,0,D
1927-02-26,1926,Arsenal,Burnley,6-2,6,2,1,1,8,4,H
1927-02-26,1926,Birmingham City,Tottenham Hotspur,1-0,1,0,1,1,1,1,H
1927-02-26,1926,Blackburn Rovers,Leeds United,4-1,4,1,1,1,5,3,H
1927-02-26,1926,Bury,West Ham United,1-2,1,2,1,1,3,-1,A
1927-02-26,1926,Derby County,Aston Villa,2-3,2,3,1,1,5,-1,A
1927-02-26,1926,Huddersfield Town,Everton,0-0,0,0,1,1,0,0,D
1927-02-26,1926,Liverpool,Newcastle United,1-2,1,2,1,1,3,-1,A
1927-02-26,1926,Manchester United,Bolton Wanderers,0-0,0,0,1,1,0,0,D
1927-02-26,1926,Sheffield United,Cardiff City,3-1,3,1,1,1,4,2,H
1927-02-26,1926,West Bromwich Albion,Sheffield Wednesday,2-2,2,2,1,1,4,0,D
1927-03-02,1926,Everton,Sheffield Wednesday,2-1,2,1,1,1,3,1,H
1927-03-05,1926,Aston Villa,Sunderland,3-1,3,1,1,1,4,2,H
1927-03-05,1926,Bolton Wanderers,West Bromwich Albion,1-1,1,1,1,1,2,0,D
1927-03-05,1926,Burnley,Blackburn Rovers,3-1,3,1,1,1,4,2,H
1927-03-05,1926,Derby County,Birmingham City,4-1,4,1,1,1,5,3,H
1927-03-05,1926,Leeds United,Leicester City,1-1,1,1,1,1,2,0,D
1927-03-05,1926,Liverpool,Sheffield Wednesday,3-0,3,0,1,1,3,3,H
1927-03-05,1926,Manchester United,Bury,1-2,1,2,1,1,3,-1,A
1927-03-05,1926,Newcastle United,Everton,7-3,7,3,1,1,10,4,H
1927-03-05,1926,Sheffield United,Tottenham Hotspur,3-3,3,3,1,1,6,0,D
1927-03-07,1926,West Ham United,Arsenal,7-0,7,0,1,1,7,7,H
1927-03-09,1926,Bolton Wanderers,Burnley,3-1,3,1,1,1,4,2,H
1927-03-12,1926,Birmingham City,Manchester United,4-0,4,0,1,1,4,4,H
1927-03-12,1926,Blackburn Rovers,Newcastle United,1-2,1,2,1,1,3,-1,A
1927-03-12,1926,Bury,Bolton Wanderers,2-0,2,0,1,1,2,2,H
1927-03-12,1926,Everton,Leeds United,2-1,2,1,1,1,3,1,H
1927-03-12,1926,Huddersfield Town,Burnley,2-0,2,0,1,1,2,2,H
1927-03-12,1926,Leicester City,Liverpool,3-2,3,2,1,1,5,1,H
1927-03-12,1926,Sheffield Wednesday,Arsenal,4-2,4,2,1,1,6,2,H
1927-03-12,1926,Sunderland,Cardiff City,2-2,2,2,1,1,4,0,D
1927-03-12,1926,Tottenham Hotspur,Derby County,3-2,3,2,1,1,5,1,H
1927-03-12,1926,West Bromwich Albion,Aston Villa,6-2,6,2,1,1,8,4,H
1927-03-12,1926,West Ham United,Sheffield United,3-0,3,0,1,1,3,3,H
1927-03-16,1926,Cardiff City,Derby County,2-0,2,0,1,1,2,2,H
1927-03-19,1926,Arsenal,Everton,1-2,1,2,1,1,3,-1,A
1927-03-19,1926,Aston Villa,Birmingham City,4-2,4,2,1,1,6,2,H
1927-03-19,1926,Bolton Wanderers,Tottenham Hotspur,2-2,2,2,1,1,4,0,D
1927-03-19,1926,Burnley,West Bromwich Albion,2-1,2,1,1,1,3,1,H
1927-03-19,1926,Cardiff City,Bury,2-1,2,1,1,1,3,1,H
1927-03-19,1926,Derby County,Sheffield Wednesday,8-0,8,0,1,1,8,8,H
1927-03-19,1926,Leeds United,Huddersfield Town,1-1,1,1,1,1,2,0,D
1927-03-19,1926,Liverpool,Blackburn Rovers,2-2,2,2,1,1,4,0,D
1927-03-19,1926,Manchester United,West Ham United,0-3,0,3,1,1,3,-3,A
1927-03-19,1926,Newcastle United,Sunderland,1-0,1,0,1,1,1,1,H
1927-03-19,1926,Sheffield United,Leicester City,0-3,0,3,1,1,3,-3,A
1927-03-21,1926,Cardiff City,Huddersfield Town,2-0,2,0,1,1,2,2,H
1927-03-26,1926,Bury,Burnley,3-3,3,3,1,1,6,0,D
1927-03-26,1926,Everton,Sheffield United,2-0,2,0,1,1,2,2,H
1927-03-26,1926,Huddersfield Town,Liverpool,1-0,1,0,1,1,1,1,H
1927-03-26,1926,Leicester City,Derby County,1-1,1,1,1,1,2,0,D
1927-03-26,1926,Sheffield Wednesday,Manchester United,2-0,2,0,1,1,2,2,H
1927-03-26,1926,Sunderland,Leeds United,6-2,6,2,1,1,8,4,H
1927-03-26,1926,Tottenham Hotspur,Aston Villa,0-1,0,1,1,1,1,-1,A
1927-03-26,1926,West Bromwich Albion,Newcastle United,4-2,4,2,1,1,6,2,H
1927-03-26,1926,West Ham United,Bolton Wanderers,4-4,4,4,1,1,8,0,D
1927-03-29,1926,Burnley,Sheffield United,2-5,2,5,1,1,7,-3,A
1927-03-30,1926,Bury,Sunderland,1-2,1,2,1,1,3,-1,A
1927-04-02,1926,Arsenal,Huddersfield Town,0-2,0,2,1,1,2,-2,A
1927-04-02,1926,Aston Villa,West Ham United,1-5,1,5,1,1,6,-4,A
1927-04-02,1926,Bolton Wanderers,Sheffield Wednesday,3-2,3,2,1,1,5,1,H
1927-04-02,1926,Burnley,Birmingham City,0-2,0,2,1,1,2,-2,A
1927-04-02,1926,Cardiff City,Tottenham Hotspur,1-2,1,2,1,1,3,-1,A
1927-04-02,1926,Derby County,Everton,0-0,0,0,1,1,0,0,D
1927-04-02,1926,Leeds United,West Bromwich Albion,3-1,3,1,1,1,4,2,H
1927-04-02,1926,Liverpool,Sunderland,1-2,1,2,1,1,3,-1,A
1927-04-02,1926,Manchester United,Leicester City,1-0,1,0,1,1,1,1,H
1927-04-02,1926,Newcastle United,Bury,3-1,3,1,1,1,4,2,H
1927-04-02,1926,Sheffield United,Blackburn Rovers,5-3,5,3,1,1,8,2,H
1927-04-04,1926,Birmingham City,Bolton Wanderers,6-1,6,1,1,1,7,5,H
1927-04-06,1926,Newcastle United,Arsenal,6-1,6,1,1,1,7,5,H
1927-04-07,1926,Leicester City,Cardiff City,3-1,3,1,1,1,4,2,H
1927-04-09,1926,Birmingham City,Newcastle United,2-0,2,0,1,1,2,2,H
1927-04-09,1926,Blackburn Rovers,Derby County,4-4,4,4,1,1,8,0,D
1927-04-09,1926,Bury,Leeds United,4-2,4,2,1,1,6,2,H
1927-04-09,1926,Everton,Manchester United,0-0,0,0,1,1,0,0,D
1927-04-09,1926,Huddersfield Town,Sheffield United,0-2,0,2,1,1,2,-2,A
1927-04-09,1926,Leicester City,Bolton Wanderers,0-1,0,1,1,1,1,-1,A
1927-04-09,1926,Sheffield Wednesday,Aston Villa,3-1,3,1,1,1,4,2,H
1927-04-09,1926,Sunderland,Arsenal,5-1,5,1,1,1,6,4,H
1927-04-09,1926,Tottenham Hotspur,Burnley,4-1,4,1,1,1,5,3,H
1927-04-09,1926,West Bromwich Albion,Liverpool,0-1,0,1,1,1,1,-1,A
1927-04-09,1926,West Ham United,Cardiff City,2-2,2,2,1,1,4,0,D
1927-04-15,1926,Arsenal,Aston Villa,2-1,2,1,1,1,3,1,H
1927-04-15,1926,Bolton Wanderers,Sheffield United,4-1,4,1,1,1,5,3,H
1927-04-15,1926,Burnley,Leeds United,3-2,3,2,1,1,5,1,H
1927-04-15,1926,Bury,Leicester City,0-0,0,0,1,1,0,0,D
1927-04-15,1926,Liverpool,Cardiff City,5-0,5,0,1,1,5,5,H
1927-04-15,1926,Manchester United,Derby County,2-2,2,2,1,1,4,0,D
1927-04-15,1926,Newcastle United,Huddersfield Town,1-0,1,0,1,1,1,1,H
1927-04-15,1926,Tottenham Hotspur,West Ham United,1-3,1,3,1,1,4,-2,A
1927-04-16,1926,Arsenal,West Bromwich Albion,4-1,4,1,1,1,5,3,H
1927-04-16,1926,Aston Villa,Leicester City,2-0,2,0,1,1,2,2,H
1927-04-16,1926,Bolton Wanderers,Everton,5-0,5,0,1,1,5,5,H
1927-04-16,1926,Burnley,West Ham United,2-1,2,1,1,1,3,1,H
1927-04-16,1926,Cardiff City,Sheffield Wednesday,3-2,3,2,1,1,5,1,H
1927-04-16,1926,Derby County,Huddersfield Town,4-4,4,4,1,1,8,0,D
1927-04-16,1926,Leeds United,Birmingham City,2-1,2,1,1,1,3,1,H
1927-04-16,1926,Liverpool,Bury,2-2,2,2,1,1,4,0,D
1927-04-16,1926,Manchester United,Blackburn Rovers,2-0,2,0,1,1,2,2,H
1927-04-16,1926,Newcastle United,Tottenham Hotspur,3-2,3,2,1,1,5,1,H
1927-04-16,1926,Sheffield United,Sunderland,2-0,2,0,1,1,2,2,H
1927-04-18,1926,Aston Villa,Arsenal,2-3,2,3,1,1,5,-1,A
1927-04-18,1926,Cardiff City,Liverpool,2-0,2,0,1,1,2,2,H
1927-04-18,1926,Derby County,Manchester United,2-2,2,2,1,1,4,0,D
1927-04-18,1926,Everton,Birmingham City,3-1,3,1,1,1,4,2,H
1927-04-18,1926,Leicester City,Bury,1-1,1,1,1,1,2,0,D
1927-04-18,1926,Sheffield United,Bolton Wanderers,1-1,1,1,1,1,2,0,D
1927-04-18,1926,West Bromwich Albion,Blackburn Rovers,2-0,2,0,1,1,2,2,H
1927-04-18,1926,West Ham United,Tottenham Hotspur,1-2,1,2,1,1,3,-1,A
1927-04-19,1926,Blackburn Rovers,West Bromwich Albion,0-0,0,0,1,1,0,0,D
1927-04-19,1926,Huddersfield Town,Newcastle United,1-0,1,0,1,1,1,1,H
1927-04-19,1926,Leeds United,Burnley,0-2,0,2,1,1,2,-2,A
1927-04-19,1926,Sheffield Wednesday,Birmingham City,4-4,4,4,1,1,8,0,D
1927-04-19,1926,Sunderland,Bolton Wanderers,6-2,6,2,1,1,8,4,H
1927-04-23,1926,Birmingham City,Liverpool,3-0,3,0,1,1,3,3,H
1927-04-23,1926,Blackburn Rovers,Bolton Wanderers,0-3,0,3,1,1,3,-3,A
1927-04-23,1926,Everton,Aston Villa,2-2,2,2,1,1,4,0,D
1927-04-23,1926,Huddersfield Town,Manchester United,0-0,0,0,1,1,0,0,D
1927-04-23,1926,Sheffield Wednesday,Burnley,2-1,2,1,1,1,3,1,H
1927-04-23,1926,Sunderland,Derby County,1-2,1,2,1,1,3,-1,A
1927-04-23,1926,Tottenham Hotspur,Leeds United,4-1,4,1,1,1,5,3,H
1927-04-23,1926,West Bromwich Albion,Sheffield United,1-0,1,0,1,1,1,1,H
1927-04-23,1926,West Ham United,Newcastle United,1-1,1,1,1,1,2,0,D
1927-04-27,1926,Birmingham City,Cardiff City,1-2,1,2,1,1,3,-1,A
1927-04-28,1926,Blackburn Rovers,Arsenal,1-2,1,2,1,1,3,-1,A
1927-04-30,1926,Arsenal,Birmingham City,3-0,3,0,1,1,3,3,H
1927-04-30,1926,Bolton Wanderers,Huddersfield Town,4-0,4,0,1,1,4,4,H
1927-04-30,1926,Burnley,Leicester City,1-1,1,1,1,1,2,0,D
1927-04-30,1926,Cardiff City,Everton,1-0,1,0,1,1,1,1,H
1927-04-30,1926,Derby County,West Bromwich Albion,2-1,2,1,1,1,3,1,H
1927-04-30,1926,Leeds United,West Ham United,6-3,6,3,1,1,9,3,H
1927-04-30,1926,Liverpool,Tottenham Hotspur,1-0,1,0,1,1,1,1,H
1927-04-30,1926,Manchester United,Sunderland,0-0,0,0,1,1,0,0,D
1927-04-30,1926,Newcastle United,Sheffield Wednesday,2-1,2,1,1,1,3,1,H
1927-05-04,1926,Bury,Arsenal,3-2,3,2,1,1,5,1,H
1927-05-05,1926,Sheffield United,Bury,2-0,2,0,1,1,2,2,H
1927-05-07,1926,Birmingham City,Sheffield United,2-3,2,3,1,1,5,-1,A
1927-05-07,1926,Blackburn Rovers,Cardiff City,1-0,1,0,1,1,1,1,H
1927-05-07,1926,Bury,Derby County,1-2,1,2,1,1,3,-1,A
1927-05-07,1926,Huddersfield Town,Aston Villa,0-0,0,0,1,1,0,0,D
1927-05-07,1926,Leicester City,Newcastle United,2-1,2,1,1,1,3,1,H
1927-05-07,1926,Sheffield Wednesday,Leeds United,1-0,1,0,1,1,1,1,H
1927-05-07,1926,Tottenham Hotspur,Arsenal,0-4,0,4,1,1,4,-4,A
1927-05-07,1926,West Bromwich Albion,Manchester United,2-2,2,2,1,1,4,0,D
1927-05-07,1926,West Ham United,Liverpool,3-3,3,3,1,1,6,0,D
1927-08-27,1927,Aston Villa,Leicester City,0-3,0,3,1,1,3,-3,A
1927-08-27,1927,Blackburn Rovers,Burnley,2-1,2,1,1,1,3,1,H
1927-08-27,1927,Bury,Arsenal,5-1,5,1,1,1,6,4,H
1927-08-27,1927,Cardiff City,Bolton Wanderers,2-1,2,1,1,1,3,1,H
1927-08-27,1927,Derby County,West Ham United,2-3,2,3,1,1,5,-1,A
1927-08-27,1927,Everton,Sheffield Wednesday,4-0,4,0,1,1,4,4,H
1927-08-27,1927,Huddersfield Town,Newcastle United,1-3,1,3,1,1,4,-2,A
1927-08-27,1927,Manchester United,Middlesbrough,3-0,3,0,1,1,3,3,H
1927-08-27,1927,Sheffield United,Liverpool,1-1,1,1,1,1,2,0,D
1927-08-27,1927,Sunderland,Portsmouth,3-3,3,3,1,1,6,0,D
1927-08-27,1927,Tottenham Hotspur,Birmingham City,1-0,1,0,1,1,1,1,H
1927-08-29,1927,Birmingham City,Huddersfield Town,3-1,3,1,1,1,4,2,H
1927-08-29,1927,Leicester City,Sheffield United,3-1,3,1,1,1,4,2,H
1927-08-29,1927,Sheffield Wednesday,Manchester United,0-2,0,2,1,1,2,-2,A
1927-08-31,1927,Arsenal,Burnley,4-1,4,1,1,1,5,3,H
1927-08-31,1927,Liverpool,Bury,5-1,5,1,1,1,6,4,H
1927-08-31,1927,Middlesbrough,Tottenham Hotspur,3-1,3,1,1,1,4,2,H
1927-08-31,1927,Portsmouth,Aston Villa,3-1,3,1,1,1,4,2,H
1927-09-01,1927,West Ham United,Sunderland,2-4,2,4,1,1,6,-2,A
1927-09-03,1927,Arsenal,Sheffield United,6-1,6,1,1,1,7,5,H
1927-09-03,1927,Birmingham City,Manchester United,0-0,0,0,1,1,0,0,D
1927-09-03,1927,Bolton Wanderers,Blackburn Rovers,3-1,3,1,1,1,4,2,H
1927-09-03,1927,Burnley,Bury,2-3,2,3,1,1,5,-1,A
1927-09-03,1927,Leicester City,Sunderland,3-3,3,3,1,1,6,0,D
1927-09-03,1927,Liverpool,Aston Villa,0-0,0,0,1,1,0,0,D
1927-09-03,1927,Middlesbrough,Everton,4-2,4,2,1,1,6,2,H
1927-09-03,1927,Newcastle United,Tottenham Hotspur,4-1,4,1,1,1,5,3,H
1927-09-03,1927,Portsmouth,Derby County,2-2,2,2,1,1,4,0,D
1927-09-03,1927,Sheffield Wednesday,Cardiff City,3-3,3,3,1,1,6,0,D
1927-09-03,1927,West Ham United,Huddersfield Town,4-2,4,2,1,1,6,2,H
1927-09-05,1927,Aston Villa,Portsmouth,7-2,7,2,1,1,9,5,H
1927-09-05,1927,Blackburn Rovers,Cardiff City,0-0,0,0,1,1,0,0,D
1927-09-05,1927,Bolton Wanderers,Everton,1-1,1,1,1,1,2,0,D
1927-09-05,1927,Burnley,Arsenal,1-2,1,2,1,1,3,-1,A
1927-09-05,1927,Derby County,Newcastle United,1-1,1,1,1,1,2,0,D
1927-09-05,1927,Sheffield United,Leicester City,1-1,1,1,1,1,2,0,D
1927-09-07,1927,Manchester United,Sheffield Wednesday,1-1,1,1,1,1,2,0,D
1927-09-07,1927,Sunderland,Birmingham City,4-2,4,2,1,1,6,2,H
1927-09-10,1927,Aston Villa,Arsenal,2-2,2,2,1,1,4,0,D
1927-09-10,1927,Blackburn Rovers,Sheffield Wednesday,3-1,3,1,1,1,4,2,H
1927-09-10,1927,Bury,Bolton Wanderers,1-0,1,0,1,1,1,1,H
1927-09-10,1927,Cardiff City,Middlesbrough,1-1,1,1,1,1,2,0,D
1927-09-10,1927,Derby County,Leicester City,2-1,2,1,1,1,3,1,H
1927-09-10,1927,Everton,Birmingham City,5-2,5,2,1,1,7,3,H
1927-09-10,1927,Manchester United,Newcastle United,1-7,1,7,1,1,8,-6,A
1927-09-10,1927,Sheffield United,Burnley,5-2,5,2,1,1,7,3,H
1927-09-10,1927,Sunderland,Liverpool,2-1,2,1,1,1,3,1,H
1927-09-10,1927,Tottenham Hotspur,Huddersfield Town,2-2,2,2,1,1,4,0,D
1927-09-10,1927,West Ham United,Portsmouth,4-2,4,2,1,1,6,2,H
1927-09-12,1927,Cardiff City,Blackburn Rovers,1-1,1,1,1,1,2,0,D
1927-09-12,1927,Tottenham Hotspur,Middlesbrough,4-2,4,2,1,1,6,2,H
1927-09-14,1927,Everton,Bolton Wanderers,2-2,2,2,1,1,4,0,D
1927-09-14,1927,Newcastle United,Derby County,4-3,4,3,1,1,7,1,H
1927-09-17,1927,Arsenal,Sunderland,2-1,2,1,1,1,3,1,H
1927-09-17,1927,Birmingham City,Cardiff City,1-3,1,3,1,1,4,-2,A
1927-09-17,1927,Burnley,Aston Villa,4-2,4,2,1,1,6,2,H
1927-09-17,1927,Bury,Sheffield United,1-0,1,0,1,1,1,1,H
1927-09-17,1927,Huddersfield Town,Manchester United,4-2,4,2,1,1,6,2,H
1927-09-17,1927,Leicester City,West Ham United,2-3,2,3,1,1,5,-1,A
1927-09-17,1927,Liverpool,Derby County,5-2,5,2,1,1,7,3,H
1927-09-17,1927,Middlesbrough,Blackburn Rovers,2-0,2,0,1,1,2,2,H
1927-09-17,1927,Newcastle United,Everton,2-2,2,2,1,1,4,0,D
1927-09-17,1927,Portsmouth,Tottenham Hotspur,3-0,3,0,1,1,3,3,H
1927-09-17,1927,Sheffield Wednesday,Bolton Wanderers,3-0,3,0,1,1,3,3,H
1927-09-19,1927,Blackburn Rovers,Manchester United,3-0,3,0,1,1,3,3,H
1927-09-19,1927,Bury,Liverpool,5-2,5,2,1,1,7,3,H
1927-09-22,1927,Tottenham Hotspur,Leicester City,2-1,2,1,1,1,3,1,H
1927-09-24,1927,Aston Villa,Bury,1-0,1,0,1,1,1,1,H
1927-09-24,1927,Blackburn Rovers,Birmingham City,4-4,4,4,1,1,8,0,D
1927-09-24,1927,Bolton Wanderers,Middlesbrough,0-0,0,0,1,1,0,0,D
1927-09-24,1927,Cardiff City,Newcastle United,3-1,3,1,1,1,4,2,H
1927-09-24,1927,Derby County,Arsenal,4-0,4,0,1,1,4,4,H
1927-09-24,1927,Everton,Huddersfield Town,2-2,2,2,1,1,4,0,D
1927-09-24,1927,Manchester United,Tottenham Hotspur,3-0,3,0,1,1,3,3,H
1927-09-24,1927,Portsmouth,Leicester City,2-0,2,0,1,1,2,2,H
1927-09-24,1927,Sheffield United,Sheffield Wednesday,1-1,1,1,1,1,2,0,D
1927-09-24,1927,Sunderland,Burnley,2-3,2,3,1,1,5,-1,A
1927-09-24,1927,West Ham United,Liverpool,3-1,3,1,1,1,4,2,H
1927-10-01,1927,Arsenal,West Ham United,2-2,2,2,1,1,4,0,D
1927-10-01,1927,Birmingham City,Bolton Wanderers,1-1,1,1,1,1,2,0,D
1927-10-01,1927,Burnley,Derby County,4-2,4,2,1,1,6,2,H
1927-10-01,1927,Bury,Sunderland,5-3,5,3,1,1,8,2,H
1927-10-01,1927,Huddersfield Town,Cardiff City,8-2,8,2,1,1,10,6,H
1927-10-01,1927,Leicester City,Manchester United,1-0,1,0,1,1,1,1,H
1927-10-01,1927,Liverpool,Portsmouth,8-2,8,2,1,1,10,6,H
1927-10-01,1927,Middlesbrough,Sheffield Wednesday,3-3,3,3,1,1,6,0,D
1927-10-01,1927,Newcastle United,Blackburn Rovers,0-1,0,1,1,1,1,-1,A
1927-10-01,1927,Sheffield United,Aston Villa,0-3,0,3,1,1,3,-3,A
1927-10-01,1927,Tottenham Hotspur,Everton,1-3,1,3,1,1,4,-2,A
1927-10-08,1927,Aston Villa,Middlesbrough,5-1,5,1,1,1,6,4,H
1927-10-08,1927,Blackburn Rovers,Huddersfield Town,1-1,1,1,1,1,2,0,D
1927-10-08,1927,Bolton Wanderers,Newcastle United,1-2,1,2,1,1,3,-1,A
1927-10-08,1927,Cardiff City,Tottenham Hotspur,2-1,2,1,1,1,3,1,H
1927-10-08,1927,Derby County,Bury,5-2,5,2,1,1,7,3,H
1927-10-08,1927,Everton,Manchester United,5-2,5,2,1,1,7,3,H
1927-10-08,1927,Leicester City,Liverpool,1-1,1,1,1,1,2,0,D
1927-10-08,1927,Portsmouth,Arsenal,2-3,2,3,1,1,5,-1,A
1927-10-08,1927,Sheffield Wednesday,Birmingham City,2-3,2,3,1,1,5,-1,A
1927-10-08,1927,Sunderland,Sheffield United,0-1,0,1,1,1,1,-1,A
1927-10-08,1927,West Ham United,Burnley,2-0,2,0,1,1,2,2,H
1927-10-15,1927,Arsenal,Leicester City,2-2,2,2,1,1,4,0,D
1927-10-15,1927,Aston Villa,Sunderland,4-2,4,2,1,1,6,2,H
1927-10-15,1927,Birmingham City,Middlesbrough,3-2,3,2,1,1,5,1,H
1927-10-15,1927,Burnley,Portsmouth,2-0,2,0,1,1,2,2,H
1927-10-15,1927,Bury,West Ham United,3-1,3,1,1,1,4,2,H
1927-10-15,1927,Everton,Liverpool,1-1,1,1,1,1,2,0,D
1927-10-15,1927,Huddersfield Town,Bolton Wanderers,1-0,1,0,1,1,1,1,H
1927-10-15,1927,Manchester United,Cardiff City,2-2,2,2,1,1,4,0,D
1927-10-15,1927,Newcastle United,Sheffield Wednesday,4-3,4,3,1,1,7,1,H
1927-10-15,1927,Sheffield United,Derby County,1-0,1,0,1,1,1,1,H
1927-10-15,1927,Tottenham Hotspur,Blackburn Rovers,1-1,1,1,1,1,2,0,D
1927-10-22,1927,Birmingham City,Bury,2-2,2,2,1,1,4,0,D
1927-10-22,1927,Blackburn Rovers,Leicester City,0-0,0,0,1,1,0,0,D
1927-10-22,1927,Bolton Wanderers,Liverpool,2-1,2,1,1,1,3,1,H
1927-10-22,1927,Cardiff City,Portsmouth,3-1,3,1,1,1,4,2,H
1927-10-22,1927,Everton,West Ham United,7-0,7,0,1,1,7,7,H
1927-10-22,1927,Huddersfield Town,Aston Villa,1-1,1,1,1,1,2,0,D
1927-10-22,1927,Manchester United,Derby County,5-0,5,0,1,1,5,5,H
1927-10-22,1927,Middlesbrough,Burnley,2-3,2,3,1,1,5,-1,A
1927-10-22,1927,Newcastle United,Sheffield United,1-0,1,0,1,1,1,1,H
1927-10-22,1927,Sheffield Wednesday,Arsenal,1-1,1,1,1,1,2,0,D
1927-10-22,1927,Tottenham Hotspur,Sunderland,3-1,3,1,1,1,4,2,H
1927-10-29,1927,Arsenal,Bolton Wanderers,1-2,1,2,1,1,3,-1,A
1927-10-29,1927,Aston Villa,Newcastle United,3-0,3,0,1,1,3,3,H
1927-10-29,1927,Burnley,Sheffield Wednesday,3-1,3,1,1,1,4,2,H
1927-10-29,1927,Bury,Middlesbrough,1-4,1,4,1,1,5,-3,A
1927-10-29,1927,Derby County,Tottenham Hotspur,1-1,1,1,1,1,2,0,D
1927-10-29,1927,Leicester City,Cardiff City,4-1,4,1,1,1,5,3,H
1927-10-29,1927,Liverpool,Blackburn Rovers,4-2,4,2,1,1,6,2,H
1927-10-29,1927,Portsmouth,Everton,1-3,1,3,1,1,4,-2,A
1927-10-29,1927,Sheffield United,Birmingham City,3-1,3,1,1,1,4,2,H
1927-10-29,1927,Sunderland,Huddersfield Town,3-0,3,0,1,1,3,3,H
1927-10-29,1927,West Ham United,Manchester United,1-2,1,2,1,1,3,-1,A
1927-11-05,1927,Birmingham City,Aston Villa,1-1,1,1,1,1,2,0,D
1927-11-05,1927,Blackburn Rovers,Arsenal,4-1,4,1,1,1,5,3,H
1927-11-05,1927,Bolton Wanderers,Burnley,7-1,7,1,1,1,8,6,H
1927-11-05,1927,Cardiff City,Liverpool,1-1,1,1,1,1,2,0,D
1927-11-05,1927,Everton,Leicester City,7-1,7,1,1,1,8,6,H
1927-11-05,1927,Huddersfield Town,Derby County,2-1,2,1,1,1,3,1,H
1927-11-05,1927,Manchester United,Portsmouth,2-0,2,0,1,1,2,2,H
1927-11-05,1927,Middlesbrough,Sheffield United,3-0,3,0,1,1,3,3,H
1927-11-05,1927,Newcastle United,Sunderland,3-1,3,1,1,1,4,2,H
1927-11-05,1927,Sheffield Wednesday,Bury,4-0,4,0,1,1,4,4,H
1927-11-05,1927,Tottenham Hotspur,West Ham United,5-3,5,3,1,1,8,2,H
1927-11-12,1927,Arsenal,Middlesbrough,3-1,3,1,1,1,4,2,H
1927-11-12,1927,Aston Villa,Tottenham Hotspur,1-2,1,2,1,1,3,-1,A
1927-11-12,1927,Burnley,Birmingham City,2-1,2,1,1,1,3,1,H
1927-11-12,1927,Bury,Newcastle United,1-4,1,4,1,1,5,-3,A
1927-11-12,1927,Derby County,Everton,0-3,0,3,1,1,3,-3,A
1927-11-12,1927,Leicester City,Bolton Wanderers,4-2,4,2,1,1,6,2,H
1927-11-12,1927,Liverpool,Sheffield Wednesday,5-2,5,2,1,1,7,3,H
1927-11-12,1927,Portsmouth,Blackburn Rovers,2-2,2,2,1,1,4,0,D
1927-11-12,1927,Sheffield United,Huddersfield Town,1-7,1,7,1,1,8,-6,A
1927-11-12,1927,Sunderland,Manchester United,4-1,4,1,1,1,5,3,H
1927-11-12,1927,West Ham United,Cardiff City,2-0,2,0,1,1,2,2,H
1927-11-19,1927,Birmingham City,Arsenal,1-1,1,1,1,1,2,0,D
1927-11-19,1927,Blackburn Rovers,West Ham United,1-0,1,0,1,1,1,1,H
1927-11-19,1927,Bolton Wanderers,Portsmouth,3-1,3,1,1,1,4,2,H
1927-11-19,1927,Cardiff City,Derby County,4-4,4,4,1,1,8,0,D
1927-11-19,1927,Everton,Sunderland,0-1,0,1,1,1,1,-1,A
1927-11-19,1927,Huddersfield Town,Bury,3-0,3,0,1,1,3,3,H
1927-11-19,1927,Manchester United,Aston Villa,5-1,5,1,1,1,6,4,H
1927-11-19,1927,Middlesbrough,Liverpool,1-1,1,1,1,1,2,0,D
1927-11-19,1927,Newcastle United,Burnley,1-1,1,1,1,1,2,0,D
1927-11-19,1927,Sheffield Wednesday,Leicester City,1-2,1,2,1,1,3,-1,A
1927-11-19,1927,Tottenham Hotspur,Sheffield United,2-2,2,2,1,1,4,0,D
1927-11-26,1927,Aston Villa,Blackburn Rovers,2-0,2,0,1,1,2,2,H
1927-11-26,1927,Burnley,Manchester United,4-0,4,0,1,1,4,4,H
1927-11-26,1927,Bury,Everton,2-3,2,3,1,1,5,-1,A
1927-11-26,1927,Derby County,Sheffield Wednesday,4-6,4,6,1,1,10,-2,A
1927-11-26,1927,Leicester City,Newcastle United,3-0,3,0,1,1,3,3,H
1927-11-26,1927,Liverpool,Huddersfield Town,4-2,4,2,1,1,6,2,H
1927-11-26,1927,Portsmouth,Birmingham City,2-2,2,2,1,1,4,0,D
1927-11-26,1927,Sheffield United,Cardiff City,3-4,3,4,1,1,7,-1,A
1927-11-26,1927,Sunderland,Bolton Wanderers,1-1,1,1,1,1,2,0,D
1927-11-26,1927,West Ham United,Middlesbrough,4-5,4,5,1,1,9,-1,A
1927-12-03,1927,Birmingham City,Leicester City,0-2,0,2,1,1,2,-2,A
1927-12-03,1927,Blackburn Rovers,Sunderland,0-0,0,0,1,1,0,0,D
1927-12-03,1927,Cardiff City,Aston Villa,2-1,2,1,1,1,3,1,H
1927-12-03,1927,Everton,Sheffield United,0-0,0,0,1,1,0,0,D
1927-12-03,1927,Huddersfield Town,Arsenal,2-1,2,1,1,1,3,1,H
1927-12-03,1927,Manchester United,Bury,0-1,0,1,1,1,1,-1,A
1927-12-03,1927,Middlesbrough,Portsmouth,5-1,5,1,1,1,6,4,H
1927-12-03,1927,Newcastle United,Liverpool,1-1,1,1,1,1,2,0,D
1927-12-03,1927,Sheffield Wednesday,West Ham United,2-0,2,0,1,1,2,2,H
1927-12-03,1927,Tottenham Hotspur,Burnley,5-0,5,0,1,1,5,5,H
1927-12-10,1927,Arsenal,Newcastle United,4-1,4,1,1,1,5,3,H
1927-12-10,1927,Aston Villa,Everton,2-3,2,3,1,1,5,-1,A
1927-12-10,1927,Burnley,Huddersfield Town,0-1,0,1,1,1,1,-1,A
1927-12-10,1927,Bury,Tottenham Hotspur,1-2,1,2,1,1,3,-1,A
1927-12-10,1927,Derby County,Blackburn Rovers,6-0,6,0,1,1,6,6,H
1927-12-10,1927,Leicester City,Middlesbrough,3-3,3,3,1,1,6,0,D
1927-12-10,1927,Liverpool,Birmingham City,2-3,2,3,1,1,5,-1,A
1927-12-10,1927,Portsmouth,Sheffield Wednesday,0-0,0,0,1,1,0,0,D
1927-12-10,1927,Sheffield United,Manchester United,2-1,2,1,1,1,3,1,H
1927-12-10,1927,Sunderland,Cardiff City,0-2,0,2,1,1,2,-2,A
1927-12-10,1927,West Ham United,Bolton Wanderers,2-0,2,0,1,1,2,2,H
1927-12-17,1927,Birmingham City,West Ham United,1-2,1,2,1,1,3,-1,A
1927-12-17,1927,Blackburn Rovers,Sheffield United,1-0,1,0,1,1,1,1,H
1927-12-17,1927,Bolton Wanderers,Aston Villa,3-1,3,1,1,1,4,2,H
1927-12-17,1927,Cardiff City,Bury,0-1,0,1,1,1,1,-1,A
1927-12-17,1927,Everton,Burnley,4-1,4,1,1,1,5,3,H
1927-12-17,1927,Huddersfield Town,Leicester City,3-1,3,1,1,1,4,2,H
1927-12-17,1927,Manchester United,Arsenal,4-1,4,1,1,1,5,3,H
1927-12-17,1927,Middlesbrough,Derby County,3-3,3,3,1,1,6,0,D
1927-12-17,1927,Newcastle United,Portsmouth,1-3,1,3,1,1,4,-2,A
1927-12-17,1927,Sheffield Wednesday,Sunderland,0-0,0,0,1,1,0,0,D
1927-12-17,1927,Tottenham Hotspur,Liverpool,3-1,3,1,1,1,4,2,H
1927-12-24,1927,Arsenal,Everton,3-2,3,2,1,1,5,1,H
1927-12-24,1927,Aston Villa,Sheffield Wednesday,5-4,5,4,1,1,9,1,H
1927-12-24,1927,Burnley,Cardiff City,2-1,2,1,1,1,3,1,H
1927-12-24,1927,Bury,Blackburn Rovers,2-3,2,3,1,1,5,-1,A
1927-12-24,1927,Derby County,Birmingham City,4-1,4,1,1,1,5,3,H
1927-12-24,1927,Leicester City,Tottenham Hotspur,6-1,6,1,1,1,7,5,H
1927-12-24,1927,Liverpool,Manchester United,2-0,2,0,1,1,2,2,H
1927-12-24,1927,Portsmouth,Huddersfield Town,2-1,2,1,1,1,3,1,H
1927-12-24,1927,Sheffield United,Bolton Wanderers,4-3,4,3,1,1,7,1,H
1927-12-24,1927,Sunderland,Middlesbrough,1-0,1,0,1,1,1,1,H
1927-12-24,1927,West Ham United,Newcastle United,5-2,5,2,1,1,7,3,H
1927-12-26,1927,Birmingham City,Sunderland,1-1,1,1,1,1,2,0,D
1927-12-26,1927,Bolton Wanderers,Tottenham Hotspur,4-1,4,1,1,1,5,3,H
1927-12-26,1927,Bury,Portsmouth,4-0,4,0,1,1,4,4,H
1927-12-26,1927,Derby County,Aston Villa,5-0,5,0,1,1,5,5,H
1927-12-26,1927,Everton,Cardiff City,2-1,2,1,1,1,3,1,H
1927-12-26,1927,Huddersfield Town,Sheffield Wednesday,1-0,1,0,1,1,1,1,H
1927-12-26,1927,Leicester City,Burnley,5-0,5,0,1,1,5,5,H
1927-12-26,1927,Manchester United,Blackburn Rovers,1-1,1,1,1,1,2,0,D
1927-12-26,1927,Middlesbrough,Newcastle United,1-1,1,1,1,1,2,0,D
1927-12-26,1927,Sheffield United,West Ham United,6-2,6,2,1,1,8,4,H
1927-12-27,1927,Aston Villa,Derby County,0-1,0,1,1,1,1,-1,A
1927-12-27,1927,Burnley,Leicester City,5-1,5,1,1,1,6,4,H
1927-12-27,1927,Cardiff City,Everton,2-0,2,0,1,1,2,2,H
1927-12-27,1927,Liverpool,Arsenal,0-2,0,2,1,1,2,-2,A
1927-12-27,1927,Newcastle United,Middlesbrough,3-3,3,3,1,1,6,0,D
1927-12-27,1927,Portsmouth,Bury,1-0,1,0,1,1,1,1,H
1927-12-27,1927,Sheffield Wednesday,Huddersfield Town,0-5,0,5,1,1,5,-5,A
1927-12-27,1927,West Ham United,Sheffield United,1-1,1,1,1,1,2,0,D
1927-12-31,1927,Arsenal,Bury,3-1,3,1,1,1,4,2,H
1927-12-31,1927,Birmingham City,Tottenham Hotspur,3-2,3,2,1,1,5,1,H
1927-12-31,1927,Bolton Wanderers,Cardiff City,2-1,2,1,1,1,3,1,H
1927-12-31,1927,Burnley,Blackburn Rovers,3-1,3,1,1,1,4,2,H
1927-12-31,1927,Leicester City,Aston Villa,3-0,3,0,1,1,3,3,H
1927-12-31,1927,Liverpool,Sheffield United,2-1,2,1,1,1,3,1,H
1927-12-31,1927,Middlesbrough,Manchester United,1-2,1,2,1,1,3,-1,A
1927-12-31,1927,Newcastle United,Huddersfield Town,2-3,2,3,1,1,5,-1,A
1927-12-31,1927,Sheffield Wednesday,Everton,1-2,1,2,1,1,3,-1,A
1927-12-31,1927,West Ham United,Derby County,2-2,2,2,1,1,4,0,D
1928-01-02,1927,Arsenal,Tottenham Hotspur,1-1,1,1,1,1,2,0,D
1928-01-02,1927,Blackburn Rovers,Everton,4-2,4,2,1,1,6,2,H
1928-01-02,1927,Bolton Wanderers,Derby County,1-3,1,3,1,1,4,-2,A
1928-01-02,1927,Bury,Leicester City,2-1,2,1,1,1,3,1,H
1928-01-02,1927,Liverpool,Burnley,2-2,2,2,1,1,4,0,D
1928-01-02,1927,Middlesbrough,Huddersfield Town,3-1,3,1,1,1,4,2,H
1928-01-02,1927,Newcastle United,Birmingham City,1-1,1,1,1,1,2,0,D
1928-01-02,1927,Sheffield United,Portsmouth,3-1,3,1,1,1,4,2,H
1928-01-02,1927,Sunderland,West Ham United,3-2,3,2,1,1,5,1,H
1928-01-07,1927,Aston Villa,Liverpool,3-4,3,4,1,1,7,-1,A
1928-01-07,1927,Blackburn Rovers,Bolton Wanderers,1-6,1,6,1,1,7,-5,A
1928-01-07,1927,Bury,Burnley,2-0,2,0,1,1,2,2,H
1928-01-07,1927,Cardiff City,Sheffield Wednesday,1-1,1,1,1,1,2,0,D
1928-01-07,1927,Derby County,Portsmouth,2-2,2,2,1,1,4,0,D
1928-01-07,1927,Everton,Middlesbrough,3-1,3,1,1,1,4,2,H
1928-01-07,1927,Huddersfield Town,West Ham United,5-2,5,2,1,1,7,3,H
1928-01-07,1927,Manchester United,Birmingham City,1-1,1,1,1,1,2,0,D
1928-01-07,1927,Sheffield United,Arsenal,6-4,6,4,1,1,10,2,H
1928-01-07,1927,Sunderland,Leicester City,2-2,2,2,1,1,4,0,D
1928-01-07,1927,Tottenham Hotspur,Newcastle United,5-2,5,2,1,1,7,3,H
1928-01-21,1927,Arsenal,Aston Villa,0-3,0,3,1,1,3,-3,A
1928-01-21,1927,Birmingham City,Everton,2-2,2,2,1,1,4,0,D
1928-01-21,1927,Bolton Wanderers,Bury,2-1,2,1,1,1,3,1,H
1928-01-21,1927,Burnley,Sheffield United,5-3,5,3,1,1,8,2,H
1928-01-21,1927,Huddersfield Town,Tottenham Hotspur,4-2,4,2,1,1,6,2,H
1928-01-21,1927,Leicester City,Derby County,4-0,4,0,1,1,4,4,H
1928-01-21,1927,Liverpool,Sunderland,2-5,2,5,1,1,7,-3,A
1928-01-21,1927,Middlesbrough,Cardiff City,1-2,1,2,1,1,3,-1,A
1928-01-21,1927,Newcastle United,Manchester United,4-1,4,1,1,1,5,3,H
1928-01-21,1927,Portsmouth,West Ham United,2-1,2,1,1,1,3,1,H
1928-01-21,1927,Sheffield Wednesday,Blackburn Rovers,4-1,4,1,1,1,5,3,H
1928-02-04,1927,Arsenal,Derby County,3-4,3,4,1,1,7,-1,A
1928-02-04,1927,Birmingham City,Blackburn Rovers,2-1,2,1,1,1,3,1,H
1928-02-04,1927,Burnley,Sunderland,3-0,3,0,1,1,3,3,H
1928-02-04,1927,Bury,Aston Villa,0-0,0,0,1,1,0,0,D
1928-02-04,1927,Huddersfield Town,Everton,4-1,4,1,1,1,5,3,H
1928-02-04,1927,Leicester City,Portsmouth,6-2,6,2,1,1,8,4,H
1928-02-04,1927,Liverpool,West Ham United,1-3,1,3,1,1,4,-2,A
1928-02-04,1927,Middlesbrough,Bolton Wanderers,2-5,2,5,1,1,7,-3,A
1928-02-04,1927,Newcastle United,Cardiff City,2-0,2,0,1,1,2,2,H
1928-02-04,1927,Sheffield Wednesday,Sheffield United,3-3,3,3,1,1,6,0,D
1928-02-04,1927,Tottenham Hotspur,Manchester United,4-1,4,1,1,1,5,3,H
1928-02-06,1927,Tottenham Hotspur,Bolton Wanderers,1-2,1,2,1,1,3,-1,A
1928-02-08,1927,Aston Villa,Burnley,3-1,3,1,1,1,4,2,H
1928-02-11,1927,Aston Villa,Sheffield United,1-0,1,0,1,1,1,1,H
1928-02-11,1927,Blackburn Rovers,Newcastle United,1-0,1,0,1,1,1,1,H
1928-02-11,1927,Bolton Wanderers,Birmingham City,3-2,3,2,1,1,5,1,H
1928-02-11,1927,Cardiff City,Huddersfield Town,4-0,4,0,1,1,4,4,H
1928-02-11,1927,Derby County,Burnley,3-4,3,4,1,1,7,-1,A
1928-02-11,1927,Everton,Tottenham Hotspur,2-5,2,5,1,1,7,-3,A
1928-02-11,1927,Manchester United,Leicester City,5-2,5,2,1,1,7,3,H
1928-02-11,1927,Portsmouth,Liverpool,1-0,1,0,1,1,1,1,H
1928-02-11,1927,Sheffield Wednesday,Middlesbrough,2-3,2,3,1,1,5,-1,A
1928-02-11,1927,Sunderland,Bury,1-0,1,0,1,1,1,1,H
1928-02-11,1927,West Ham United,Arsenal,2-2,2,2,1,1,4,0,D
1928-02-15,1927,Derby County,Liverpool,2-3,2,3,1,1,5,-1,A
1928-02-18,1927,Burnley,West Ham United,0-0,0,0,1,1,0,0,D
1928-02-18,1927,Bury,Derby County,3-0,3,0,1,1,3,3,H
1928-02-18,1927,Newcastle United,Bolton Wanderers,2-2,2,2,1,1,4,0,D
1928-02-18,1927,Portsmouth,Sunderland,3-5,3,5,1,1,8,-2,A
1928-02-22,1927,Cardiff City,Birmingham City,2-1,2,1,1,1,3,1,H
1928-02-23,1927,Blackburn Rovers,Middlesbrough,3-0,3,0,1,1,3,3,H
1928-02-25,1927,Blackburn Rovers,Tottenham Hotspur,2-1,2,1,1,1,3,1,H
1928-02-25,1927,Bolton Wanderers,Huddersfield Town,0-1,0,1,1,1,1,-1,A
1928-02-25,1927,Cardiff City,Manchester United,2-0,2,0,1,1,2,2,H
1928-02-25,1927,Derby County,Sheffield United,2-1,2,1,1,1,3,1,H
1928-02-25,1927,Leicester City,Arsenal,3-2,3,2,1,1,5,1,H
1928-02-25,1927,Liverpool,Everton,3-3,3,3,1,1,6,0,D
1928-02-25,1927,Middlesbrough,Birmingham City,1-1,1,1,1,1,2,0,D
1928-02-25,1927,Portsmouth,Burnley,1-0,1,0,1,1,1,1,H
1928-02-25,1927,Sheffield Wednesday,Newcastle United,0-0,0,0,1,1,0,0,D
1928-02-25,1927,Sunderland,Aston Villa,2-3,2,3,1,1,5,-1,A
1928-02-25,1927,West Ham United,Bury,1-2,1,2,1,1,3,-1,A
1928-02-29,1927,Bolton Wanderers,Sheffield Wednesday,2-0,2,0,1,1,2,2,H
1928-03-03,1927,Burnley,Middlesbrough,1-1,1,1,1,1,2,0,D
1928-03-03,1927,Bury,Birmingham City,2-3,2,3,1,1,5,-1,A
1928-03-03,1927,Liverpool,Bolton Wanderers,4-2,4,2,1,1,6,2,H
1928-03-03,1927,Portsmouth,Cardiff City,3-0,3,0,1,1,3,3,H
1928-03-03,1927,West Ham United,Everton,0-0,0,0,1,1,0,0,D
1928-03-05,1927,Tottenham Hotspur,Cardiff City,1-0,1,0,1,1,1,1,H
1928-03-07,1927,Arsenal,Liverpool,6-3,6,3,1,1,9,3,H
1928-03-07,1927,Birmingham City,Sheffield Wednesday,1-0,1,0,1,1,1,1,H
1928-03-07,1927,Manchester United,Huddersfield Town,0-0,0,0,1,1,0,0,D
1928-03-10,1927,Birmingham City,Sheffield United,4-1,4,1,1,1,5,3,H
1928-03-10,1927,Blackburn Rovers,Liverpool,2-1,2,1,1,1,3,1,H
1928-03-10,1927,Bolton Wanderers,Arsenal,1-1,1,1,1,1,2,0,D
1928-03-10,1927,Cardiff City,Leicester City,3-0,3,0,1,1,3,3,H
1928-03-10,1927,Everton,Portsmouth,0-0,0,0,1,1,0,0,D
1928-03-10,1927,Huddersfield Town,Sunderland,4-2,4,2,1,1,6,2,H
1928-03-10,1927,Manchester United,West Ham United,1-1,1,1,1,1,2,0,D
1928-03-10,1927,Middlesbrough,Bury,6-1,6,1,1,1,7,5,H
1928-03-10,1927,Newcastle United,Aston Villa,7-5,7,5,1,1,12,2,H
1928-03-10,1927,Sheffield Wednesday,Burnley,5-0,5,0,1,1,5,5,H
1928-03-10,1927,Tottenham Hotspur,Derby County,1-2,1,2,1,1,3,-1,A
1928-03-12,1927,Sheffield United,Bury,3-1,3,1,1,1,4,2,H
1928-03-12,1927,West Ham United,Leicester City,4-0,4,0,1,1,4,4,H
1928-03-14,1927,Huddersfield Town,Blackburn Rovers,3-1,3,1,1,1,4,2,H
1928-03-14,1927,Manchester United,Everton,1-0,1,0,1,1,1,1,H
1928-03-14,1927,Sunderland,Arsenal,5-1,5,1,1,1,6,4,H
1928-03-17,1927,Arsenal,Blackburn Rovers,3-2,3,2,1,1,5,1,H
1928-03-17,1927,Aston Villa,Birmingham City,1-1,1,1,1,1,2,0,D
1928-03-17,1927,Burnley,Bolton Wanderers,2-2,2,2,1,1,4,0,D
1928-03-17,1927,Bury,Sheffield Wednesday,4-2,4,2,1,1,6,2,H
1928-03-17,1927,Derby County,Huddersfield Town,0-0,0,0,1,1,0,0,D
1928-03-17,1927,Leicester City,Everton,1-0,1,0,1,1,1,1,H
1928-03-17,1927,Liverpool,Cardiff City,1-2,1,2,1,1,3,-1,A
1928-03-17,1927,Portsmouth,Manchester United,1-0,1,0,1,1,1,1,H
1928-03-17,1927,Sheffield United,Middlesbrough,4-1,4,1,1,1,5,3,H
1928-03-17,1927,Sunderland,Newcastle United,1-1,1,1,1,1,2,0,D
1928-03-17,1927,West Ham United,Tottenham Hotspur,1-1,1,1,1,1,2,0,D
1928-03-19,1927,Tottenham Hotspur,Portsmouth,0-3,0,3,1,1,3,-3,A
1928-03-21,1927,Middlesbrough,Aston Villa,0-0,0,0,1,1,0,0,D
1928-03-24,1927,Birmingham City,Burnley,4-0,4,0,1,1,4,4,H
1928-03-24,1927,Bolton Wanderers,Leicester City,3-3,3,3,1,1,6,0,D
1928-03-24,1927,Cardiff City,West Ham United,1-5,1,5,1,1,6,-4,A
1928-03-24,1927,Everton,Derby County,2-2,2,2,1,1,4,0,D
1928-03-24,1927,Newcastle United,Bury,2-3,2,3,1,1,5,-1,A
1928-03-24,1927,Sheffield Wednesday,Liverpool,4-0,4,0,1,1,4,4,H
1928-03-24,1927,Tottenham Hotspur,Aston Villa,2-1,2,1,1,1,3,1,H
1928-03-28,1927,Arsenal,Portsmouth,0-2,0,2,1,1,2,-2,A
1928-03-28,1927,Derby County,Manchester United,5-0,5,0,1,1,5,5,H
1928-03-28,1927,Sunderland,Tottenham Hotspur,0-0,0,0,1,1,0,0,D
1928-03-31,1927,Arsenal,Birmingham City,2-2,2,2,1,1,4,0,D
1928-03-31,1927,Aston Villa,Manchester United,3-1,3,1,1,1,4,2,H
1928-03-31,1927,Burnley,Newcastle United,5-1,5,1,1,1,6,4,H
1928-03-31,1927,Bury,Huddersfield Town,2-3,2,3,1,1,5,-1,A
1928-03-31,1927,Derby County,Cardiff City,7-1,7,1,1,1,8,6,H
1928-03-31,1927,Leicester City,Sheffield Wednesday,2-2,2,2,1,1,4,0,D
1928-03-31,1927,Liverpool,Middlesbrough,1-1,1,1,1,1,2,0,D
1928-03-31,1927,Portsmouth,Bolton Wanderers,1-0,1,0,1,1,1,1,H
1928-03-31,1927,Sheffield United,Tottenham Hotspur,3-1,3,1,1,1,4,2,H
1928-03-31,1927,Sunderland,Everton,0-2,0,2,1,1,2,-2,A
1928-03-31,1927,West Ham United,Blackburn Rovers,4-3,4,3,1,1,7,1,H
1928-04-06,1927,Arsenal,Cardiff City,3-0,3,0,1,1,3,3,H
1928-04-06,1927,Bolton Wanderers,Manchester United,3-2,3,2,1,1,5,1,H
1928-04-06,1927,Burnley,Liverpool,2-2,2,2,1,1,4,0,D
1928-04-06,1927,Everton,Blackburn Rovers,4-1,4,1,1,1,5,3,H
1928-04-06,1927,Sunderland,Derby County,0-1,0,1,1,1,1,-1,A
1928-04-06,1927,Tottenham Hotspur,Sheffield Wednesday,1-3,1,3,1,1,4,-2,A
1928-04-06,1927,West Ham United,Aston Villa,0-0,0,0,1,1,0,0,D
1928-04-07,1927,Birmingham City,Portsmouth,2-0,2,0,1,1,2,2,H
1928-04-07,1927,Blackburn Rovers,Aston Villa,0-1,0,1,1,1,1,-1,A
1928-04-07,1927,Bolton Wanderers,Sunderland,1-2,1,2,1,1,3,-1,A
1928-04-07,1927,Cardiff City,Sheffield United,2-2,2,2,1,1,4,0,D
1928-04-07,1927,Everton,Bury,1-1,1,1,1,1,2,0,D
1928-04-07,1927,Huddersfield Town,Liverpool,2-4,2,4,1,1,6,-2,A
1928-04-07,1927,Manchester United,Burnley,4-3,4,3,1,1,7,1,H
1928-04-07,1927,Middlesbrough,West Ham United,2-2,2,2,1,1,4,0,D
1928-04-07,1927,Newcastle United,Leicester City,1-5,1,5,1,1,6,-4,A
1928-04-07,1927,Sheffield Wednesday,Derby County,2-2,2,2,1,1,4,0,D
1928-04-07,1927,Tottenham Hotspur,Arsenal,2-0,2,0,1,1,2,2,H
1928-04-09,1927,Aston Villa,West Ham United,1-0,1,0,1,1,1,1,H
1928-04-09,1927,Cardiff City,Arsenal,2-2,2,2,1,1,4,0,D
1928-04-09,1927,Derby County,Sunderland,1-0,1,0,1,1,1,1,H
1928-04-09,1927,Huddersfield Town,Birmingham City,2-0,2,0,1,1,2,2,H
1928-04-09,1927,Leicester City,Bury,2-2,2,2,1,1,4,0,D
1928-04-09,1927,Manchester United,Bolton Wanderers,2-1,2,1,1,1,3,1,H
1928-04-09,1927,Portsmouth,Sheffield United,4-1,4,1,1,1,5,3,H
1928-04-10,1927,Birmingham City,Newcastle United,0-2,0,2,1,1,2,-2,A
1928-04-10,1927,Huddersfield Town,Middlesbrough,2-4,2,4,1,1,6,-2,A
1928-04-10,1927,Sheffield Wednesday,Tottenham Hotspur,4-2,4,2,1,1,6,2,H
1928-04-14,1927,Arsenal,Huddersfield Town,0-0,0,0,1,1,0,0,D
1928-04-14,1927,Aston Villa,Cardiff City,3-1,3,1,1,1,4,2,H
1928-04-14,1927,Burnley,Tottenham Hotspur,2-2,2,2,1,1,4,0,D
1928-04-14,1927,Bury,Manchester United,4-3,4,3,1,1,7,1,H
1928-04-14,1927,Derby County,Bolton Wanderers,1-0,1,0,1,1,1,1,H
1928-04-14,1927,Leicester City,Birmingham City,3-0,3,0,1,1,3,3,H
1928-04-14,1927,Liverpool,Newcastle United,0-0,0,0,1,1,0,0,D
1928-04-14,1927,Portsmouth,Middlesbrough,4-1,4,1,1,1,5,3,H
1928-04-14,1927,Sheffield United,Everton,1-3,1,3,1,1,4,-2,A
1928-04-14,1927,Sunderland,Blackburn Rovers,1-0,1,0,1,1,1,1,H
1928-04-14,1927,West Ham United,Sheffield Wednesday,1-2,1,2,1,1,3,-1,A
1928-04-16,1927,Sheffield United,Sunderland,5-1,5,1,1,1,6,4,H
1928-04-18,1927,Everton,Newcastle United,3-0,3,0,1,1,3,3,H
1928-04-18,1927,Middlesbrough,Arsenal,2-2,2,2,1,1,4,0,D
1928-04-21,1927,Birmingham City,Liverpool,2-0,2,0,1,1,2,2,H
1928-04-21,1927,Bolton Wanderers,West Ham United,4-0,4,0,1,1,4,4,H
1928-04-21,1927,Cardiff City,Sunderland,3-1,3,1,1,1,4,2,H
1928-04-21,1927,Everton,Aston Villa,3-2,3,2,1,1,5,1,H
1928-04-21,1927,Manchester United,Sheffield United,2-3,2,3,1,1,5,-1,A
1928-04-21,1927,Middlesbrough,Leicester City,1-1,1,1,1,1,2,0,D
1928-04-21,1927,Newcastle United,Arsenal,1-1,1,1,1,1,2,0,D
1928-04-21,1927,Sheffield Wednesday,Portsmouth,2-0,2,0,1,1,2,2,H
1928-04-21,1927,Tottenham Hotspur,Bury,1-4,1,4,1,1,5,-3,A
1928-04-23,1927,Sheffield United,Newcastle United,1-1,1,1,1,1,2,0,D
1928-04-24,1927,Blackburn Rovers,Portsmouth,6-0,6,0,1,1,6,6,H
1928-04-25,1927,Huddersfield Town,Burnley,1-2,1,2,1,1,3,-1,A
1928-04-25,1927,Liverpool,Leicester City,1-1,1,1,1,1,2,0,D
1928-04-25,1927,Manchester United,Sunderland,2-1,2,1,1,1,3,1,H
1928-04-26,1927,Blackburn Rovers,Derby County,3-2,3,2,1,1,5,1,H
1928-04-28,1927,Arsenal,Manchester United,0-1,0,1,1,1,1,-1,A
1928-04-28,1927,Aston Villa,Bolton Wanderers,2-2,2,2,1,1,4,0,D
1928-04-28,1927,Burnley,Everton,3-5,3,5,1,1,8,-2,A
1928-04-28,1927,Bury,Cardiff City,3-0,3,0,1,1,3,3,H
1928-04-28,1927,Derby County,Middlesbrough,2-1,2,1,1,1,3,1,H
1928-04-28,1927,Leicester City,Huddersfield Town,1-2,1,2,1,1,3,-1,A
1928-04-28,1927,Liverpool,Tottenham Hotspur,2-0,2,0,1,1,2,2,H
1928-04-28,1927,Portsmouth,Newcastle United,0-1,0,1,1,1,1,-1,A
1928-04-28,1927,Sheffield United,Blackburn Rovers,2-3,2,3,1,1,5,-1,A
1928-04-28,1927,Sunderland,Sheffield Wednesday,2-3,2,3,1,1,5,-1,A
1928-04-28,1927,West Ham United,Birmingham City,3-3,3,3,1,1,6,0,D
1928-04-30,1927,Huddersfield Town,Sheffield United,0-1,0,1,1,1,1,-1,A
1928-04-30,1927,Leicester City,Blackburn Rovers,6-0,6,0,1,1,6,6,H
1928-05-02,1927,Arsenal,Sheffield Wednesday,1-1,1,1,1,1,2,0,D
1928-05-02,1927,Aston Villa,Huddersfield Town,3-0,3,0,1,1,3,3,H
1928-05-05,1927,Birmingham City,Derby County,2-1,2,1,1,1,3,1,H
1928-05-05,1927,Blackburn Rovers,Bury,0-1,0,1,1,1,1,-1,A
1928-05-05,1927,Bolton Wanderers,Sheffield United,1-1,1,1,1,1,2,0,D
1928-05-05,1927,Cardiff City,Burnley,3-2,3,2,1,1,5,1,H
1928-05-05,1927,Everton,Arsenal,3-3,3,3,1,1,6,0,D
1928-05-05,1927,Huddersfield Town,Portsmouth,4-1,4,1,1,1,5,3,H
1928-05-05,1927,Manchester United,Liverpool,6-1,6,1,1,1,7,5,H
1928-05-05,1927,Middlesbrough,Sunderland,0-3,0,3,1,1,3,-3,A
1928-05-05,1927,Newcastle United,West Ham United,3-1,3,1,1,1,4,2,H
1928-05-05,1927,Sheffield Wednesday,Aston Villa,2-0,2,0,1,1,2,2,H
1928-08-25,1928,Birmingham City,Manchester City,4-1,4,1,1,1,5,3,H
1928-08-25,1928,Bolton Wanderers,Everton,2-3,2,3,1,1,5,-1,A
1928-08-25,1928,Burnley,Sunderland,3-1,3,1,1,1,4,2,H
1928-08-25,1928,Derby County,Blackburn Rovers,5-1,5,1,1,1,6,4,H
1928-08-25,1928,Leeds United,Aston Villa,4-1,4,1,1,1,5,3,H
1928-08-25,1928,Liverpool,Bury,3-0,3,0,1,1,3,3,H
1928-08-25,1928,Manchester United,Leicester City,1-1,1,1,1,1,2,0,D
1928-08-25,1928,Newcastle United,Cardiff City,1-1,1,1,1,1,2,0,D
1928-08-25,1928,Portsmouth,Huddersfield Town,1-0,1,0,1,1,1,1,H
1928-08-25,1928,Sheffield Wednesday,Arsenal,3-2,3,2,1,1,5,1,H
1928-08-25,1928,West Ham United,Sheffield United,4-0,4,0,1,1,4,4,H
1928-08-27,1928,Aston Villa,Manchester United,0-0,0,0,1,1,0,0,D
1928-08-27,1928,Huddersfield Town,Bolton Wanderers,4-1,4,1,1,1,5,3,H
1928-08-27,1928,Leeds United,Bury,3-1,3,1,1,1,4,2,H
1928-08-27,1928,Leicester City,Birmingham City,5-3,5,3,1,1,8,2,H
1928-08-29,1928,Arsenal,Derby County,1-3,1,3,1,1,4,-2,A
1928-08-29,1928,Everton,Sheffield Wednesday,0-0,0,0,1,1,0,0,D
1928-08-29,1928,Newcastle United,Burnley,2-7,2,7,1,1,9,-5,A
1928-08-29,1928,Sunderland,Blackburn Rovers,3-1,3,1,1,1,4,2,H
1928-09-01,1928,Arsenal,Bolton Wanderers,2-0,2,0,1,1,2,2,H
1928-09-01,1928,Aston Villa,Liverpool,3-1,3,1,1,1,4,2,H
1928-09-01,1928,Blackburn Rovers,Sheffield Wednesday,4-1,4,1,1,1,5,3,H
1928-09-01,1928,Bury,West Ham United,0-3,0,3,1,1,3,-3,A
1928-09-01,1928,Cardiff City,Burnley,7-0,7,0,1,1,7,7,H
1928-09-01,1928,Everton,Portsmouth,4-0,4,0,1,1,4,4,H
1928-09-01,1928,Huddersfield Town,Birmingham City,0-0,0,0,1,1,0,0,D
1928-09-01,1928,Leicester City,Leeds United,4-4,4,4,1,1,8,0,D
1928-09-01,1928,Manchester City,Manchester United,2-2,2,2,1,1,4,0,D
1928-09-01,1928,Sheffield United,Newcastle United,3-1,3,1,1,1,4,2,H
1928-09-01,1928,Sunderland,Derby County,4-0,4,0,1,1,4,4,H
1928-09-03,1928,Bolton Wanderers,Huddersfield Town,1-1,1,1,1,1,2,0,D
1928-09-03,1928,Burnley,West Ham United,3-3,3,3,1,1,6,0,D
1928-09-03,1928,Sheffield Wednesday,Everton,1-0,1,0,1,1,1,1,H
1928-09-05,1928,Liverpool,Sheffield United,1-2,1,2,1,1,3,-1,A
1928-09-05,1928,Portsmouth,Manchester City,1-0,1,0,1,1,1,1,H
1928-09-08,1928,Birmingham City,Everton,1-3,1,3,1,1,4,-2,A
1928-09-08,1928,Bolton Wanderers,Blackburn Rovers,0-3,0,3,1,1,3,-3,A
1928-09-08,1928,Burnley,Sheffield United,2-1,2,1,1,1,3,1,H
1928-09-08,1928,Derby County,Cardiff City,2-0,2,0,1,1,2,2,H
1928-09-08,1928,Leeds United,Manchester United,3-2,3,2,1,1,5,1,H
1928-09-08,1928,Liverpool,Leicester City,6-3,6,3,1,1,9,3,H
1928-09-08,1928,Manchester City,Huddersfield Town,3-2,3,2,1,1,5,1,H
1928-09-08,1928,Newcastle United,Bury,2-1,2,1,1,1,3,1,H
1928-09-08,1928,Portsmouth,Arsenal,2-0,2,0,1,1,2,2,H
1928-09-08,1928,Sheffield Wednesday,Sunderland,2-1,2,1,1,1,3,1,H
1928-09-08,1928,West Ham United,Aston Villa,4-1,4,1,1,1,5,3,H
1928-09-10,1928,Birmingham City,Leicester City,1-0,1,0,1,1,1,1,H
1928-09-10,1928,Burnley,Newcastle United,4-3,4,3,1,1,7,1,H
1928-09-10,1928,Cardiff City,West Ham United,3-2,3,2,1,1,5,1,H
1928-09-10,1928,Sheffield United,Liverpool,1-3,1,3,1,1,4,-2,A
1928-09-15,1928,Arsenal,Birmingham City,0-0,0,0,1,1,0,0,D
1928-09-15,1928,Aston Villa,Newcastle United,1-1,1,1,1,1,2,0,D
1928-09-15,1928,Blackburn Rovers,Portsmouth,4-0,4,0,1,1,4,4,H
1928-09-15,1928,Bury,Burnley,2-1,2,1,1,1,3,1,H
1928-09-15,1928,Derby County,Sheffield Wednesday,6-0,6,0,1,1,6,6,H
1928-09-15,1928,Everton,Manchester City,2-6,2,6,1,1,8,-4,A
1928-09-15,1928,Huddersfield Town,Leeds United,6-1,6,1,1,1,7,5,H
1928-09-15,1928,Leicester City,West Ham United,5-0,5,0,1,1,5,5,H
1928-09-15,1928,Manchester United,Liverpool,2-2,2,2,1,1,4,0,D
1928-09-15,1928,Sheffield United,Cardiff City,3-1,3,1,1,1,4,2,H
1928-09-15,1928,Sunderland,Bolton Wanderers,4-0,4,0,1,1,4,4,H
1928-09-17,1928,Blackburn Rovers,Sunderland,2-0,2,0,1,1,2,2,H
1928-09-17,1928,West Ham United,Cardiff City,1-1,1,1,1,1,2,0,D
1928-09-22,1928,Birmingham City,Blackburn Rovers,4-0,4,0,1,1,4,4,H
1928-09-22,1928,Bolton Wanderers,Derby County,3-0,3,0,1,1,3,3,H
1928-09-22,1928,Burnley,Aston Villa,4-1,4,1,1,1,5,3,H
1928-09-22,1928,Cardiff City,Bury,4-0,4,0,1,1,4,4,H
1928-09-22,1928,Huddersfield Town,Everton,3-1,3,1,1,1,4,2,H
1928-09-22,1928,Liverpool,Leeds United,1-1,1,1,1,1,2,0,D
1928-09-22,1928,Manchester City,Arsenal,4-1,4,1,1,1,5,3,H
1928-09-22,1928,Newcastle United,Leicester City,1-0,1,0,1,1,1,1,H
1928-09-22,1928,Portsmouth,Sunderland,4-0,4,0,1,1,4,4,H
1928-09-22,1928,Sheffield Wednesday,Sheffield United,5-2,5,2,1,1,7,3,H
1928-09-22,1928,West Ham United,Manchester United,3-1,3,1,1,1,4,2,H
1928-09-24,1928,Blackburn Rovers,Newcastle United,2-0,2,0,1,1,2,2,H
1928-09-26,1928,Derby County,Arsenal,0-0,0,0,1,1,0,0,D
1928-09-29,1928,Arsenal,Huddersfield Town,2-0,2,0,1,1,2,2,H
1928-09-29,1928,Aston Villa,Cardiff City,1-0,1,0,1,1,1,1,H
1928-09-29,1928,Blackburn Rovers,Manchester City,2-2,2,2,1,1,4,0,D
1928-09-29,1928,Bury,Sheffield United,4-0,4,0,1,1,4,4,H
1928-09-29,1928,Derby County,Portsmouth,1-0,1,0,1,1,1,1,H
1928-09-29,1928,Everton,Liverpool,1-0,1,0,1,1,1,1,H
1928-09-29,1928,Leeds United,West Ham United,4-1,4,1,1,1,5,3,H
1928-09-29,1928,Leicester City,Burnley,1-1,1,1,1,1,2,0,D
1928-09-29,1928,Manchester United,Newcastle United,5-0,5,0,1,1,5,5,H
1928-09-29,1928,Sheffield Wednesday,Bolton Wanderers,0-0,0,0,1,1,0,0,D
1928-09-29,1928,Sunderland,Birmingham City,3-4,3,4,1,1,7,-1,A
1928-10-01,1928,Manchester City,Portsmouth,2-1,2,1,1,1,3,1,H
1928-10-06,1928,Birmingham City,Derby County,1-4,1,4,1,1,5,-3,A
1928-10-06,1928,Bolton Wanderers,Bury,0-1,0,1,1,1,1,-1,A
1928-10-06,1928,Burnley,Manchester United,3-4,3,4,1,1,7,-1,A
1928-10-06,1928,Cardiff City,Leicester City,1-2,1,2,1,1,3,-1,A
1928-10-06,1928,Everton,Arsenal,4-2,4,2,1,1,6,2,H
1928-10-06,1928,Huddersfield Town,Blackburn Rovers,0-2,0,2,1,1,2,-2,A
1928-10-06,1928,Manchester City,Sunderland,5-3,5,3,1,1,8,2,H
1928-10-06,1928,Newcastle United,Leeds United,3-2,3,2,1,1,5,1,H
1928-10-06,1928,Portsmouth,Sheffield Wednesday,3-2,3,2,1,1,5,1,H
1928-10-06,1928,Sheffield United,Aston Villa,1-3,1,3,1,1,4,-2,A
1928-10-06,1928,West Ham United,Liverpool,1-1,1,1,1,1,2,0,D
1928-10-13,1928,Arsenal,West Ham United,2-3,2,3,1,1,5,-1,A
1928-10-13,1928,Aston Villa,Bury,7-1,7,1,1,1,8,6,H
1928-10-13,1928,Blackburn Rovers,Everton,2-1,2,1,1,1,3,1,H
1928-10-13,1928,Bolton Wanderers,Portsmouth,4-2,4,2,1,1,6,2,H
1928-10-13,1928,Derby County,Manchester City,1-1,1,1,1,1,2,0,D
1928-10-13,1928,Leeds United,Burnley,2-1,2,1,1,1,3,1,H
1928-10-13,1928,Leicester City,Sheffield United,3-1,3,1,1,1,4,2,H
1928-10-13,1928,Liverpool,Newcastle United,2-1,2,1,1,1,3,1,H
1928-10-13,1928,Manchester United,Cardiff City,1-1,1,1,1,1,2,0,D
1928-10-13,1928,Sheffield Wednesday,Birmingham City,3-0,3,0,1,1,3,3,H
1928-10-13,1928,Sunderland,Huddersfield Town,4-1,4,1,1,1,5,3,H
1928-10-20,1928,Aston Villa,Bolton Wanderers,3-5,3,5,1,1,8,-2,A
1928-10-20,1928,Burnley,Blackburn Rovers,2-2,2,2,1,1,4,0,D
1928-10-20,1928,Bury,Sheffield Wednesday,0-4,0,4,1,1,4,-4,A
1928-10-20,1928,Cardiff City,Sunderland,0-1,0,1,1,1,1,-1,A
1928-10-20,1928,Leeds United,Manchester City,4-1,4,1,1,1,5,3,H
1928-10-20,1928,Leicester City,Portsmouth,10-0,10,0,1,1,10,10,H
1928-10-20,1928,Liverpool,Huddersfield Town,2-3,2,3,1,1,5,-1,A
1928-10-20,1928,Manchester United,Birmingham City,1-0,1,0,1,1,1,1,H
1928-10-20,1928,Newcastle United,Arsenal,0-3,0,3,1,1,3,-3,A
1928-10-20,1928,Sheffield United,Derby County,2-1,2,1,1,1,3,1,H
1928-10-20,1928,West Ham United,Everton,2-4,2,4,1,1,6,-2,A
1928-10-27,1928,Arsenal,Liverpool,4-4,4,4,1,1,8,0,D
1928-10-27,1928,Birmingham City,Aston Villa,2-4,2,4,1,1,6,-2,A
1928-10-27,1928,Blackburn Rovers,West Ham United,2-0,2,0,1,1,2,2,H
1928-10-27,1928,Bolton Wanderers,Sheffield United,3-1,3,1,1,1,4,2,H
1928-10-27,1928,Derby County,Burnley,4-0,4,0,1,1,4,4,H
1928-10-27,1928,Everton,Leeds United,0-1,0,1,1,1,1,-1,A
1928-10-27,1928,Huddersfield Town,Manchester United,1-2,1,2,1,1,3,-1,A
1928-10-27,1928,Manchester City,Leicester City,2-3,2,3,1,1,5,-1,A
1928-10-27,1928,Portsmouth,Bury,4-1,4,1,1,1,5,3,H
1928-10-27,1928,Sheffield Wednesday,Cardiff City,1-0,1,0,1,1,1,1,H
1928-10-27,1928,Sunderland,Newcastle United,5-2,5,2,1,1,7,3,H
1928-11-03,1928,Aston Villa,Derby County,2-3,2,3,1,1,5,-1,A
1928-11-03,1928,Burnley,Everton,2-0,2,0,1,1,2,2,H
1928-11-03,1928,Bury,Sunderland,1-3,1,3,1,1,4,-2,A
1928-11-03,1928,Cardiff City,Arsenal,1-1,1,1,1,1,2,0,D
1928-11-03,1928,Leeds United,Portsmouth,3-2,3,2,1,1,5,1,H
1928-11-03,1928,Leicester City,Sheffield Wednesday,1-1,1,1,1,1,2,0,D
1928-11-03,1928,Liverpool,Birmingham City,1-2,1,2,1,1,3,-1,A
1928-11-03,1928,Manchester United,Bolton Wanderers,1-1,1,1,1,1,2,0,D
1928-11-03,1928,Newcastle United,Huddersfield Town,4-1,4,1,1,1,5,3,H
1928-11-03,1928,Sheffield United,Blackburn Rovers,2-1,2,1,1,1,3,1,H
1928-11-03,1928,West Ham United,Manchester City,3-0,3,0,1,1,3,3,H
1928-11-10,1928,Arsenal,Sheffield United,2-0,2,0,1,1,2,2,H
1928-11-10,1928,Birmingham City,West Ham United,2-2,2,2,1,1,4,0,D
1928-11-10,1928,Blackburn Rovers,Bury,1-1,1,1,1,1,2,0,D
1928-11-10,1928,Bolton Wanderers,Leeds United,4-1,4,1,1,1,5,3,H
1928-11-10,1928,Derby County,Leicester City,5-2,5,2,1,1,7,3,H
1928-11-10,1928,Everton,Cardiff City,1-0,1,0,1,1,1,1,H
1928-11-10,1928,Huddersfield Town,Burnley,7-1,7,1,1,1,8,6,H
1928-11-10,1928,Manchester City,Newcastle United,2-4,2,4,1,1,6,-2,A
1928-11-10,1928,Portsmouth,Liverpool,0-1,0,1,1,1,1,-1,A
1928-11-10,1928,Sheffield Wednesday,Manchester United,2-1,2,1,1,1,3,1,H
1928-11-10,1928,Sunderland,Aston Villa,1-3,1,3,1,1,4,-2,A
1928-11-17,1928,Aston Villa,Blackburn Rovers,2-1,2,1,1,1,3,1,H
1928-11-17,1928,Burnley,Manchester City,2-3,2,3,1,1,5,-1,A
1928-11-17,1928,Bury,Arsenal,1-0,1,0,1,1,1,1,H
1928-11-17,1928,Cardiff City,Huddersfield Town,0-0,0,0,1,1,0,0,D
1928-11-17,1928,Leeds United,Sheffield Wednesday,0-2,0,2,1,1,2,-2,A
1928-11-17,1928,Leicester City,Sunderland,1-0,1,0,1,1,1,1,H
1928-11-17,1928,Liverpool,Bolton Wanderers,3-0,3,0,1,1,3,3,H
1928-11-17,1928,Manchester United,Derby County,0-1,0,1,1,1,1,-1,A
1928-11-17,1928,Newcastle United,Birmingham City,1-0,1,0,1,1,1,1,H
1928-11-17,1928,Sheffield United,Everton,2-1,2,1,1,1,3,1,H
1928-11-17,1928,West Ham United,Portsmouth,0-1,0,1,1,1,1,-1,A
1928-11-24,1928,Arsenal,Aston Villa,2-5,2,5,1,1,7,-3,A
1928-11-24,1928,Birmingham City,Burnley,3-6,3,6,1,1,9,-3,A
1928-11-24,1928,Blackburn Rovers,Leicester City,1-1,1,1,1,1,2,0,D
1928-11-24,1928,Bolton Wanderers,West Ham United,4-1,4,1,1,1,5,3,H
1928-11-24,1928,Derby County,Leeds United,3-4,3,4,1,1,7,-1,A
1928-11-24,1928,Everton,Bury,1-0,1,0,1,1,1,1,H
1928-11-24,1928,Huddersfield Town,Sheffield United,6-1,6,1,1,1,7,5,H
1928-11-24,1928,Manchester City,Cardiff City,1-1,1,1,1,1,2,0,D
1928-11-24,1928,Portsmouth,Newcastle United,0-1,0,1,1,1,1,-1,A
1928-11-24,1928,Sheffield Wednesday,Liverpool,3-2,3,2,1,1,5,1,H
1928-11-24,1928,Sunderland,Manchester United,5-1,5,1,1,1,6,4,H
1928-12-01,1928,Aston Villa,Everton,2-0,2,0,1,1,2,2,H
1928-12-01,1928,Burnley,Portsmouth,4-1,4,1,1,1,5,3,H
1928-12-01,1928,Bury,Huddersfield Town,2-1,2,1,1,1,3,1,H
1928-12-01,1928,Cardiff City,Birmingham City,1-4,1,4,1,1,5,-3,A
1928-12-01,1928,Leeds United,Sunderland,0-3,0,3,1,1,3,-3,A
1928-12-01,1928,Leicester City,Arsenal,1-1,1,1,1,1,2,0,D
1928-12-01,1928,Liverpool,Derby County,3-0,3,0,1,1,3,3,H
1928-12-01,1928,Manchester United,Blackburn Rovers,1-4,1,4,1,1,5,-3,A
1928-12-01,1928,Newcastle United,Bolton Wanderers,4-1,4,1,1,1,5,3,H
1928-12-01,1928,Sheffield United,Manchester City,1-3,1,3,1,1,4,-2,A
1928-12-01,1928,West Ham United,Sheffield Wednesday,3-2,3,2,1,1,5,1,H
1928-12-08,1928,Arsenal,Manchester United,3-1,3,1,1,1,4,2,H
1928-12-08,1928,Birmingham City,Sheffield United,2-2,2,2,1,1,4,0,D
1928-12-08,1928,Blackburn Rovers,Leeds United,0-1,0,1,1,1,1,-1,A
1928-12-08,1928,Bolton Wanderers,Burnley,0-1,0,1,1,1,1,-1,A
1928-12-08,1928,Derby County,West Ham United,6-0,6,0,1,1,6,6,H
1928-12-08,1928,Everton,Leicester City,3-1,3,1,1,1,4,2,H
1928-12-08,1928,Huddersfield Town,Aston Villa,3-0,3,0,1,1,3,3,H
1928-12-08,1928,Portsmouth,Cardiff City,0-1,0,1,1,1,1,-1,A
1928-12-08,1928,Sheffield Wednesday,Newcastle United,3-1,3,1,1,1,4,2,H
1928-12-08,1928,Sunderland,Liverpool,2-1,2,1,1,1,3,1,H
1928-12-15,1928,Burnley,Sheffield Wednesday,0-2,0,2,1,1,2,-2,A
1928-12-15,1928,Cardiff City,Bolton Wanderers,1-1,1,1,1,1,2,0,D
1928-12-15,1928,Leeds United,Arsenal,1-1,1,1,1,1,2,0,D
1928-12-15,1928,Leicester City,Huddersfield Town,4-1,4,1,1,1,5,3,H
1928-12-15,1928,Liverpool,Blackburn Rovers,1-1,1,1,1,1,2,0,D
1928-12-15,1928,Manchester United,Everton,1-1,1,1,1,1,2,0,D
1928-12-15,1928,Newcastle United,Derby County,4-1,4,1,1,1,5,3,H
1928-12-15,1928,Sheffield United,Portsmouth,3-0,3,0,1,1,3,3,H
1928-12-15,1928,West Ham United,Sunderland,3-3,3,3,1,1,6,0,D
1928-12-19,1928,Aston Villa,Manchester City,5-1,5,1,1,1,6,4,H
1928-12-22,1928,Arsenal,Burnley,3-1,3,1,1,1,4,2,H
1928-12-22,1928,Birmingham City,Leeds United,5-1,5,1,1,1,6,4,H
1928-12-22,1928,Blackburn Rovers,Cardiff City,2-0,2,0,1,1,2,2,H
1928-12-22,1928,Bolton Wanderers,Leicester City,5-0,5,0,1,1,5,5,H
1928-12-22,1928,Derby County,Bury,3-1,3,1,1,1,4,2,H
1928-12-22,1928,Everton,Newcastle United,5-2,5,2,1,1,7,3,H
1928-12-22,1928,Huddersfield Town,West Ham United,4-0,4,0,1,1,4,4,H
1928-12-22,1928,Manchester City,Liverpool,2-3,2,3,1,1,5,-1,A
1928-12-22,1928,Portsmouth,Manchester United,3-0,3,0,1,1,3,3,H
1928-12-22,1928,Sheffield Wednesday,Aston Villa,4-1,4,1,1,1,5,3,H
1928-12-22,1928,Sunderland,Sheffield United,4-4,4,4,1,1,8,0,D
1928-12-25,1928,Birmingham City,Bolton Wanderers,0-2,0,2,1,1,2,-2,A
1928-12-25,1928,Blackburn Rovers,Arsenal,5-2,5,2,1,1,7,3,H
1928-12-25,1928,Burnley,Liverpool,3-2,3,2,1,1,5,1,H
1928-12-25,1928,Bury,Leicester City,3-1,3,1,1,1,4,2,H
1928-12-25,1928,Everton,Sunderland,0-0,0,0,1,1,0,0,D
1928-12-25,1928,Huddersfield Town,Derby County,0-0,0,0,1,1,0,0,D
1928-12-25,1928,Leeds United,Cardiff City,3-0,3,0,1,1,3,3,H
1928-12-25,1928,Manchester United,Sheffield United,1-1,1,1,1,1,2,0,D
1928-12-25,1928,Portsmouth,Aston Villa,3-2,3,2,1,1,5,1,H
1928-12-25,1928,Sheffield Wednesday,Manchester City,4-0,4,0,1,1,4,4,H
1928-12-25,1928,West Ham United,Newcastle United,1-0,1,0,1,1,1,1,H
1928-12-26,1928,Arsenal,Sunderland,1-1,1,1,1,1,2,0,D
1928-12-26,1928,Aston Villa,Portsmouth,3-2,3,2,1,1,5,1,H
1928-12-26,1928,Bolton Wanderers,Birmingham City,6-2,6,2,1,1,8,4,H
1928-12-26,1928,Cardiff City,Leeds United,2-1,2,1,1,1,3,1,H
1928-12-26,1928,Derby County,Huddersfield Town,1-2,1,2,1,1,3,-1,A
1928-12-26,1928,Leicester City,Bury,5-2,5,2,1,1,7,3,H
1928-12-26,1928,Liverpool,Burnley,8-0,8,0,1,1,8,8,H
1928-12-26,1928,Manchester City,Sheffield Wednesday,2-2,2,2,1,1,4,0,D
1928-12-26,1928,Newcastle United,West Ham United,1-0,1,0,1,1,1,1,H
1928-12-26,1928,Sheffield United,Manchester United,6-1,6,1,1,1,7,5,H
1928-12-29,1928,Arsenal,Sheffield Wednesday,2-2,2,2,1,1,4,0,D
1928-12-29,1928,Aston Villa,Leeds United,1-0,1,0,1,1,1,1,H
1928-12-29,1928,Blackburn Rovers,Derby County,3-1,3,1,1,1,4,2,H
1928-12-29,1928,Bury,Liverpool,2-2,2,2,1,1,4,0,D
1928-12-29,1928,Cardiff City,Newcastle United,2-0,2,0,1,1,2,2,H
1928-12-29,1928,Everton,Bolton Wanderers,3-0,3,0,1,1,3,3,H
1928-12-29,1928,Huddersfield Town,Portsmouth,3-1,3,1,1,1,4,2,H
1928-12-29,1928,Leicester City,Manchester United,2-1,2,1,1,1,3,1,H
1928-12-29,1928,Manchester City,Birmingham City,2-3,2,3,1,1,5,-1,A
1928-12-29,1928,Sheffield United,West Ham United,3-3,3,3,1,1,6,0,D
1928-12-29,1928,Sunderland,Burnley,2-1,2,1,1,1,3,1,H
1929-01-01,1928,Bolton Wanderers,Cardiff City,1-0,1,0,1,1,1,1,H
1929-01-01,1928,Bury,Leeds United,2-2,2,2,1,1,4,0,D
1929-01-01,1928,Everton,Derby County,4-0,4,0,1,1,4,4,H
1929-01-01,1928,Manchester United,Aston Villa,2-2,2,2,1,1,4,0,D
1929-01-01,1928,Newcastle United,Blackburn Rovers,0-2,0,2,1,1,2,-2,A
1929-01-01,1928,Sheffield Wednesday,Huddersfield Town,1-1,1,1,1,1,2,0,D
1929-01-01,1928,Sunderland,Arsenal,5-1,5,1,1,1,6,4,H
1929-01-05,1928,Birmingham City,Huddersfield Town,1-2,1,2,1,1,3,-1,A
1929-01-05,1928,Bolton Wanderers,Arsenal,1-2,1,2,1,1,3,-1,A
1929-01-05,1928,Burnley,Cardiff City,3-0,3,0,1,1,3,3,H
1929-01-05,1928,Derby County,Sunderland,0-0,0,0,1,1,0,0,D
1929-01-05,1928,Leeds United,Leicester City,4-3,4,3,1,1,7,1,H
1929-01-05,1928,Liverpool,Aston Villa,4-0,4,0,1,1,4,4,H
1929-01-05,1928,Manchester United,Manchester City,1-2,1,2,1,1,3,-1,A
1929-01-05,1928,Newcastle United,Sheffield United,4-2,4,2,1,1,6,2,H
1929-01-05,1928,Portsmouth,Everton,3-0,3,0,1,1,3,3,H
1929-01-05,1928,Sheffield Wednesday,Blackburn Rovers,1-0,1,0,1,1,1,1,H
1929-01-05,1928,West Ham United,Bury,2-3,2,3,1,1,5,-1,A
1929-01-19,1928,Arsenal,Portsmouth,4-0,4,0,1,1,4,4,H
1929-01-19,1928,Aston Villa,West Ham United,5-2,5,2,1,1,7,3,H
1929-01-19,1928,Blackburn Rovers,Bolton Wanderers,1-3,1,3,1,1,4,-2,A
1929-01-19,1928,Bury,Newcastle United,2-0,2,0,1,1,2,2,H
1929-01-19,1928,Cardiff City,Derby County,3-0,3,0,1,1,3,3,H
1929-01-19,1928,Everton,Birmingham City,0-2,0,2,1,1,2,-2,A
1929-01-19,1928,Huddersfield Town,Manchester City,2-2,2,2,1,1,4,0,D
1929-01-19,1928,Leicester City,Liverpool,2-0,2,0,1,1,2,2,H
1929-01-19,1928,Manchester United,Leeds United,1-2,1,2,1,1,3,-1,A
1929-01-19,1928,Sheffield United,Burnley,10-0,10,0,1,1,10,10,H
1929-01-19,1928,Sunderland,Sheffield Wednesday,4-3,4,3,1,1,7,1,H
1929-01-26,1928,Cardiff City,Sheffield United,0-0,0,0,1,1,0,0,D
1929-01-26,1928,Manchester City,Everton,5-1,5,1,1,1,6,4,H
1929-01-30,1928,Manchester City,Bury,6-4,6,4,1,1,10,2,H
1929-02-02,1928,Arsenal,Manchester City,0-0,0,0,1,1,0,0,D
1929-02-02,1928,Aston Villa,Burnley,4-2,4,2,1,1,6,2,H
1929-02-02,1928,Blackburn Rovers,Birmingham City,4-1,4,1,1,1,5,3,H
1929-02-02,1928,Bury,Cardiff City,4-1,4,1,1,1,5,3,H
1929-02-02,1928,Derby County,Bolton Wanderers,2-1,2,1,1,1,3,1,H
1929-02-02,1928,Everton,Huddersfield Town,0-3,0,3,1,1,3,-3,A
1929-02-02,1928,Leeds United,Liverpool,2-2,2,2,1,1,4,0,D
1929-02-02,1928,Leicester City,Newcastle United,1-1,1,1,1,1,2,0,D
1929-02-02,1928,Manchester United,West Ham United,2-3,2,3,1,1,5,-1,A
1929-02-02,1928,Sheffield United,Sheffield Wednesday,1-1,1,1,1,1,2,0,D
1929-02-02,1928,Sunderland,Portsmouth,5-0,5,0,1,1,5,5,H
1929-02-09,1928,Birmingham City,Sunderland,1-0,1,0,1,1,1,1,H
1929-02-09,1928,Bolton Wanderers,Sheffield Wednesday,2-2,2,2,1,1,4,0,D
1929-02-09,1928,Burnley,Leicester City,0-1,0,1,1,1,1,-1,A
1929-02-09,1928,Cardiff City,Aston Villa,0-2,0,2,1,1,2,-2,A
1929-02-09,1928,Huddersfield Town,Arsenal,0-1,0,1,1,1,1,-1,A
1929-02-09,1928,Liverpool,Everton,1-2,1,2,1,1,3,-1,A
1929-02-09,1928,Manchester City,Blackburn Rovers,1-2,1,2,1,1,3,-1,A
1929-02-09,1928,Newcastle United,Manchester United,5-0,5,0,1,1,5,5,H
1929-02-09,1928,Portsmouth,Derby County,1-5,1,5,1,1,6,-4,A
1929-02-09,1928,Sheffield United,Bury,6-1,6,1,1,1,7,5,H
1929-02-09,1928,West Ham United,Leeds United,8-2,8,2,1,1,10,6,H
1929-02-13,1928,Liverpool,Manchester United,2-3,2,3,1,1,5,-1,A
1929-02-16,1928,Derby County,Birmingham City,2-2,2,2,1,1,4,0,D
1929-02-16,1928,Leeds United,Newcastle United,0-0,0,0,1,1,0,0,D
1929-02-16,1928,Manchester United,Burnley,1-0,1,0,1,1,1,1,H
1929-02-16,1928,Sunderland,Manchester City,3-1,3,1,1,1,4,2,H
1929-02-18,1928,Burnley,Bury,0-0,0,0,1,1,0,0,D
1929-02-18,1928,Sheffield Wednesday,Derby County,5-0,5,0,1,1,5,5,H
1929-02-20,1928,Aston Villa,Sheffield United,3-2,3,2,1,1,5,1,H
1929-02-20,1928,Bolton Wanderers,Sunderland,2-2,2,2,1,1,4,0,D
1929-02-21,1928,Leicester City,Cardiff City,2-0,2,0,1,1,2,2,H
1929-02-23,1928,Birmingham City,Sheffield Wednesday,4-1,4,1,1,1,5,3,H
1929-02-23,1928,Burnley,Leeds United,5-0,5,0,1,1,5,5,H
1929-02-23,1928,Bury,Aston Villa,2-2,2,2,1,1,4,0,D
1929-02-23,1928,Cardiff City,Manchester United,2-2,2,2,1,1,4,0,D
1929-02-23,1928,Everton,Blackburn Rovers,5-2,5,2,1,1,7,3,H
1929-02-23,1928,Huddersfield Town,Sunderland,1-2,1,2,1,1,3,-1,A
1929-02-23,1928,Manchester City,Derby County,2-3,2,3,1,1,5,-1,A
1929-02-23,1928,Newcastle United,Liverpool,2-2,2,2,1,1,4,0,D
1929-02-23,1928,Portsmouth,Bolton Wanderers,4-4,4,4,1,1,8,0,D
1929-02-23,1928,Sheffield United,Leicester City,1-4,1,4,1,1,5,-3,A
1929-02-23,1928,West Ham United,Arsenal,3-4,3,4,1,1,7,-1,A
1929-03-02,1928,Birmingham City,Manchester United,1-1,1,1,1,1,2,0,D
1929-03-02,1928,Derby County,Sheffield United,2-2,2,2,1,1,4,0,D
1929-03-02,1928,Manchester City,Leeds United,3-0,3,0,1,1,3,3,H
1929-03-02,1928,Sheffield Wednesday,Bury,3-1,3,1,1,1,4,2,H
1929-03-02,1928,Sunderland,Cardiff City,1-0,1,0,1,1,1,1,H
1929-03-04,1928,Sheffield Wednesday,Portsmouth,2-1,2,1,1,1,3,1,H
1929-03-04,1928,West Ham United,Leicester City,2-1,2,1,1,1,3,1,H
1929-03-09,1928,Aston Villa,Birmingham City,1-2,1,2,1,1,3,-1,A
1929-03-09,1928,Burnley,Derby County,2-2,2,2,1,1,4,0,D
1929-03-09,1928,Bury,Portsmouth,0-0,0,0,1,1,0,0,D
1929-03-09,1928,Cardiff City,Sheffield Wednesday,3-1,3,1,1,1,4,2,H
1929-03-09,1928,Leeds United,Everton,3-1,3,1,1,1,4,2,H
1929-03-09,1928,Leicester City,Manchester City,3-2,3,2,1,1,5,1,H
1929-03-09,1928,Liverpool,Arsenal,2-4,2,4,1,1,6,-2,A
1929-03-09,1928,Manchester United,Huddersfield Town,1-0,1,0,1,1,1,1,H
1929-03-09,1928,Newcastle United,Sunderland,4-3,4,3,1,1,7,1,H
1929-03-09,1928,Sheffield United,Bolton Wanderers,1-1,1,1,1,1,2,0,D
1929-03-09,1928,West Ham United,Blackburn Rovers,3-3,3,3,1,1,6,0,D
1929-03-13,1928,Birmingham City,Arsenal,1-1,1,1,1,1,2,0,D
1929-03-13,1928,Liverpool,West Ham United,2-1,2,1,1,1,3,1,H
1929-03-13,1928,Newcastle United,Aston Villa,2-1,2,1,1,1,3,1,H
1929-03-13,1928,Portsmouth,Blackburn Rovers,2-2,2,2,1,1,4,0,D
1929-03-16,1928,Arsenal,Cardiff City,2-1,2,1,1,1,3,1,H
1929-03-16,1928,Birmingham City,Liverpool,0-0,0,0,1,1,0,0,D
1929-03-16,1928,Blackburn Rovers,Sheffield United,1-1,1,1,1,1,2,0,D
1929-03-16,1928,Bolton Wanderers,Manchester United,1-1,1,1,1,1,2,0,D
1929-03-16,1928,Derby County,Aston Villa,1-0,1,0,1,1,1,1,H
1929-03-16,1928,Everton,Burnley,2-0,2,0,1,1,2,2,H
1929-03-16,1928,Huddersfield Town,Newcastle United,2-1,2,1,1,1,3,1,H
1929-03-16,1928,Manchester City,West Ham United,4-2,4,2,1,1,6,2,H
1929-03-16,1928,Portsmouth,Leeds United,0-2,0,2,1,1,2,-2,A
1929-03-16,1928,Sheffield Wednesday,Leicester City,1-0,1,0,1,1,1,1,H
1929-03-16,1928,Sunderland,Bury,3-1,3,1,1,1,4,2,H
1929-03-20,1928,Bury,Birmingham City,3-1,3,1,1,1,4,2,H
1929-03-23,1928,Bury,Blackburn Rovers,1-0,1,0,1,1,1,1,H
1929-03-23,1928,Cardiff City,Everton,0-2,0,2,1,1,2,-2,A
1929-03-23,1928,Leicester City,Derby County,1-0,1,0,1,1,1,1,H
1929-03-23,1928,Manchester United,Sheffield Wednesday,2-1,2,1,1,1,3,1,H
1929-03-23,1928,Newcastle United,Manchester City,4-0,4,0,1,1,4,4,H
1929-03-23,1928,Sheffield United,Arsenal,2-2,2,2,1,1,4,0,D
1929-03-23,1928,West Ham United,Birmingham City,2-1,2,1,1,1,3,1,H
1929-03-25,1928,Aston Villa,Sunderland,3-1,3,1,1,1,4,2,H
1929-03-29,1928,Arsenal,Blackburn Rovers,1-0,1,0,1,1,1,1,H
1929-03-29,1928,Bury,Manchester United,1-3,1,3,1,1,4,-2,A
1929-03-29,1928,Liverpool,Cardiff City,2-0,2,0,1,1,2,2,H
1929-03-29,1928,Manchester City,Bolton Wanderers,5-1,5,1,1,1,6,4,H
1929-03-29,1928,Portsmouth,Birmingham City,3-1,3,1,1,1,4,2,H
1929-03-29,1928,Sunderland,Everton,2-2,2,2,1,1,4,0,D
1929-03-29,1928,West Ham United,Burnley,4-0,4,0,1,1,4,4,H
1929-03-30,1928,Arsenal,Bury,7-1,7,1,1,1,8,6,H
1929-03-30,1928,Birmingham City,Newcastle United,0-0,0,0,1,1,0,0,D
1929-03-30,1928,Blackburn Rovers,Aston Villa,2-5,2,5,1,1,7,-3,A
1929-03-30,1928,Bolton Wanderers,Liverpool,0-0,0,0,1,1,0,0,D
1929-03-30,1928,Derby County,Manchester United,6-1,6,1,1,1,7,5,H
1929-03-30,1928,Everton,Sheffield United,1-3,1,3,1,1,4,-2,A
1929-03-30,1928,Huddersfield Town,Cardiff City,1-1,1,1,1,1,2,0,D
1929-03-30,1928,Manchester City,Burnley,4-1,4,1,1,1,5,3,H
1929-03-30,1928,Portsmouth,West Ham United,3-0,3,0,1,1,3,3,H
1929-03-30,1928,Sheffield Wednesday,Leeds United,4-2,4,2,1,1,6,2,H
1929-03-30,1928,Sunderland,Leicester City,1-2,1,2,1,1,3,-1,A
1929-04-01,1928,Birmingham City,Portsmouth,1-0,1,0,1,1,1,1,H
1929-04-01,1928,Blackburn Rovers,Huddersfield Town,1-1,1,1,1,1,2,0,D
1929-04-01,1928,Bolton Wanderers,Manchester City,1-1,1,1,1,1,2,0,D
1929-04-01,1928,Cardiff City,Liverpool,1-2,1,2,1,1,3,-1,A
1929-04-01,1928,Leicester City,Aston Villa,4-1,4,1,1,1,5,3,H
1929-04-01,1928,Manchester United,Bury,1-0,1,0,1,1,1,1,H
1929-04-01,1928,Sheffield United,Leeds United,1-1,1,1,1,1,2,0,D
1929-04-02,1928,Arsenal,Newcastle United,1-2,1,2,1,1,3,-1,A
1929-04-02,1928,Aston Villa,Leicester City,4-2,4,2,1,1,6,2,H
1929-04-02,1928,Derby County,Everton,3-0,3,0,1,1,3,3,H
1929-04-02,1928,Huddersfield Town,Sheffield Wednesday,0-0,0,0,1,1,0,0,D
1929-04-02,1928,Leeds United,Sheffield United,2-0,2,0,1,1,2,2,H
1929-04-06,1928,Aston Villa,Arsenal,4-2,4,2,1,1,6,2,H
1929-04-06,1928,Burnley,Birmingham City,4-0,4,0,1,1,4,4,H
1929-04-06,1928,Bury,Everton,1-2,1,2,1,1,3,-1,A
1929-04-06,1928,Cardiff City,Manchester City,1-3,1,3,1,1,4,-2,A
1929-04-06,1928,Leeds United,Derby County,1-1,1,1,1,1,2,0,D
1929-04-06,1928,Leicester City,Blackburn Rovers,2-1,2,1,1,1,3,1,H
1929-04-06,1928,Liverpool,Sheffield Wednesday,3-2,3,2,1,1,5,1,H
1929-04-06,1928,Manchester United,Sunderland,3-0,3,0,1,1,3,3,H
1929-04-06,1928,Newcastle United,Portsmouth,0-1,0,1,1,1,1,-1,A
1929-04-06,1928,Sheffield United,Huddersfield Town,1-0,1,0,1,1,1,1,H
1929-04-06,1928,West Ham United,Bolton Wanderers,3-0,3,0,1,1,3,3,H
1929-04-10,1928,Everton,West Ham United,0-4,0,4,1,1,4,-4,A
1929-04-10,1928,Huddersfield Town,Liverpool,1-3,1,3,1,1,4,-2,A
1929-04-10,1928,Portsmouth,Leicester City,1-0,1,0,1,1,1,1,H
1929-04-13,1928,Arsenal,Leicester City,1-1,1,1,1,1,2,0,D
1929-04-13,1928,Birmingham City,Cardiff City,0-0,0,0,1,1,0,0,D
1929-04-13,1928,Blackburn Rovers,Manchester United,0-3,0,3,1,1,3,-3,A
1929-04-13,1928,Bolton Wanderers,Newcastle United,1-0,1,0,1,1,1,1,H
1929-04-13,1928,Derby County,Liverpool,2-5,2,5,1,1,7,-3,A
1929-04-13,1928,Everton,Aston Villa,0-1,0,1,1,1,1,-1,A
1929-04-13,1928,Huddersfield Town,Bury,0-2,0,2,1,1,2,-2,A
1929-04-13,1928,Manchester City,Sheffield United,3-1,3,1,1,1,4,2,H
1929-04-13,1928,Portsmouth,Burnley,3-1,3,1,1,1,4,2,H
1929-04-13,1928,Sheffield Wednesday,West Ham United,6-0,6,0,1,1,6,6,H
1929-04-13,1928,Sunderland,Leeds United,2-1,2,1,1,1,3,1,H
1929-04-16,1928,Burnley,Huddersfield Town,3-2,3,2,1,1,5,1,H
1929-04-17,1928,Bolton Wanderers,Aston Villa,3-1,3,1,1,1,4,2,H
1929-04-17,1928,Liverpool,Portsmouth,0-0,0,0,1,1,0,0,D
1929-04-20,1928,Aston Villa,Huddersfield Town,4-1,4,1,1,1,5,3,H
1929-04-20,1928,Burnley,Bolton Wanderers,3-1,3,1,1,1,4,2,H
1929-04-20,1928,Bury,Manchester City,1-2,1,2,1,1,3,-1,A
1929-04-20,1928,Cardiff City,Portsmouth,1-1,1,1,1,1,2,0,D
1929-04-20,1928,Leeds United,Blackburn Rovers,0-1,0,1,1,1,1,-1,A
1929-04-20,1928,Leicester City,Everton,4-1,4,1,1,1,5,3,H
1929-04-20,1928,Liverpool,Sunderland,5-2,5,2,1,1,7,3,H
1929-04-20,1928,Manchester United,Arsenal,4-1,4,1,1,1,5,3,H
1929-04-20,1928,Newcastle United,Sheffield Wednesday,2-1,2,1,1,1,3,1,H
1929-04-20,1928,Sheffield United,Birmingham City,3-2,3,2,1,1,5,1,H
1929-04-20,1928,West Ham United,Derby County,2-2,2,2,1,1,4,0,D
1929-04-22,1928,Arsenal,Everton,2-0,2,0,1,1,2,2,H
1929-04-27,1928,Arsenal,Leeds United,1-0,1,0,1,1,1,1,H
1929-04-27,1928,Birmingham City,Bury,3-2,3,2,1,1,5,1,H
1929-04-27,1928,Blackburn Rovers,Liverpool,2-1,2,1,1,1,3,1,H
1929-04-27,1928,Derby County,Newcastle United,1-2,1,2,1,1,3,-1,A
1929-04-27,1928,Everton,Manchester United,2-4,2,4,1,1,6,-2,A
1929-04-27,1928,Huddersfield Town,Leicester City,1-1,1,1,1,1,2,0,D
1929-04-27,1928,Manchester City,Aston Villa,3-0,3,0,1,1,3,3,H
1929-04-27,1928,Sheffield Wednesday,Burnley,1-1,1,1,1,1,2,0,D
1929-04-27,1928,Sunderland,West Ham United,4-1,4,1,1,1,5,3,H
1929-04-29,1928,Leeds United,Bolton Wanderers,2-2,2,2,1,1,4,0,D
1929-04-29,1928,Portsmouth,Sheffield United,2-3,2,3,1,1,5,-1,A
1929-05-01,1928,Bury,Bolton Wanderers,3-4,3,4,1,1,7,-1,A
1929-05-01,1928,Leeds United,Huddersfield Town,1-2,1,2,1,1,3,-1,A
1929-05-02,1928,Blackburn Rovers,Burnley,1-1,1,1,1,1,2,0,D
1929-05-04,1928,Aston Villa,Sheffield Wednesday,4-1,4,1,1,1,5,3,H
1929-05-04,1928,Burnley,Arsenal,3-3,3,3,1,1,6,0,D
1929-05-04,1928,Bury,Derby County,3-3,3,3,1,1,6,0,D
1929-05-04,1928,Cardiff City,Blackburn Rovers,1-1,1,1,1,1,2,0,D
1929-05-04,1928,Leeds United,Birmingham City,0-1,0,1,1,1,1,-1,A
1929-05-04,1928,Leicester City,Bolton Wanderers,6-1,6,1,1,1,7,5,H
1929-05-04,1928,Liverpool,Manchester City,1-1,1,1,1,1,2,0,D
1929-05-04,1928,Manchester United,Portsmouth,0-0,0,0,1,1,0,0,D
1929-05-04,1928,Newcastle United,Everton,2-0,2,0,1,1,2,2,H
1929-05-04,1928,Sheffield United,Sunderland,4-0,4,0,1,1,4,4,H
1929-05-04,1928,West Ham United,Huddersfield Town,1-1,1,1,1,1,2,0,D
1929-08-31,1929,Arsenal,Leeds United,4-0,4,0,1,1,4,4,H
1929-08-31,1929,Aston Villa,Birmingham City,2-1,2,1,1,1,3,1,H
1929-08-31,1929,Blackburn Rovers,West Ham United,3-3,3,3,1,1,6,0,D
1929-08-31,1929,Derby County,Sunderland,3-0,3,0,1,1,3,3,H
1929-08-31,1929,Everton,Bolton Wanderers,3-3,3,3,1,1,6,0,D
1929-08-31,1929,Huddersfield Town,Leicester City,3-2,3,2,1,1,5,1,H
1929-08-31,1929,Manchester City,Burnley,2-2,2,2,1,1,4,0,D
1929-08-31,1929,Middlesbrough,Liverpool,5-0,5,0,1,1,5,5,H
1929-08-31,1929,Newcastle United,Manchester United,4-1,4,1,1,1,5,3,H
1929-08-31,1929,Portsmouth,Sheffield Wednesday,0-4,0,4,1,1,4,-4,A
1929-08-31,1929,Sheffield United,Grimsby Town,2-3,2,3,1,1,5,-1,A
1929-09-02,1929,Burnley,Everton,1-1,1,1,1,1,2,0,D
1929-09-02,1929,Leicester City,Manchester United,4-1,4,1,1,1,5,3,H
1929-09-02,1929,Sheffield Wednesday,Bolton Wanderers,1-0,1,0,1,1,1,1,H
1929-09-04,1929,Birmingham City,West Ham United,4-2,4,2,1,1,6,2,H
1929-09-04,1929,Derby County,Aston Villa,4-0,4,0,1,1,4,4,H
1929-09-04,1929,Grimsby Town,Portsmouth,1-1,1,1,1,1,2,0,D
1929-09-04,1929,Liverpool,Huddersfield Town,3-0,3,0,1,1,3,3,H
1929-09-04,1929,Manchester City,Arsenal,3-1,3,1,1,1,4,2,H
1929-09-04,1929,Middlesbrough,Sheffield United,3-1,3,1,1,1,4,2,H
1929-09-04,1929,Newcastle United,Blackburn Rovers,5-1,5,1,1,1,6,4,H
1929-09-07,1929,Birmingham City,Huddersfield Town,4-1,4,1,1,1,5,3,H
1929-09-07,1929,Bolton Wanderers,Derby County,1-2,1,2,1,1,3,-1,A
1929-09-07,1929,Burnley,Portsmouth,4-0,4,0,1,1,4,4,H
1929-09-07,1929,Grimsby Town,Newcastle United,4-0,4,0,1,1,4,4,H
1929-09-07,1929,Leeds United,Aston Villa,4-1,4,1,1,1,5,3,H
1929-09-07,1929,Leicester City,Sheffield United,3-3,3,3,1,1,6,0,D
1929-09-07,1929,Liverpool,Everton,0-3,0,3,1,1,3,-3,A
1929-09-07,1929,Manchester United,Blackburn Rovers,1-0,1,0,1,1,1,1,H
1929-09-07,1929,Sheffield Wednesday,Arsenal,0-2,0,2,1,1,2,-2,A
1929-09-07,1929,Sunderland,Manchester City,5-2,5,2,1,1,7,3,H
1929-09-07,1929,West Ham United,Middlesbrough,5-3,5,3,1,1,8,2,H
1929-09-09,1929,Aston Villa,Derby County,2-2,2,2,1,1,4,0,D
1929-09-09,1929,Sheffield United,Middlesbrough,1-3,1,3,1,1,4,-2,A
1929-09-09,1929,West Ham United,Newcastle United,5-1,5,1,1,1,6,4,H
1929-09-10,1929,Burnley,Sunderland,2-0,2,0,1,1,2,2,H
1929-09-11,1929,Arsenal,Manchester City,3-2,3,2,1,1,5,1,H
1929-09-11,1929,Everton,Leeds United,1-1,1,1,1,1,2,0,D
1929-09-11,1929,Manchester United,Leicester City,2-1,2,1,1,1,3,1,H
1929-09-11,1929,Portsmouth,Grimsby Town,1-1,1,1,1,1,2,0,D
1929-09-14,1929,Arsenal,Burnley,6-1,6,1,1,1,7,5,H
1929-09-14,1929,Aston Villa,Sheffield Wednesday,1-3,1,3,1,1,4,-2,A
1929-09-14,1929,Blackburn Rovers,Grimsby Town,4-1,4,1,1,1,5,3,H
1929-09-14,1929,Derby County,Everton,2-1,2,1,1,1,3,1,H
1929-09-14,1929,Huddersfield Town,Leeds United,1-0,1,0,1,1,1,1,H
1929-09-14,1929,Liverpool,West Ham United,3-1,3,1,1,1,4,2,H
1929-09-14,1929,Manchester City,Bolton Wanderers,2-0,2,0,1,1,2,2,H
1929-09-14,1929,Middlesbrough,Manchester United,2-3,2,3,1,1,5,-1,A
1929-09-14,1929,Newcastle United,Leicester City,2-1,2,1,1,1,3,1,H
1929-09-14,1929,Portsmouth,Sunderland,1-1,1,1,1,1,2,0,D
1929-09-14,1929,Sheffield United,Birmingham City,4-2,4,2,1,1,6,2,H
1929-09-16,1929,Blackburn Rovers,Newcastle United,4-2,4,2,1,1,6,2,H
1929-09-16,1929,Huddersfield Town,Liverpool,3-0,3,0,1,1,3,3,H
1929-09-16,1929,Leeds United,Everton,2-1,2,1,1,1,3,1,H
1929-09-16,1929,West Ham United,Birmingham City,0-1,0,1,1,1,1,-1,A
1929-09-18,1929,Bolton Wanderers,Middlesbrough,2-2,2,2,1,1,4,0,D
1929-09-21,1929,Birmingham City,Newcastle United,5-1,5,1,1,1,6,4,H
1929-09-21,1929,Bolton Wanderers,Portsmouth,2-1,2,1,1,1,3,1,H
1929-09-21,1929,Burnley,Aston Villa,1-4,1,4,1,1,5,-3,A
1929-09-21,1929,Everton,Manchester City,2-3,2,3,1,1,5,-1,A
1929-09-21,1929,Grimsby Town,Middlesbrough,0-3,0,3,1,1,3,-3,A
1929-09-21,1929,Huddersfield Town,Sheffield United,2-2,2,2,1,1,4,0,D
1929-09-21,1929,Leicester City,Blackburn Rovers,1-1,1,1,1,1,2,0,D
1929-09-21,1929,Manchester United,Liverpool,1-2,1,2,1,1,3,-1,A
1929-09-21,1929,Sheffield Wednesday,Leeds United,1-2,1,2,1,1,3,-1,A
1929-09-21,1929,Sunderland,Arsenal,0-1,0,1,1,1,1,-1,A
1929-09-21,1929,West Ham United,Derby County,2-0,2,0,1,1,2,2,H
1929-09-23,1929,Leeds United,Portsmouth,1-0,1,0,1,1,1,1,H
1929-09-24,1929,Grimsby Town,Huddersfield Town,4-2,4,2,1,1,6,2,H
1929-09-25,1929,Aston Villa,Arsenal,5-2,5,2,1,1,7,3,H
1929-09-25,1929,Bolton Wanderers,Sheffield Wednesday,1-3,1,3,1,1,4,-2,A
1929-09-25,1929,Derby County,Burnley,1-3,1,3,1,1,4,-2,A
1929-09-28,1929,Arsenal,Bolton Wanderers,1-2,1,2,1,1,3,-1,A
1929-09-28,1929,Aston Villa,Sunderland,2-1,2,1,1,1,3,1,H
1929-09-28,1929,Blackburn Rovers,Birmingham City,7-5,7,5,1,1,12,2,H
1929-09-28,1929,Leeds United,Burnley,3-0,3,0,1,1,3,3,H
1929-09-28,1929,Liverpool,Grimsby Town,2-0,2,0,1,1,2,2,H
1929-09-28,1929,Manchester City,Derby County,3-0,3,0,1,1,3,3,H
1929-09-28,1929,Middlesbrough,Leicester City,0-2,0,2,1,1,2,-2,A
1929-09-28,1929,Newcastle United,Huddersfield Town,5-2,5,2,1,1,7,3,H
1929-09-28,1929,Portsmouth,Everton,1-4,1,4,1,1,5,-3,A
1929-09-28,1929,Sheffield United,Sheffield Wednesday,2-2,2,2,1,1,4,0,D
1929-09-28,1929,West Ham United,Manchester United,2-1,2,1,1,1,3,1,H
1929-10-02,1929,Sunderland,Everton,2-2,2,2,1,1,4,0,D
1929-10-05,1929,Birmingham City,Middlesbrough,1-1,1,1,1,1,2,0,D
1929-10-05,1929,Bolton Wanderers,Aston Villa,3-0,3,0,1,1,3,3,H
1929-10-05,1929,Burnley,Sheffield Wednesday,2-4,2,4,1,1,6,-2,A
1929-10-05,1929,Derby County,Portsmouth,3-2,3,2,1,1,5,1,H
1929-10-05,1929,Everton,Arsenal,1-1,1,1,1,1,2,0,D
1929-10-05,1929,Grimsby Town,West Ham United,2-2,2,2,1,1,4,0,D
1929-10-05,1929,Huddersfield Town,Blackburn Rovers,0-0,0,0,1,1,0,0,D
1929-10-05,1929,Leicester City,Liverpool,2-1,2,1,1,1,3,1,H
1929-10-05,1929,Manchester United,Manchester City,1-3,1,3,1,1,4,-2,A
1929-10-05,1929,Sheffield United,Newcastle United,1-0,1,0,1,1,1,1,H
1929-10-05,1929,Sunderland,Leeds United,1-4,1,4,1,1,5,-3,A
1929-10-07,1929,Sheffield United,Manchester United,3-1,3,1,1,1,4,2,H
1929-10-09,1929,Liverpool,Blackburn Rovers,1-1,1,1,1,1,2,0,D
1929-10-12,1929,Arsenal,Derby County,1-1,1,1,1,1,2,0,D
1929-10-12,1929,Aston Villa,Everton,5-2,5,2,1,1,7,3,H
1929-10-12,1929,Blackburn Rovers,Sheffield United,0-1,0,1,1,1,1,-1,A
1929-10-12,1929,Leeds United,Bolton Wanderers,2-1,2,1,1,1,3,1,H
1929-10-12,1929,Liverpool,Birmingham City,1-1,1,1,1,1,2,0,D
1929-10-12,1929,Manchester United,Grimsby Town,2-5,2,5,1,1,7,-3,A
1929-10-12,1929,Middlesbrough,Huddersfield Town,1-3,1,3,1,1,4,-2,A
1929-10-12,1929,Newcastle United,Burnley,2-1,2,1,1,1,3,1,H
1929-10-12,1929,Portsmouth,Manchester City,2-2,2,2,1,1,4,0,D
1929-10-12,1929,Sheffield Wednesday,Sunderland,1-1,1,1,1,1,2,0,D
1929-10-12,1929,West Ham United,Leicester City,1-2,1,2,1,1,3,-1,A
1929-10-17,1929,Leicester City,Birmingham City,2-1,2,1,1,1,3,1,H
1929-10-19,1929,Arsenal,Grimsby Town,4-1,4,1,1,1,5,3,H
1929-10-19,1929,Aston Villa,Leicester City,3-0,3,0,1,1,3,3,H
1929-10-19,1929,Bolton Wanderers,Blackburn Rovers,2-1,2,1,1,1,3,1,H
1929-10-19,1929,Burnley,Sheffield United,5-0,5,0,1,1,5,5,H
1929-10-19,1929,Derby County,Liverpool,2-2,2,2,1,1,4,0,D
1929-10-19,1929,Everton,Middlesbrough,3-2,3,2,1,1,5,1,H
1929-10-19,1929,Leeds United,Birmingham City,1-0,1,0,1,1,1,1,H
1929-10-19,1929,Manchester City,West Ham United,4-3,4,3,1,1,7,1,H
1929-10-19,1929,Portsmouth,Manchester United,3-0,3,0,1,1,3,3,H
1929-10-19,1929,Sheffield Wednesday,Huddersfield Town,3-1,3,1,1,1,4,2,H
1929-10-19,1929,Sunderland,Newcastle United,1-0,1,0,1,1,1,1,H
1929-10-26,1929,Birmingham City,Sheffield Wednesday,1-0,1,0,1,1,1,1,H
1929-10-26,1929,Blackburn Rovers,Everton,3-1,3,1,1,1,4,2,H
1929-10-26,1929,Grimsby Town,Aston Villa,0-2,0,2,1,1,2,-2,A
1929-10-26,1929,Huddersfield Town,Burnley,3-0,3,0,1,1,3,3,H
1929-10-26,1929,Leicester City,Leeds United,2-2,2,2,1,1,4,0,D
1929-10-26,1929,Liverpool,Manchester City,1-6,1,6,1,1,7,-5,A
1929-10-26,1929,Manchester United,Arsenal,1-0,1,0,1,1,1,1,H
1929-10-26,1929,Middlesbrough,Derby County,4-0,4,0,1,1,4,4,H
1929-10-26,1929,Newcastle United,Bolton Wanderers,2-3,2,3,1,1,5,-1,A
1929-10-26,1929,Sheffield United,Sunderland,4-2,4,2,1,1,6,2,H
1929-10-26,1929,West Ham United,Portsmouth,0-1,0,1,1,1,1,-1,A
1929-11-02,1929,Arsenal,West Ham United,0-1,0,1,1,1,1,-1,A
1929-11-02,1929,Aston Villa,Manchester United,1-0,1,0,1,1,1,1,H
1929-11-02,1929,Bolton Wanderers,Sheffield United,2-1,2,1,1,1,3,1,H
1929-11-02,1929,Burnley,Birmingham City,3-1,3,1,1,1,4,2,H
1929-11-02,1929,Derby County,Blackburn Rovers,4-3,4,3,1,1,7,1,H
1929-11-02,1929,Everton,Newcastle United,5-2,5,2,1,1,7,3,H
1929-11-02,1929,Leeds United,Grimsby Town,6-0,6,0,1,1,6,6,H
1929-11-02,1929,Manchester City,Middlesbrough,3-1,3,1,1,1,4,2,H
1929-11-02,1929,Portsmouth,Liverpool,3-3,3,3,1,1,6,0,D
1929-11-02,1929,Sheffield Wednesday,Leicester City,4-0,4,0,1,1,4,4,H
1929-11-02,1929,Sunderland,Huddersfield Town,1-0,1,0,1,1,1,1,H
1929-11-09,1929,Birmingham City,Arsenal,2-3,2,3,1,1,5,-1,A
1929-11-09,1929,Blackburn Rovers,Burnley,8-3,8,3,1,1,11,5,H
1929-11-09,1929,Grimsby Town,Manchester City,2-2,2,2,1,1,4,0,D
1929-11-09,1929,Huddersfield Town,Aston Villa,1-1,1,1,1,1,2,0,D
1929-11-09,1929,Leicester City,Portsmouth,0-5,0,5,1,1,5,-5,A
1929-11-09,1929,Liverpool,Bolton Wanderers,3-0,3,0,1,1,3,3,H
1929-11-09,1929,Manchester United,Derby County,3-2,3,2,1,1,5,1,H
1929-11-09,1929,Middlesbrough,Sunderland,3-0,3,0,1,1,3,3,H
1929-11-09,1929,Newcastle United,Sheffield Wednesday,1-3,1,3,1,1,4,-2,A
1929-11-09,1929,Sheffield United,Leeds United,3-2,3,2,1,1,5,1,H
1929-11-09,1929,West Ham United,Everton,3-1,3,1,1,1,4,2,H
1929-11-16,1929,Aston Villa,Liverpool,2-3,2,3,1,1,5,-1,A
1929-11-16,1929,Bolton Wanderers,Birmingham City,0-0,0,0,1,1,0,0,D
1929-11-16,1929,Burnley,Grimsby Town,3-1,3,1,1,1,4,2,H
1929-11-16,1929,Derby County,Sheffield United,2-1,2,1,1,1,3,1,H
1929-11-16,1929,Everton,Huddersfield Town,0-2,0,2,1,1,2,-2,A
1929-11-16,1929,Leeds United,West Ham United,1-3,1,3,1,1,4,-2,A
1929-11-16,1929,Manchester City,Newcastle United,3-0,3,0,1,1,3,3,H
1929-11-16,1929,Portsmouth,Blackburn Rovers,4-0,4,0,1,1,4,4,H
1929-11-16,1929,Sheffield Wednesday,Manchester United,7-2,7,2,1,1,9,5,H
1929-11-16,1929,Sunderland,Leicester City,2-1,2,1,1,1,3,1,H
1929-11-23,1929,Birmingham City,Everton,0-0,0,0,1,1,0,0,D
1929-11-23,1929,Blackburn Rovers,Arsenal,1-1,1,1,1,1,2,0,D
1929-11-23,1929,Grimsby Town,Sunderland,0-1,0,1,1,1,1,-1,A
1929-11-23,1929,Huddersfield Town,Derby County,0-1,0,1,1,1,1,-1,A
1929-11-23,1929,Leicester City,Bolton Wanderers,5-2,5,2,1,1,7,3,H
1929-11-23,1929,Liverpool,Leeds United,1-0,1,0,1,1,1,1,H
1929-11-23,1929,Manchester United,Burnley,1-0,1,0,1,1,1,1,H
1929-11-23,1929,Middlesbrough,Aston Villa,2-3,2,3,1,1,5,-1,A
1929-11-23,1929,Newcastle United,Portsmouth,4-1,4,1,1,1,5,3,H
1929-11-23,1929,Sheffield United,Manchester City,1-2,1,2,1,1,3,-1,A
1929-11-23,1929,West Ham United,Sheffield Wednesday,1-1,1,1,1,1,2,0,D
1929-11-27,1929,Arsenal,Middlesbrough,1-2,1,2,1,1,3,-1,A
1929-11-30,1929,Arsenal,Newcastle United,0-1,0,1,1,1,1,-1,A
1929-11-30,1929,Aston Villa,Blackburn Rovers,3-0,3,0,1,1,3,3,H
1929-11-30,1929,Bolton Wanderers,Grimsby Town,2-3,2,3,1,1,5,-1,A
1929-11-30,1929,Burnley,West Ham United,1-1,1,1,1,1,2,0,D
1929-11-30,1929,Derby County,Birmingham City,3-1,3,1,1,1,4,2,H
1929-11-30,1929,Everton,Leicester City,4-5,4,5,1,1,9,-1,A
1929-11-30,1929,Leeds United,Middlesbrough,1-2,1,2,1,1,3,-1,A
1929-11-30,1929,Manchester City,Huddersfield Town,1-1,1,1,1,1,2,0,D
1929-11-30,1929,Portsmouth,Sheffield United,3-1,3,1,1,1,4,2,H
1929-11-30,1929,Sheffield Wednesday,Liverpool,2-1,2,1,1,1,3,1,H
1929-11-30,1929,Sunderland,Manchester United,2-4,2,4,1,1,6,-2,A
1929-12-07,1929,Birmingham City,Manchester City,3-0,3,0,1,1,3,3,H
1929-12-07,1929,Blackburn Rovers,Leeds United,2-1,2,1,1,1,3,1,H
1929-12-07,1929,Grimsby Town,Everton,0-3,0,3,1,1,3,-3,A
1929-12-07,1929,Huddersfield Town,Portsmouth,2-1,2,1,1,1,3,1,H
1929-12-07,1929,Leicester City,Derby County,0-0,0,0,1,1,0,0,D
1929-12-07,1929,Liverpool,Burnley,1-3,1,3,1,1,4,-2,A
1929-12-07,1929,Manchester United,Bolton Wanderers,1-1,1,1,1,1,2,0,D
1929-12-07,1929,Middlesbrough,Sheffield Wednesday,4-1,4,1,1,1,5,3,H
1929-12-07,1929,Newcastle United,Aston Villa,2-2,2,2,1,1,4,0,D
1929-12-07,1929,West Ham United,Sunderland,1-1,1,1,1,1,2,0,D
1929-12-14,1929,Arsenal,Huddersfield Town,2-0,2,0,1,1,2,2,H
1929-12-14,1929,Aston Villa,Sheffield United,5-1,5,1,1,1,6,4,H
1929-12-14,1929,Bolton Wanderers,West Ham United,4-1,4,1,1,1,5,3,H
1929-12-14,1929,Burnley,Middlesbrough,4-1,4,1,1,1,5,3,H
1929-12-14,1929,Derby County,Grimsby Town,5-4,5,4,1,1,9,1,H
1929-12-14,1929,Everton,Manchester United,0-0,0,0,1,1,0,0,D
1929-12-14,1929,Leeds United,Newcastle United,5-2,5,2,1,1,7,3,H
1929-12-14,1929,Manchester City,Leicester City,3-2,3,2,1,1,5,1,H
1929-12-14,1929,Portsmouth,Birmingham City,2-1,2,1,1,1,3,1,H
1929-12-14,1929,Sheffield Wednesday,Blackburn Rovers,4-0,4,0,1,1,4,4,H
1929-12-14,1929,Sunderland,Liverpool,2-3,2,3,1,1,5,-1,A
1929-12-16,1929,Sheffield United,Arsenal,4-1,4,1,1,1,5,3,H
1929-12-21,1929,Birmingham City,Sunderland,3-1,3,1,1,1,4,2,H
1929-12-21,1929,Blackburn Rovers,Manchester City,1-3,1,3,1,1,4,-2,A
1929-12-21,1929,Huddersfield Town,Bolton Wanderers,0-2,0,2,1,1,2,-2,A
1929-12-21,1929,Leicester City,Burnley,4-3,4,3,1,1,7,1,H
1929-12-21,1929,Liverpool,Arsenal,1-0,1,0,1,1,1,1,H
1929-12-21,1929,Manchester United,Leeds United,3-1,3,1,1,1,4,2,H
1929-12-21,1929,Middlesbrough,Portsmouth,2-0,2,0,1,1,2,2,H
1929-12-21,1929,Newcastle United,Derby County,2-3,2,3,1,1,5,-1,A
1929-12-21,1929,Sheffield United,Everton,2-0,2,0,1,1,2,2,H
1929-12-21,1929,West Ham United,Aston Villa,5-2,5,2,1,1,7,3,H
1929-12-25,1929,Aston Villa,Manchester City,0-2,0,2,1,1,2,-2,A
1929-12-25,1929,Blackburn Rovers,Sunderland,5-3,5,3,1,1,8,2,H
1929-12-25,1929,Bolton Wanderers,Burnley,1-1,1,1,1,1,2,0,D
1929-12-25,1929,Everton,Sheffield Wednesday,1-4,1,4,1,1,5,-3,A
1929-12-25,1929,Grimsby Town,Leicester City,1-4,1,4,1,1,5,-3,A
1929-12-25,1929,Leeds United,Derby County,2-1,2,1,1,1,3,1,H
1929-12-25,1929,Manchester United,Birmingham City,0-0,0,0,1,1,0,0,D
1929-12-25,1929,Newcastle United,Middlesbrough,3-2,3,2,1,1,5,1,H
1929-12-25,1929,Portsmouth,Arsenal,0-1,0,1,1,1,1,-1,A
1929-12-25,1929,Sheffield United,Liverpool,4-0,4,0,1,1,4,4,H
1929-12-25,1929,West Ham United,Huddersfield Town,2-3,2,3,1,1,5,-1,A
1929-12-26,1929,Arsenal,Portsmouth,1-2,1,2,1,1,3,-1,A
1929-12-26,1929,Birmingham City,Manchester United,0-1,0,1,1,1,1,-1,A
1929-12-26,1929,Burnley,Bolton Wanderers,2-2,2,2,1,1,4,0,D
1929-12-26,1929,Derby County,Leeds United,3-0,3,0,1,1,3,3,H
1929-12-26,1929,Huddersfield Town,West Ham United,3-0,3,0,1,1,3,3,H
1929-12-26,1929,Leicester City,Grimsby Town,1-0,1,0,1,1,1,1,H
1929-12-26,1929,Liverpool,Sheffield United,2-0,2,0,1,1,2,2,H
1929-12-26,1929,Manchester City,Aston Villa,1-2,1,2,1,1,3,-1,A
1929-12-26,1929,Middlesbrough,Newcastle United,2-2,2,2,1,1,4,0,D
1929-12-26,1929,Sheffield Wednesday,Everton,4-0,4,0,1,1,4,4,H
1929-12-26,1929,Sunderland,Blackburn Rovers,3-1,3,1,1,1,4,2,H
1929-12-28,1929,Birmingham City,Aston Villa,1-1,1,1,1,1,2,0,D
1929-12-28,1929,Bolton Wanderers,Everton,5-0,5,0,1,1,5,5,H
1929-12-28,1929,Burnley,Manchester City,4-2,4,2,1,1,6,2,H
1929-12-28,1929,Grimsby Town,Sheffield United,4-1,4,1,1,1,5,3,H
1929-12-28,1929,Leeds United,Arsenal,2-0,2,0,1,1,2,2,H
1929-12-28,1929,Leicester City,Huddersfield Town,1-2,1,2,1,1,3,-1,A
1929-12-28,1929,Liverpool,Middlesbrough,5-2,5,2,1,1,7,3,H
1929-12-28,1929,Manchester United,Newcastle United,5-0,5,0,1,1,5,5,H
1929-12-28,1929,Sheffield Wednesday,Portsmouth,1-1,1,1,1,1,2,0,D
1929-12-28,1929,Sunderland,Derby County,3-1,3,1,1,1,4,2,H
1929-12-28,1929,West Ham United,Blackburn Rovers,2-3,2,3,1,1,5,-1,A
1930-01-01,1929,Blackburn Rovers,Middlesbrough,7-0,7,0,1,1,7,7,H
1930-01-01,1929,Bolton Wanderers,Huddersfield Town,7-1,7,1,1,1,8,6,H
1930-01-01,1929,Manchester City,Sheffield Wednesday,3-3,3,3,1,1,6,0,D
1930-01-01,1929,Sheffield United,West Ham United,4-2,4,2,1,1,6,2,H
1930-01-01,1929,Sunderland,Burnley,3-3,3,3,1,1,6,0,D
1930-01-04,1929,Arsenal,Sheffield Wednesday,2-3,2,3,1,1,5,-1,A
1930-01-04,1929,Aston Villa,Leeds United,3-4,3,4,1,1,7,-1,A
1930-01-04,1929,Blackburn Rovers,Manchester United,5-4,5,4,1,1,9,1,H
1930-01-04,1929,Derby County,Bolton Wanderers,2-1,2,1,1,1,3,1,H
1930-01-04,1929,Everton,Liverpool,3-3,3,3,1,1,6,0,D
1930-01-04,1929,Huddersfield Town,Birmingham City,1-1,1,1,1,1,2,0,D
1930-01-04,1929,Manchester City,Sunderland,2-2,2,2,1,1,4,0,D
1930-01-04,1929,Middlesbrough,West Ham United,2-0,2,0,1,1,2,2,H
1930-01-04,1929,Newcastle United,Grimsby Town,3-1,3,1,1,1,4,2,H
1930-01-04,1929,Portsmouth,Burnley,7-1,7,1,1,1,8,6,H
1930-01-04,1929,Sheffield United,Leicester City,7-1,7,1,1,1,8,6,H
1930-01-18,1929,Birmingham City,Sheffield United,2-1,2,1,1,1,3,1,H
1930-01-18,1929,Bolton Wanderers,Manchester City,1-2,1,2,1,1,3,-1,A
1930-01-18,1929,Burnley,Arsenal,2-2,2,2,1,1,4,0,D
1930-01-18,1929,Everton,Derby County,4-0,4,0,1,1,4,4,H
1930-01-18,1929,Grimsby Town,Blackburn Rovers,5-3,5,3,1,1,8,2,H
1930-01-18,1929,Leeds United,Huddersfield Town,0-1,0,1,1,1,1,-1,A
1930-01-18,1929,Leicester City,Newcastle United,6-1,6,1,1,1,7,5,H
1930-01-18,1929,Manchester United,Middlesbrough,0-3,0,3,1,1,3,-3,A
1930-01-18,1929,Sheffield Wednesday,Aston Villa,3-0,3,0,1,1,3,3,H
1930-01-18,1929,Sunderland,Portsmouth,1-1,1,1,1,1,2,0,D
1930-01-18,1929,West Ham United,Liverpool,4-1,4,1,1,1,5,3,H
1930-01-25,1929,Liverpool,Manchester United,1-0,1,0,1,1,1,1,H
1930-01-27,1929,Blackburn Rovers,Leicester City,3-1,3,1,1,1,4,2,H
1930-02-01,1929,Birmingham City,Blackburn Rovers,1-2,1,2,1,1,3,-1,A
1930-02-01,1929,Bolton Wanderers,Arsenal,0-0,0,0,1,1,0,0,D
1930-02-01,1929,Burnley,Leeds United,0-3,0,3,1,1,3,-3,A
1930-02-01,1929,Derby County,Manchester City,4-2,4,2,1,1,6,2,H
1930-02-01,1929,Everton,Portsmouth,1-1,1,1,1,1,2,0,D
1930-02-01,1929,Grimsby Town,Liverpool,3-2,3,2,1,1,5,1,H
1930-02-01,1929,Huddersfield Town,Newcastle United,2-0,2,0,1,1,2,2,H
1930-02-01,1929,Leicester City,Middlesbrough,4-1,4,1,1,1,5,3,H
1930-02-01,1929,Manchester United,West Ham United,4-2,4,2,1,1,6,2,H
1930-02-01,1929,Sheffield Wednesday,Sheffield United,1-1,1,1,1,1,2,0,D
1930-02-01,1929,Sunderland,Aston Villa,4-1,4,1,1,1,5,3,H
1930-02-05,1929,Aston Villa,Burnley,1-2,1,2,1,1,3,-1,A
1930-02-05,1929,Derby County,West Ham United,4-3,4,3,1,1,7,1,H
1930-02-05,1929,Grimsby Town,Sheffield Wednesday,0-5,0,5,1,1,5,-5,A
1930-02-05,1929,Manchester City,Everton,1-2,1,2,1,1,3,-1,A
1930-02-05,1929,Portsmouth,Bolton Wanderers,3-0,3,0,1,1,3,3,H
1930-02-08,1929,Arsenal,Everton,4-0,4,0,1,1,4,4,H
1930-02-08,1929,Aston Villa,Bolton Wanderers,2-0,2,0,1,1,2,2,H
1930-02-08,1929,Blackburn Rovers,Huddersfield Town,5-2,5,2,1,1,7,3,H
1930-02-08,1929,Leeds United,Sunderland,5-0,5,0,1,1,5,5,H
1930-02-08,1929,Liverpool,Leicester City,1-1,1,1,1,1,2,0,D
1930-02-08,1929,Manchester City,Manchester United,0-1,0,1,1,1,1,-1,A
1930-02-08,1929,Middlesbrough,Birmingham City,5-1,5,1,1,1,6,4,H
1930-02-08,1929,Newcastle United,Sheffield United,3-5,3,5,1,1,8,-2,A
1930-02-08,1929,Portsmouth,Derby County,3-1,3,1,1,1,4,2,H
1930-02-08,1929,Sheffield Wednesday,Burnley,4-1,4,1,1,1,5,3,H
1930-02-08,1929,West Ham United,Grimsby Town,2-0,2,0,1,1,2,2,H
1930-02-15,1929,Birmingham City,Liverpool,1-0,1,0,1,1,1,1,H
1930-02-15,1929,Bolton Wanderers,Leeds United,4-2,4,2,1,1,6,2,H
1930-02-15,1929,Burnley,Leicester City,1-1,1,1,1,1,2,0,D
1930-02-15,1929,Grimsby Town,Manchester United,2-2,2,2,1,1,4,0,D
1930-02-17,1929,Sheffield United,Huddersfield Town,0-1,0,1,1,1,1,-1,A
1930-02-19,1929,Derby County,Arsenal,4-1,4,1,1,1,5,3,H
1930-02-20,1929,Leicester City,West Ham United,1-2,1,2,1,1,3,-1,A
1930-02-22,1929,Birmingham City,Leeds United,1-0,1,0,1,1,1,1,H
1930-02-22,1929,Blackburn Rovers,Bolton Wanderers,3-1,3,1,1,1,4,2,H
1930-02-22,1929,Grimsby Town,Arsenal,1-1,1,1,1,1,2,0,D
1930-02-22,1929,Huddersfield Town,Sheffield Wednesday,4-1,4,1,1,1,5,3,H
1930-02-22,1929,Leicester City,Aston Villa,4-3,4,3,1,1,7,1,H
1930-02-22,1929,Liverpool,Derby County,2-2,2,2,1,1,4,0,D
1930-02-22,1929,Manchester United,Portsmouth,3-0,3,0,1,1,3,3,H
1930-02-22,1929,Middlesbrough,Everton,1-2,1,2,1,1,3,-1,A
1930-02-22,1929,Newcastle United,Sunderland,3-0,3,0,1,1,3,3,H
1930-02-22,1929,Sheffield United,Burnley,3-1,3,1,1,1,4,2,H
1930-02-22,1929,West Ham United,Manchester City,3-0,3,0,1,1,3,3,H
1930-02-26,1929,Manchester City,Portsmouth,5-2,5,2,1,1,7,3,H
1930-03-01,1929,Bolton Wanderers,Manchester United,4-1,4,1,1,1,5,3,H
1930-03-01,1929,Derby County,Middlesbrough,3-1,3,1,1,1,4,2,H
1930-03-01,1929,Everton,Blackburn Rovers,2-2,2,2,1,1,4,0,D
1930-03-01,1929,Leeds United,Leicester City,1-2,1,2,1,1,3,-1,A
1930-03-01,1929,Manchester City,Liverpool,4-3,4,3,1,1,7,1,H
1930-03-01,1929,Sunderland,Sheffield United,3-2,3,2,1,1,5,1,H
1930-03-03,1929,Sheffield United,Blackburn Rovers,5-7,5,7,1,1,12,-2,A
1930-03-05,1929,Everton,Aston Villa,3-4,3,4,1,1,7,-1,A
1930-03-05,1929,Middlesbrough,Grimsby Town,1-5,1,5,1,1,6,-4,A
1930-03-08,1929,Birmingham City,Burnley,2-0,2,0,1,1,2,2,H
1930-03-08,1929,Blackburn Rovers,Derby County,0-3,0,3,1,1,3,-3,A
1930-03-08,1929,Grimsby Town,Leeds United,1-2,1,2,1,1,3,-1,A
1930-03-08,1929,Huddersfield Town,Sunderland,0-2,0,2,1,1,2,-2,A
1930-03-08,1929,Leicester City,Sheffield Wednesday,2-1,2,1,1,1,3,1,H
1930-03-08,1929,Liverpool,Portsmouth,2-0,2,0,1,1,2,2,H
1930-03-08,1929,Manchester United,Aston Villa,2-3,2,3,1,1,5,-1,A
1930-03-08,1929,Middlesbrough,Manchester City,1-0,1,0,1,1,1,1,H
1930-03-08,1929,Newcastle United,Everton,1-0,1,0,1,1,1,1,H
1930-03-08,1929,Sheffield United,Bolton Wanderers,2-3,2,3,1,1,5,-1,A
1930-03-08,1929,West Ham United,Arsenal,3-2,3,2,1,1,5,1,H
1930-03-11,1929,Burnley,Newcastle United,0-3,0,3,1,1,3,-3,A
1930-03-12,1929,Arsenal,Manchester United,4-2,4,2,1,1,6,2,H
1930-03-12,1929,Portsmouth,West Ham United,3-1,3,1,1,1,4,2,H
1930-03-15,1929,Arsenal,Birmingham City,1-0,1,0,1,1,1,1,H
1930-03-15,1929,Aston Villa,Huddersfield Town,5-3,5,3,1,1,8,2,H
1930-03-15,1929,Bolton Wanderers,Liverpool,0-2,0,2,1,1,2,-2,A
1930-03-15,1929,Burnley,Blackburn Rovers,3-2,3,2,1,1,5,1,H
1930-03-15,1929,Derby County,Manchester United,1-1,1,1,1,1,2,0,D
1930-03-15,1929,Everton,West Ham United,1-2,1,2,1,1,3,-1,A
1930-03-15,1929,Leeds United,Sheffield United,2-2,2,2,1,1,4,0,D
1930-03-15,1929,Manchester City,Grimsby Town,3-1,3,1,1,1,4,2,H
1930-03-15,1929,Portsmouth,Leicester City,3-0,3,0,1,1,3,3,H
1930-03-15,1929,Sheffield Wednesday,Newcastle United,4-2,4,2,1,1,6,2,H
1930-03-15,1929,Sunderland,Middlesbrough,3-2,3,2,1,1,5,1,H
1930-03-22,1929,Birmingham City,Bolton Wanderers,3-1,3,1,1,1,4,2,H
1930-03-22,1929,Blackburn Rovers,Portsmouth,1-0,1,0,1,1,1,1,H
1930-03-22,1929,Grimsby Town,Burnley,4-0,4,0,1,1,4,4,H
1930-03-22,1929,Leicester City,Sunderland,1-2,1,2,1,1,3,-1,A
1930-03-22,1929,Liverpool,Aston Villa,2-0,2,0,1,1,2,2,H
1930-03-22,1929,Newcastle United,Manchester City,2-2,2,2,1,1,4,0,D
1930-03-22,1929,Sheffield United,Derby County,2-0,2,0,1,1,2,2,H
1930-03-22,1929,West Ham United,Leeds United,3-0,3,0,1,1,3,3,H
1930-03-26,1929,Huddersfield Town,Middlesbrough,1-0,1,0,1,1,1,1,H
1930-03-29,1929,Arsenal,Blackburn Rovers,4-0,4,0,1,1,4,4,H
1930-03-29,1929,Aston Villa,Middlesbrough,4-2,4,2,1,1,6,2,H
1930-03-29,1929,Bolton Wanderers,Leicester City,1-0,1,0,1,1,1,1,H
1930-03-29,1929,Burnley,Manchester United,4-0,4,0,1,1,4,4,H
1930-03-29,1929,Derby County,Huddersfield Town,2-2,2,2,1,1,4,0,D
1930-03-29,1929,Everton,Birmingham City,2-4,2,4,1,1,6,-2,A
1930-03-29,1929,Leeds United,Liverpool,1-1,1,1,1,1,2,0,D
1930-03-29,1929,Manchester City,Sheffield United,2-1,2,1,1,1,3,1,H
1930-03-29,1929,Portsmouth,Newcastle United,2-0,2,0,1,1,2,2,H
1930-03-29,1929,Sheffield Wednesday,West Ham United,2-1,2,1,1,1,3,1,H
1930-03-29,1929,Sunderland,Grimsby Town,2-0,2,0,1,1,2,2,H
1930-04-01,1929,Burnley,Huddersfield Town,1-3,1,3,1,1,4,-2,A
1930-04-02,1929,Arsenal,Liverpool,0-1,0,1,1,1,1,-1,A
1930-04-02,1929,Aston Villa,Grimsby Town,4-1,4,1,1,1,5,3,H
1930-04-02,1929,Newcastle United,Birmingham City,1-1,1,1,1,1,2,0,D
1930-04-05,1929,Birmingham City,Derby County,2-4,2,4,1,1,6,-2,A
1930-04-05,1929,Blackburn Rovers,Aston Villa,2-0,2,0,1,1,2,2,H
1930-04-05,1929,Grimsby Town,Bolton Wanderers,1-1,1,1,1,1,2,0,D
1930-04-05,1929,Huddersfield Town,Manchester City,1-1,1,1,1,1,2,0,D
1930-04-05,1929,Leicester City,Everton,5-4,5,4,1,1,9,1,H
1930-04-05,1929,Liverpool,Sheffield Wednesday,1-3,1,3,1,1,4,-2,A
1930-04-05,1929,Manchester United,Sunderland,2-1,2,1,1,1,3,1,H
1930-04-05,1929,Middlesbrough,Leeds United,1-1,1,1,1,1,2,0,D
1930-04-05,1929,Newcastle United,Arsenal,1-1,1,1,1,1,2,0,D
1930-04-05,1929,Sheffield United,Portsmouth,2-3,2,3,1,1,5,-1,A
1930-04-05,1929,West Ham United,Burnley,1-0,1,0,1,1,1,1,H
1930-04-09,1929,Bolton Wanderers,Newcastle United,1-1,1,1,1,1,2,0,D
1930-04-09,1929,Leeds United,Sheffield Wednesday,3-0,3,0,1,1,3,3,H
1930-04-09,1929,Middlesbrough,Arsenal,1-1,1,1,1,1,2,0,D
1930-04-12,1929,Arsenal,Sheffield United,8-1,8,1,1,1,9,7,H
1930-04-12,1929,Aston Villa,Newcastle United,2-0,2,0,1,1,2,2,H
1930-04-12,1929,Burnley,Liverpool,4-1,4,1,1,1,5,3,H
1930-04-12,1929,Derby County,Leicester City,2-2,2,2,1,1,4,0,D
1930-04-12,1929,Everton,Grimsby Town,2-4,2,4,1,1,6,-2,A
1930-04-12,1929,Leeds United,Blackburn Rovers,4-2,4,2,1,1,6,2,H
1930-04-12,1929,Manchester City,Birmingham City,1-4,1,4,1,1,5,-3,A
1930-04-12,1929,Portsmouth,Huddersfield Town,0-1,0,1,1,1,1,-1,A
1930-04-12,1929,Sheffield Wednesday,Middlesbrough,1-0,1,0,1,1,1,1,H
1930-04-12,1929,Sunderland,West Ham United,4-2,4,2,1,1,6,2,H
1930-04-14,1929,Manchester United,Sheffield Wednesday,2-2,2,2,1,1,4,0,D
1930-04-18,1929,Arsenal,Leicester City,1-1,1,1,1,1,2,0,D
1930-04-18,1929,Bolton Wanderers,Sunderland,3-0,3,0,1,1,3,3,H
1930-04-18,1929,Everton,Burnley,3-0,3,0,1,1,3,3,H
1930-04-18,1929,Grimsby Town,Birmingham City,2-1,2,1,1,1,3,1,H
1930-04-18,1929,Manchester United,Huddersfield Town,1-0,1,0,1,1,1,1,H
1930-04-18,1929,Newcastle United,Liverpool,3-1,3,1,1,1,4,2,H
1930-04-18,1929,Portsmouth,Aston Villa,1-2,1,2,1,1,3,-1,A
1930-04-18,1929,West Ham United,Sheffield United,1-0,1,0,1,1,1,1,H
1930-04-19,1929,Birmingham City,Portsmouth,1-0,1,0,1,1,1,1,H
1930-04-19,1929,Blackburn Rovers,Sheffield Wednesday,0-1,0,1,1,1,1,-1,A
1930-04-19,1929,Grimsby Town,Derby County,2-1,2,1,1,1,3,1,H
1930-04-19,1929,Huddersfield Town,Arsenal,2-2,2,2,1,1,4,0,D
1930-04-19,1929,Leicester City,Manchester City,3-1,3,1,1,1,4,2,H
1930-04-19,1929,Liverpool,Sunderland,0-6,0,6,1,1,6,-6,A
1930-04-19,1929,Manchester United,Everton,3-3,3,3,1,1,6,0,D
1930-04-19,1929,Middlesbrough,Burnley,3-1,3,1,1,1,4,2,H
1930-04-19,1929,Newcastle United,Leeds United,2-1,2,1,1,1,3,1,H
1930-04-19,1929,Sheffield United,Aston Villa,3-3,3,3,1,1,6,0,D
1930-04-19,1929,West Ham United,Bolton Wanderers,5-3,5,3,1,1,8,2,H
1930-04-21,1929,Aston Villa,Portsmouth,0-1,0,1,1,1,1,-1,A
1930-04-21,1929,Derby County,Sheffield Wednesday,4-1,4,1,1,1,5,3,H
1930-04-21,1929,Leicester City,Arsenal,6-6,6,6,1,1,12,0,D
1930-04-21,1929,Liverpool,Newcastle United,0-0,0,0,1,1,0,0,D
1930-04-21,1929,Manchester City,Leeds United,4-1,4,1,1,1,5,3,H
1930-04-21,1929,Middlesbrough,Blackburn Rovers,2-4,2,4,1,1,6,-2,A
1930-04-21,1929,Sunderland,Bolton Wanderers,4-1,4,1,1,1,5,3,H
1930-04-22,1929,Birmingham City,Grimsby Town,0-2,0,2,1,1,2,-2,A
1930-04-22,1929,Huddersfield Town,Manchester United,2-2,2,2,1,1,4,0,D
1930-04-22,1929,Leeds United,Manchester City,3-2,3,2,1,1,5,1,H
1930-04-22,1929,Sheffield Wednesday,Derby County,6-3,6,3,1,1,9,3,H
1930-04-26,1929,Aston Villa,West Ham United,2-3,2,3,1,1,5,-1,A
1930-04-26,1929,Derby County,Newcastle United,3-1,3,1,1,1,4,2,H
1930-04-26,1929,Everton,Sheffield United,3-2,3,2,1,1,5,1,H
1930-04-26,1929,Leeds United,Manchester United,3-1,3,1,1,1,4,2,H
1930-04-26,1929,Manchester City,Blackburn Rovers,1-1,1,1,1,1,2,0,D
1930-04-26,1929,Portsmouth,Middlesbrough,1-1,1,1,1,1,2,0,D
1930-04-26,1929,Sheffield Wednesday,Grimsby Town,1-0,1,0,1,1,1,1,H
1930-04-26,1929,Sunderland,Birmingham City,2-0,2,0,1,1,2,2,H
1930-04-28,1929,Arsenal,Sunderland,0-1,0,1,1,1,1,-1,A
1930-04-28,1929,Huddersfield Town,Everton,1-2,1,2,1,1,3,-1,A
1930-04-28,1929,Sheffield Wednesday,Birmingham City,1-1,1,1,1,1,2,0,D
1930-04-30,1929,Sunderland,Sheffield Wednesday,2-4,2,4,1,1,6,-2,A
1930-05-03,1929,Arsenal,Aston Villa,2-4,2,4,1,1,6,-2,A
1930-05-03,1929,Birmingham City,Leicester City,3-0,3,0,1,1,3,3,H
1930-05-03,1929,Blackburn Rovers,Liverpool,1-0,1,0,1,1,1,1,H
1930-05-03,1929,Burnley,Derby County,6-2,6,2,1,1,8,4,H
1930-05-03,1929,Everton,Sunderland,4-1,4,1,1,1,5,3,H
1930-05-03,1929,Huddersfield Town,Grimsby Town,0-1,0,1,1,1,1,-1,A
1930-05-03,1929,Manchester United,Sheffield United,1-5,1,5,1,1,6,-4,A
1930-05-03,1929,Middlesbrough,Bolton Wanderers,3-1,3,1,1,1,4,2,H
1930-05-03,1929,Newcastle United,West Ham United,1-0,1,0,1,1,1,1,H
1930-05-03,1929,Portsmouth,Leeds United,0-0,0,0,1,1,0,0,D
1930-05-03,1929,Sheffield Wednesday,Manchester City,5-1,5,1,1,1,6,4,H
1930-08-30,1930,Birmingham City,Sheffield United,3-1,3,1,1,1,4,2,H
1930-08-30,1930,Blackpool,Arsenal,1-4,1,4,1,1,5,-3,A
1930-08-30,1930,Bolton Wanderers,Middlesbrough,3-0,3,0,1,1,3,3,H
1930-08-30,1930,Grimsby Town,Chelsea,0-1,0,1,1,1,1,-1,A
1930-08-30,1930,Leeds United,Portsmouth,2-2,2,2,1,1,4,0,D
1930-08-30,1930,Leicester City,Derby County,1-1,1,1,1,1,2,0,D
1930-08-30,1930,Liverpool,Blackburn Rovers,2-1,2,1,1,1,3,1,H
1930-08-30,1930,Manchester United,Aston Villa,3-4,3,4,1,1,7,-1,A
1930-08-30,1930,Sheffield Wednesday,Newcastle United,2-1,2,1,1,1,3,1,H
1930-08-30,1930,Sunderland,Manchester City,3-3,3,3,1,1,6,0,D
1930-08-30,1930,West Ham United,Huddersfield Town,2-1,2,1,1,1,3,1,H
1930-09-01,1930,Aston Villa,Sheffield Wednesday,2-0,2,0,1,1,2,2,H
1930-09-01,1930,Blackburn Rovers,Portsmouth,1-2,1,2,1,1,3,-1,A
1930-09-01,1930,Bolton Wanderers,Arsenal,1-4,1,4,1,1,5,-3,A
1930-09-01,1930,Huddersfield Town,Grimsby Town,2-2,2,2,1,1,4,0,D
1930-09-01,1930,Leicester City,Birmingham City,2-1,2,1,1,1,3,1,H
1930-09-01,1930,West Ham United,Liverpool,7-0,7,0,1,1,7,7,H
1930-09-03,1930,Derby County,Leeds United,4-1,4,1,1,1,5,3,H
1930-09-03,1930,Manchester City,Blackpool,2-4,2,4,1,1,6,-2,A
1930-09-03,1930,Middlesbrough,Manchester United,3-1,3,1,1,1,4,2,H
1930-09-03,1930,Newcastle United,Chelsea,1-0,1,0,1,1,1,1,H
1930-09-03,1930,Sheffield United,Sunderland,3-3,3,3,1,1,6,0,D
1930-09-06,1930,Arsenal,Leeds United,3-1,3,1,1,1,4,2,H
1930-09-06,1930,Aston Villa,West Ham United,6-1,6,1,1,1,7,5,H
1930-09-06,1930,Blackburn Rovers,Blackpool,5-0,5,0,1,1,5,5,H
1930-09-06,1930,Chelsea,Manchester United,6-2,6,2,1,1,8,4,H
1930-09-06,1930,Derby County,Birmingham City,0-0,0,0,1,1,0,0,D
1930-09-06,1930,Huddersfield Town,Bolton Wanderers,3-2,3,2,1,1,5,1,H
1930-09-06,1930,Manchester City,Leicester City,0-2,0,2,1,1,2,-2,A
1930-09-06,1930,Middlesbrough,Liverpool,3-3,3,3,1,1,6,0,D
1930-09-06,1930,Newcastle United,Grimsby Town,1-2,1,2,1,1,3,-1,A
1930-09-06,1930,Portsmouth,Sunderland,1-1,1,1,1,1,2,0,D
1930-09-06,1930,Sheffield United,Sheffield Wednesday,1-1,1,1,1,1,2,0,D
1930-09-08,1930,Leeds United,Manchester City,4-2,4,2,1,1,6,2,H
1930-09-08,1930,Leicester City,Sheffield United,2-2,2,2,1,1,4,0,D
1930-09-08,1930,Sheffield Wednesday,Chelsea,1-1,1,1,1,1,2,0,D
1930-09-08,1930,West Ham United,Middlesbrough,0-3,0,3,1,1,3,-3,A
1930-09-09,1930,Grimsby Town,Aston Villa,1-2,1,2,1,1,3,-1,A
1930-09-10,1930,Arsenal,Blackburn Rovers,3-2,3,2,1,1,5,1,H
1930-09-10,1930,Birmingham City,Newcastle United,1-1,1,1,1,1,2,0,D
1930-09-10,1930,Blackpool,Portsmouth,2-2,2,2,1,1,4,0,D
1930-09-10,1930,Liverpool,Bolton Wanderers,7-2,7,2,1,1,9,5,H
1930-09-10,1930,Manchester United,Huddersfield Town,0-6,0,6,1,1,6,-6,A
1930-09-10,1930,Sunderland,Derby County,1-3,1,3,1,1,4,-2,A
1930-09-13,1930,Birmingham City,Manchester City,3-2,3,2,1,1,5,1,H
1930-09-13,1930,Blackpool,Middlesbrough,3-2,3,2,1,1,5,1,H
1930-09-13,1930,Bolton Wanderers,Aston Villa,1-1,1,1,1,1,2,0,D
1930-09-13,1930,Grimsby Town,Sheffield Wednesday,2-3,2,3,1,1,5,-1,A
1930-09-13,1930,Leeds United,Blackburn Rovers,4-2,4,2,1,1,6,2,H
1930-09-13,1930,Leicester City,Portsmouth,3-1,3,1,1,1,4,2,H
1930-09-13,1930,Liverpool,Huddersfield Town,1-4,1,4,1,1,5,-3,A
1930-09-13,1930,Manchester United,Newcastle United,4-7,4,7,1,1,11,-3,A
1930-09-13,1930,Sheffield United,Derby County,3-3,3,3,1,1,6,0,D
1930-09-13,1930,Sunderland,Arsenal,1-4,1,4,1,1,5,-3,A
1930-09-13,1930,West Ham United,Chelsea,4-1,4,1,1,1,5,3,H
1930-09-15,1930,Aston Villa,Grimsby Town,2-0,2,0,1,1,2,2,H
1930-09-15,1930,Blackburn Rovers,Arsenal,2-2,2,2,1,1,4,0,D
1930-09-15,1930,Chelsea,Sheffield Wednesday,0-0,0,0,1,1,0,0,D
1930-09-15,1930,Huddersfield Town,Manchester United,3-0,3,0,1,1,3,3,H
1930-09-17,1930,Derby County,Sunderland,4-1,4,1,1,1,5,3,H
1930-09-17,1930,Manchester City,Leeds United,1-0,1,0,1,1,1,1,H
1930-09-17,1930,Middlesbrough,West Ham United,2-2,2,2,1,1,4,0,D
1930-09-17,1930,Newcastle United,Birmingham City,2-2,2,2,1,1,4,0,D
1930-09-17,1930,Portsmouth,Blackpool,4-3,4,3,1,1,7,1,H
1930-09-20,1930,Arsenal,Leicester City,4-1,4,1,1,1,5,3,H
1930-09-20,1930,Aston Villa,Liverpool,4-2,4,2,1,1,6,2,H
1930-09-20,1930,Blackburn Rovers,Sunderland,3-0,3,0,1,1,3,3,H
1930-09-20,1930,Blackpool,Leeds United,3-7,3,7,1,1,10,-4,A
1930-09-20,1930,Chelsea,Bolton Wanderers,0-1,0,1,1,1,1,-1,A
1930-09-20,1930,Derby County,Grimsby Town,1-0,1,0,1,1,1,1,H
1930-09-20,1930,Huddersfield Town,Middlesbrough,2-2,2,2,1,1,4,0,D
1930-09-20,1930,Manchester City,Sheffield United,0-4,0,4,1,1,4,-4,A
1930-09-20,1930,Newcastle United,West Ham United,4-2,4,2,1,1,6,2,H
1930-09-20,1930,Portsmouth,Birmingham City,2-2,2,2,1,1,4,0,D
1930-09-20,1930,Sheffield Wednesday,Manchester United,3-0,3,0,1,1,3,3,H
1930-09-24,1930,Sheffield United,Leicester City,0-2,0,2,1,1,2,-2,A
1930-09-27,1930,Birmingham City,Arsenal,2-4,2,4,1,1,6,-2,A
1930-09-27,1930,Bolton Wanderers,Newcastle United,0-3,0,3,1,1,3,-3,A
1930-09-27,1930,Derby County,Manchester City,1-1,1,1,1,1,2,0,D
1930-09-27,1930,Leeds United,Huddersfield Town,1-2,1,2,1,1,3,-1,A
1930-09-27,1930,Leicester City,Blackburn Rovers,3-1,3,1,1,1,4,2,H
1930-09-27,1930,Liverpool,Chelsea,3-1,3,1,1,1,4,2,H
1930-09-27,1930,Manchester United,Grimsby Town,0-2,0,2,1,1,2,-2,A
1930-09-27,1930,Middlesbrough,Aston Villa,3-1,3,1,1,1,4,2,H
1930-09-27,1930,Sheffield United,Portsmouth,3-1,3,1,1,1,4,2,H
1930-09-27,1930,Sunderland,Blackpool,2-4,2,4,1,1,6,-2,A
1930-09-27,1930,West Ham United,Sheffield Wednesday,3-3,3,3,1,1,6,0,D
1930-10-04,1930,Arsenal,Sheffield United,1-1,1,1,1,1,2,0,D
1930-10-04,1930,Aston Villa,Huddersfield Town,6-1,6,1,1,1,7,5,H
1930-10-04,1930,Blackburn Rovers,Birmingham City,2-1,2,1,1,1,3,1,H
1930-10-04,1930,Blackpool,Leicester City,5-4,5,4,1,1,9,1,H
1930-10-04,1930,Chelsea,Middlesbrough,4-0,4,0,1,1,4,4,H
1930-10-04,1930,Grimsby Town,West Ham United,4-0,4,0,1,1,4,4,H
1930-10-04,1930,Leeds United,Sunderland,0-3,0,3,1,1,3,-3,A
1930-10-04,1930,Manchester City,Manchester United,4-1,4,1,1,1,5,3,H
1930-10-04,1930,Newcastle United,Liverpool,0-4,0,4,1,1,4,-4,A
1930-10-04,1930,Portsmouth,Derby County,2-0,2,0,1,1,2,2,H
1930-10-04,1930,Sheffield Wednesday,Bolton Wanderers,1-0,1,0,1,1,1,1,H
1930-10-11,1930,Birmingham City,Blackpool,1-1,1,1,1,1,2,0,D
1930-10-11,1930,Bolton Wanderers,Grimsby Town,4-2,4,2,1,1,6,2,H
1930-10-11,1930,Derby County,Arsenal,4-2,4,2,1,1,6,2,H
1930-10-11,1930,Huddersfield Town,Chelsea,1-1,1,1,1,1,2,0,D
1930-10-11,1930,Leicester City,Leeds United,4-0,4,0,1,1,4,4,H
1930-10-11,1930,Liverpool,Sheffield Wednesday,1-2,1,2,1,1,3,-1,A
1930-10-11,1930,Manchester City,Portsmouth,1-3,1,3,1,1,4,-2,A
1930-10-11,1930,Middlesbrough,Newcastle United,3-1,3,1,1,1,4,2,H
1930-10-11,1930,Sheffield United,Blackburn Rovers,1-1,1,1,1,1,2,0,D
1930-10-11,1930,Sunderland,Aston Villa,1-1,1,1,1,1,2,0,D
1930-10-11,1930,West Ham United,Manchester United,5-1,5,1,1,1,6,4,H
1930-10-18,1930,Aston Villa,Birmingham City,1-1,1,1,1,1,2,0,D
1930-10-18,1930,Bolton Wanderers,Blackpool,1-0,1,0,1,1,1,1,H
1930-10-18,1930,Chelsea,Sheffield United,1-0,1,0,1,1,1,1,H
1930-10-18,1930,Grimsby Town,Portsmouth,0-3,0,3,1,1,3,-3,A
1930-10-18,1930,Huddersfield Town,Leicester City,4-1,4,1,1,1,5,3,H
1930-10-18,1930,Liverpool,Leeds United,2-0,2,0,1,1,2,2,H
1930-10-18,1930,Manchester United,Arsenal,1-2,1,2,1,1,3,-1,A
1930-10-18,1930,Middlesbrough,Sunderland,1-0,1,0,1,1,1,1,H
1930-10-18,1930,Newcastle United,Derby County,2-5,2,5,1,1,7,-3,A
1930-10-18,1930,Sheffield Wednesday,Manchester City,1-1,1,1,1,1,2,0,D
1930-10-18,1930,West Ham United,Blackburn Rovers,4-3,4,3,1,1,7,1,H
1930-10-25,1930,Arsenal,West Ham United,1-1,1,1,1,1,2,0,D
1930-10-25,1930,Birmingham City,Chelsea,6-2,6,2,1,1,8,4,H
1930-10-25,1930,Blackburn Rovers,Bolton Wanderers,2-2,2,2,1,1,4,0,D
1930-10-25,1930,Blackpool,Liverpool,1-3,1,3,1,1,4,-2,A
1930-10-25,1930,Derby County,Sheffield Wednesday,2-3,2,3,1,1,5,-1,A
1930-10-25,1930,Leeds United,Middlesbrough,7-0,7,0,1,1,7,7,H
1930-10-25,1930,Leicester City,Aston Villa,4-1,4,1,1,1,5,3,H
1930-10-25,1930,Manchester City,Grimsby Town,1-0,1,0,1,1,1,1,H
1930-10-25,1930,Portsmouth,Manchester United,4-1,4,1,1,1,5,3,H
1930-10-25,1930,Sheffield United,Newcastle United,3-1,3,1,1,1,4,2,H
1930-10-25,1930,Sunderland,Huddersfield Town,4-2,4,2,1,1,6,2,H
1930-11-01,1930,Aston Villa,Blackburn Rovers,5-2,5,2,1,1,7,3,H
1930-11-01,1930,Bolton Wanderers,Derby County,1-2,1,2,1,1,3,-1,A
1930-11-01,1930,Chelsea,Blackpool,3-0,3,0,1,1,3,3,H
1930-11-01,1930,Grimsby Town,Leicester City,8-2,8,2,1,1,10,6,H
1930-11-01,1930,Huddersfield Town,Arsenal,1-1,1,1,1,1,2,0,D
1930-11-01,1930,Liverpool,Manchester City,0-2,0,2,1,1,2,-2,A
1930-11-01,1930,Manchester United,Birmingham City,2-0,2,0,1,1,2,2,H
1930-11-01,1930,Middlesbrough,Portsmouth,0-1,0,1,1,1,1,-1,A
1930-11-01,1930,Newcastle United,Leeds United,4-1,4,1,1,1,5,3,H
1930-11-01,1930,Sheffield Wednesday,Sunderland,7-2,7,2,1,1,9,5,H
1930-11-01,1930,West Ham United,Sheffield United,4-1,4,1,1,1,5,3,H
1930-11-08,1930,Arsenal,Aston Villa,5-2,5,2,1,1,7,3,H
1930-11-08,1930,Birmingham City,West Ham United,0-2,0,2,1,1,2,-2,A
1930-11-08,1930,Blackburn Rovers,Chelsea,2-0,2,0,1,1,2,2,H
1930-11-08,1930,Blackpool,Newcastle United,0-0,0,0,1,1,0,0,D
1930-11-08,1930,Derby County,Liverpool,2-2,2,2,1,1,4,0,D
1930-11-08,1930,Leeds United,Sheffield Wednesday,2-3,2,3,1,1,5,-1,A
1930-11-08,1930,Leicester City,Manchester United,5-4,5,4,1,1,9,1,H
1930-11-08,1930,Manchester City,Middlesbrough,4-2,4,2,1,1,6,2,H
1930-11-08,1930,Portsmouth,Huddersfield Town,2-2,2,2,1,1,4,0,D
1930-11-08,1930,Sheffield United,Bolton Wanderers,2-0,2,0,1,1,2,2,H
1930-11-08,1930,Sunderland,Grimsby Town,3-2,3,2,1,1,5,1,H
1930-11-15,1930,Aston Villa,Derby County,4-6,4,6,1,1,10,-2,A
1930-11-15,1930,Bolton Wanderers,Sunderland,2-2,2,2,1,1,4,0,D
1930-11-15,1930,Chelsea,Manchester City,2-0,2,0,1,1,2,2,H
1930-11-15,1930,Grimsby Town,Blackburn Rovers,2-0,2,0,1,1,2,2,H
1930-11-15,1930,Huddersfield Town,Sheffield United,1-1,1,1,1,1,2,0,D
1930-11-15,1930,Liverpool,Leicester City,3-1,3,1,1,1,4,2,H
1930-11-15,1930,Manchester United,Blackpool,0-0,0,0,1,1,0,0,D
1930-11-15,1930,Middlesbrough,Birmingham City,1-1,1,1,1,1,2,0,D
1930-11-15,1930,Newcastle United,Portsmouth,4-7,4,7,1,1,11,-3,A
1930-11-15,1930,Sheffield Wednesday,Arsenal,1-2,1,2,1,1,3,-1,A
1930-11-15,1930,West Ham United,Leeds United,1-1,1,1,1,1,2,0,D
1930-11-22,1930,Arsenal,Middlesbrough,5-3,5,3,1,1,8,2,H
1930-11-22,1930,Birmingham City,Grimsby Town,4-1,4,1,1,1,5,3,H
1930-11-22,1930,Blackburn Rovers,Huddersfield Town,5-3,5,3,1,1,8,2,H
1930-11-22,1930,Blackpool,Aston Villa,2-2,2,2,1,1,4,0,D
1930-11-22,1930,Derby County,West Ham United,1-1,1,1,1,1,2,0,D
1930-11-22,1930,Leeds United,Chelsea,2-3,2,3,1,1,5,-1,A
1930-11-22,1930,Leicester City,Sheffield Wednesday,2-5,2,5,1,1,7,-3,A
1930-11-22,1930,Manchester City,Bolton Wanderers,3-0,3,0,1,1,3,3,H
1930-11-22,1930,Portsmouth,Liverpool,4-0,4,0,1,1,4,4,H
1930-11-22,1930,Sheffield United,Manchester United,3-1,3,1,1,1,4,2,H
1930-11-22,1930,Sunderland,Newcastle United,5-0,5,0,1,1,5,5,H
1930-11-29,1930,Bolton Wanderers,Birmingham City,2-0,2,0,1,1,2,2,H
1930-11-29,1930,Chelsea,Arsenal,1-5,1,5,1,1,6,-4,A
1930-11-29,1930,Grimsby Town,Leeds United,2-0,2,0,1,1,2,2,H
1930-11-29,1930,Huddersfield Town,Manchester City,1-1,1,1,1,1,2,0,D
1930-11-29,1930,Liverpool,Sheffield United,6-1,6,1,1,1,7,5,H
1930-11-29,1930,Manchester United,Sunderland,1-1,1,1,1,1,2,0,D
1930-11-29,1930,Middlesbrough,Derby County,4-1,4,1,1,1,5,3,H
1930-11-29,1930,Newcastle United,Blackburn Rovers,2-3,2,3,1,1,5,-1,A
1930-11-29,1930,Sheffield Wednesday,Blackpool,7-1,7,1,1,1,8,6,H
1930-11-29,1930,West Ham United,Leicester City,2-0,2,0,1,1,2,2,H
1930-12-03,1930,Aston Villa,Portsmouth,2-2,2,2,1,1,4,0,D
1930-12-06,1930,Birmingham City,Huddersfield Town,2-0,2,0,1,1,2,2,H
1930-12-06,1930,Blackburn Rovers,Manchester United,4-1,4,1,1,1,5,3,H
1930-12-06,1930,Blackpool,West Ham United,1-3,1,3,1,1,4,-2,A
1930-12-06,1930,Derby County,Chelsea,6-2,6,2,1,1,8,4,H
1930-12-06,1930,Leeds United,Bolton Wanderers,3-1,3,1,1,1,4,2,H
1930-12-06,1930,Leicester City,Middlesbrough,0-3,0,3,1,1,3,-3,A
1930-12-06,1930,Manchester City,Newcastle United,2-0,2,0,1,1,2,2,H
1930-12-06,1930,Portsmouth,Sheffield Wednesday,2-4,2,4,1,1,6,-2,A
1930-12-06,1930,Sheffield United,Aston Villa,3-4,3,4,1,1,7,-1,A
1930-12-06,1930,Sunderland,Liverpool,6-5,6,5,1,1,11,1,H
1930-12-13,1930,Aston Villa,Leeds United,4-3,4,3,1,1,7,1,H
1930-12-13,1930,Bolton Wanderers,Portsmouth,3-1,3,1,1,1,4,2,H
1930-12-13,1930,Chelsea,Sunderland,5-0,5,0,1,1,5,5,H
1930-12-13,1930,Grimsby Town,Sheffield United,2-1,2,1,1,1,3,1,H
1930-12-13,1930,Huddersfield Town,Blackpool,10-1,10,1,1,1,11,9,H
1930-12-13,1930,Liverpool,Arsenal,1-1,1,1,1,1,2,0,D
1930-12-13,1930,Manchester United,Derby County,2-1,2,1,1,1,3,1,H
1930-12-13,1930,Middlesbrough,Blackburn Rovers,4-1,4,1,1,1,5,3,H
1930-12-13,1930,Newcastle United,Leicester City,5-2,5,2,1,1,7,3,H
1930-12-13,1930,Sheffield Wednesday,Birmingham City,9-1,9,1,1,1,10,8,H
1930-12-13,1930,West Ham United,Manchester City,2-0,2,0,1,1,2,2,H
1930-12-20,1930,Arsenal,Newcastle United,1-2,1,2,1,1,3,-1,A
1930-12-20,1930,Birmingham City,Liverpool,2-0,2,0,1,1,2,2,H
1930-12-20,1930,Blackburn Rovers,Sheffield Wednesday,5-2,5,2,1,1,7,3,H
1930-12-20,1930,Blackpool,Grimsby Town,3-1,3,1,1,1,4,2,H
1930-12-20,1930,Derby County,Huddersfield Town,4-1,4,1,1,1,5,3,H
1930-12-20,1930,Leeds United,Manchester United,5-0,5,0,1,1,5,5,H
1930-12-20,1930,Leicester City,Bolton Wanderers,2-1,2,1,1,1,3,1,H
1930-12-20,1930,Manchester City,Aston Villa,3-1,3,1,1,1,4,2,H
1930-12-20,1930,Portsmouth,Chelsea,1-1,1,1,1,1,2,0,D
1930-12-20,1930,Sheffield United,Middlesbrough,4-2,4,2,1,1,6,2,H
1930-12-20,1930,Sunderland,West Ham United,6-1,6,1,1,1,7,5,H
1930-12-25,1930,Birmingham City,Leeds United,0-1,0,1,1,1,1,-1,A
1930-12-25,1930,Blackburn Rovers,Derby County,1-0,1,0,1,1,1,1,H
1930-12-25,1930,Blackpool,Sheffield United,2-1,2,1,1,1,3,1,H
1930-12-25,1930,Bolton Wanderers,Manchester United,3-1,3,1,1,1,4,2,H
1930-12-25,1930,Chelsea,Aston Villa,0-2,0,2,1,1,2,-2,A
1930-12-25,1930,Grimsby Town,Liverpool,0-0,0,0,1,1,0,0,D
1930-12-25,1930,Manchester City,Arsenal,1-4,1,4,1,1,5,-3,A
1930-12-25,1930,Sunderland,Leicester City,2-5,2,5,1,1,7,-3,A
1930-12-25,1930,West Ham United,Portsmouth,4-3,4,3,1,1,7,1,H
1930-12-26,1930,Arsenal,Manchester City,3-1,3,1,1,1,4,2,H
1930-12-26,1930,Aston Villa,Chelsea,3-3,3,3,1,1,6,0,D
1930-12-26,1930,Derby County,Blackburn Rovers,1-1,1,1,1,1,2,0,D
1930-12-26,1930,Huddersfield Town,Newcastle United,0-3,0,3,1,1,3,-3,A
1930-12-26,1930,Leeds United,Birmingham City,3-1,3,1,1,1,4,2,H
1930-12-26,1930,Leicester City,Sunderland,1-1,1,1,1,1,2,0,D
1930-12-26,1930,Liverpool,Grimsby Town,1-1,1,1,1,1,2,0,D
1930-12-26,1930,Manchester United,Bolton Wanderers,1-1,1,1,1,1,2,0,D
1930-12-26,1930,Middlesbrough,Sheffield Wednesday,2-0,2,0,1,1,2,2,H
1930-12-26,1930,Portsmouth,West Ham United,2-0,2,0,1,1,2,2,H
1930-12-26,1930,Sheffield United,Blackpool,5-1,5,1,1,1,6,4,H
1930-12-27,1930,Arsenal,Blackpool,7-1,7,1,1,1,8,6,H
1930-12-27,1930,Aston Villa,Manchester United,7-0,7,0,1,1,7,7,H
1930-12-27,1930,Blackburn Rovers,Liverpool,3-3,3,3,1,1,6,0,D
1930-12-27,1930,Chelsea,Grimsby Town,5-0,5,0,1,1,5,5,H
1930-12-27,1930,Derby County,Leicester City,1-0,1,0,1,1,1,1,H
1930-12-27,1930,Huddersfield Town,West Ham United,2-0,2,0,1,1,2,2,H
1930-12-27,1930,Manchester City,Sunderland,2-0,2,0,1,1,2,2,H
1930-12-27,1930,Middlesbrough,Bolton Wanderers,3-0,3,0,1,1,3,3,H
1930-12-27,1930,Newcastle United,Sheffield Wednesday,1-2,1,2,1,1,3,-1,A
1930-12-27,1930,Portsmouth,Leeds United,1-1,1,1,1,1,2,0,D
1930-12-27,1930,Sheffield United,Birmingham City,3-1,3,1,1,1,4,2,H
1930-12-29,1930,Sheffield Wednesday,Middlesbrough,3-2,3,2,1,1,5,1,H
1931-01-01,1930,Blackburn Rovers,Manchester City,0-1,0,1,1,1,1,-1,A
1931-01-01,1930,Manchester United,Leeds United,0-0,0,0,1,1,0,0,D
1931-01-01,1930,Middlesbrough,Grimsby Town,2-1,2,1,1,1,3,1,H
1931-01-01,1930,Newcastle United,Aston Villa,2-0,2,0,1,1,2,2,H
1931-01-01,1930,Sheffield Wednesday,Huddersfield Town,2-1,2,1,1,1,3,1,H
1931-01-03,1930,Birmingham City,Derby County,1-2,1,2,1,1,3,-1,A
1931-01-03,1930,Blackpool,Blackburn Rovers,1-1,1,1,1,1,2,0,D
1931-01-03,1930,Bolton Wanderers,Huddersfield Town,1-0,1,0,1,1,1,1,H
1931-01-03,1930,Grimsby Town,Newcastle United,2-2,2,2,1,1,4,0,D
1931-01-03,1930,Leicester City,Manchester City,3-2,3,2,1,1,5,1,H
1931-01-03,1930,Liverpool,Middlesbrough,3-1,3,1,1,1,4,2,H
1931-01-03,1930,Manchester United,Chelsea,1-0,1,0,1,1,1,1,H
1931-01-03,1930,Sheffield Wednesday,Sheffield United,1-3,1,3,1,1,4,-2,A
1931-01-03,1930,Sunderland,Portsmouth,0-0,0,0,1,1,0,0,D
1931-01-03,1930,West Ham United,Aston Villa,5-5,5,5,1,1,10,0,D
1931-01-14,1930,Bolton Wanderers,Liverpool,2-0,2,0,1,1,2,2,H
1931-01-17,1930,Arsenal,Sunderland,1-3,1,3,1,1,4,-2,A
1931-01-17,1930,Aston Villa,Bolton Wanderers,3-1,3,1,1,1,4,2,H
1931-01-17,1930,Blackburn Rovers,Leeds United,3-1,3,1,1,1,4,2,H
1931-01-17,1930,Chelsea,West Ham United,2-1,2,1,1,1,3,1,H
1931-01-17,1930,Derby County,Sheffield United,4-3,4,3,1,1,7,1,H
1931-01-17,1930,Huddersfield Town,Liverpool,2-1,2,1,1,1,3,1,H
1931-01-17,1930,Manchester City,Birmingham City,4-2,4,2,1,1,6,2,H
1931-01-17,1930,Middlesbrough,Blackpool,5-1,5,1,1,1,6,4,H
1931-01-17,1930,Newcastle United,Manchester United,4-3,4,3,1,1,7,1,H
1931-01-17,1930,Portsmouth,Leicester City,2-1,2,1,1,1,3,1,H
1931-01-17,1930,Sheffield Wednesday,Grimsby Town,4-1,4,1,1,1,5,3,H
1931-01-24,1930,Liverpool,Aston Villa,1-1,1,1,1,1,2,0,D
1931-01-24,1930,Middlesbrough,Huddersfield Town,2-3,2,3,1,1,5,-1,A
1931-01-26,1930,West Ham United,Newcastle United,3-2,3,2,1,1,5,1,H
1931-01-28,1930,Arsenal,Grimsby Town,9-1,9,1,1,1,10,8,H
1931-01-28,1930,Birmingham City,Portsmouth,2-1,2,1,1,1,3,1,H
1931-01-28,1930,Leeds United,Blackpool,2-2,2,2,1,1,4,0,D
1931-01-28,1930,Manchester United,Sheffield Wednesday,4-1,4,1,1,1,5,3,H
1931-01-28,1930,Sheffield United,Manchester City,2-2,2,2,1,1,4,0,D
1931-01-31,1930,Arsenal,Birmingham City,1-1,1,1,1,1,2,0,D
1931-01-31,1930,Aston Villa,Middlesbrough,8-1,8,1,1,1,9,7,H
1931-01-31,1930,Blackpool,Sunderland,3-1,3,1,1,1,4,2,H
1931-01-31,1930,Chelsea,Liverpool,2-2,2,2,1,1,4,0,D
1931-01-31,1930,Grimsby Town,Manchester United,2-1,2,1,1,1,3,1,H
1931-01-31,1930,Huddersfield Town,Leeds United,3-0,3,0,1,1,3,3,H
1931-01-31,1930,Manchester City,Derby County,4-3,4,3,1,1,7,1,H
1931-01-31,1930,Newcastle United,Bolton Wanderers,4-0,4,0,1,1,4,4,H
1931-01-31,1930,Portsmouth,Sheffield United,2-3,2,3,1,1,5,-1,A
1931-01-31,1930,Sheffield Wednesday,West Ham United,5-3,5,3,1,1,8,2,H
1931-02-03,1930,Grimsby Town,Derby County,5-3,5,3,1,1,8,2,H
1931-02-04,1930,Bolton Wanderers,Chelsea,1-1,1,1,1,1,2,0,D
1931-02-04,1930,Sunderland,Blackburn Rovers,8-2,8,2,1,1,10,6,H
1931-02-05,1930,Leicester City,Arsenal,2-7,2,7,1,1,9,-5,A
1931-02-07,1930,Birmingham City,Blackburn Rovers,4-1,4,1,1,1,5,3,H
1931-02-07,1930,Bolton Wanderers,Sheffield Wednesday,2-2,2,2,1,1,4,0,D
1931-02-07,1930,Derby County,Portsmouth,5-1,5,1,1,1,6,4,H
1931-02-07,1930,Huddersfield Town,Aston Villa,1-6,1,6,1,1,7,-5,A
1931-02-07,1930,Leicester City,Blackpool,6-0,6,0,1,1,6,6,H
1931-02-07,1930,Liverpool,Newcastle United,4-2,4,2,1,1,6,2,H
1931-02-07,1930,Manchester United,Manchester City,1-3,1,3,1,1,4,-2,A
1931-02-07,1930,Middlesbrough,Chelsea,2-2,2,2,1,1,4,0,D
1931-02-07,1930,Sheffield United,Arsenal,1-1,1,1,1,1,2,0,D
1931-02-07,1930,Sunderland,Leeds United,4-0,4,0,1,1,4,4,H
1931-02-07,1930,West Ham United,Grimsby Town,3-4,3,4,1,1,7,-1,A
1931-02-14,1930,Arsenal,Derby County,6-3,6,3,1,1,9,3,H
1931-02-14,1930,Manchester United,West Ham United,1-0,1,0,1,1,1,1,H
1931-02-14,1930,Newcastle United,Middlesbrough,0-5,0,5,1,1,5,-5,A
1931-02-14,1930,Sheffield Wednesday,Liverpool,3-5,3,5,1,1,8,-2,A
1931-02-17,1930,Grimsby Town,Bolton Wanderers,4-1,4,1,1,1,5,3,H
1931-02-18,1930,Aston Villa,Sunderland,4-2,4,2,1,1,6,2,H
1931-02-18,1930,Blackpool,Birmingham City,0-1,0,1,1,1,1,-1,A
1931-02-18,1930,Chelsea,Huddersfield Town,1-2,1,2,1,1,3,-1,A
1931-02-18,1930,Leeds United,Leicester City,1-3,1,3,1,1,4,-2,A
1931-02-18,1930,Portsmouth,Manchester City,1-1,1,1,1,1,2,0,D
1931-02-19,1930,Blackburn Rovers,Sheffield United,2-1,2,1,1,1,3,1,H
1931-02-21,1930,Arsenal,Manchester United,4-1,4,1,1,1,5,3,H
1931-02-21,1930,Birmingham City,Aston Villa,0-4,0,4,1,1,4,-4,A
1931-02-21,1930,Blackburn Rovers,West Ham United,1-0,1,0,1,1,1,1,H
1931-02-21,1930,Blackpool,Bolton Wanderers,3-3,3,3,1,1,6,0,D
1931-02-21,1930,Derby County,Newcastle United,1-5,1,5,1,1,6,-4,A
1931-02-21,1930,Leeds United,Liverpool,1-2,1,2,1,1,3,-1,A
1931-02-21,1930,Leicester City,Huddersfield Town,1-2,1,2,1,1,3,-1,A
1931-02-21,1930,Manchester City,Sheffield Wednesday,2-0,2,0,1,1,2,2,H
1931-02-21,1930,Portsmouth,Grimsby Town,4-3,4,3,1,1,7,1,H
1931-02-21,1930,Sheffield United,Chelsea,4-0,4,0,1,1,4,4,H
1931-02-21,1930,Sunderland,Middlesbrough,1-1,1,1,1,1,2,0,D
1931-02-28,1930,Aston Villa,Leicester City,4-2,4,2,1,1,6,2,H
1931-02-28,1930,Bolton Wanderers,Blackburn Rovers,1-1,1,1,1,1,2,0,D
1931-02-28,1930,Grimsby Town,Manchester City,3-5,3,5,1,1,8,-2,A
1931-02-28,1930,Liverpool,Blackpool,5-2,5,2,1,1,7,3,H
1931-02-28,1930,Middlesbrough,Leeds United,5-0,5,0,1,1,5,5,H
1931-02-28,1930,Newcastle United,Sheffield United,1-0,1,0,1,1,1,1,H
1931-02-28,1930,West Ham United,Arsenal,2-4,2,4,1,1,6,-2,A
1931-03-02,1930,Blackburn Rovers,Leicester City,3-0,3,0,1,1,3,3,H
1931-03-07,1930,Arsenal,Huddersfield Town,0-0,0,0,1,1,0,0,D
1931-03-07,1930,Birmingham City,Manchester United,0-0,0,0,1,1,0,0,D
1931-03-07,1930,Blackburn Rovers,Aston Villa,0-2,0,2,1,1,2,-2,A
1931-03-07,1930,Blackpool,Chelsea,2-1,2,1,1,1,3,1,H
1931-03-07,1930,Derby County,Bolton Wanderers,4-1,4,1,1,1,5,3,H
1931-03-07,1930,Leeds United,Newcastle United,1-0,1,0,1,1,1,1,H
1931-03-07,1930,Leicester City,Grimsby Town,0-1,0,1,1,1,1,-1,A
1931-03-07,1930,Manchester City,Liverpool,1-1,1,1,1,1,2,0,D
1931-03-07,1930,Portsmouth,Middlesbrough,1-0,1,0,1,1,1,1,H
1931-03-07,1930,Sheffield United,West Ham United,1-2,1,2,1,1,3,-1,A
1931-03-07,1930,Sunderland,Sheffield Wednesday,5-1,5,1,1,1,6,4,H
1931-03-11,1930,Leeds United,Arsenal,1-2,1,2,1,1,3,-1,A
1931-03-14,1930,Aston Villa,Arsenal,5-1,5,1,1,1,6,4,H
1931-03-14,1930,Bolton Wanderers,Sheffield United,6-2,6,2,1,1,8,4,H
1931-03-14,1930,Chelsea,Blackburn Rovers,3-2,3,2,1,1,5,1,H
1931-03-14,1930,Huddersfield Town,Portsmouth,1-3,1,3,1,1,4,-2,A
1931-03-14,1930,Liverpool,Derby County,0-0,0,0,1,1,0,0,D
1931-03-14,1930,Middlesbrough,Manchester City,4-1,4,1,1,1,5,3,H
1931-03-14,1930,Newcastle United,Blackpool,0-2,0,2,1,1,2,-2,A
1931-03-14,1930,Sheffield Wednesday,Leeds United,2-1,2,1,1,1,3,1,H
1931-03-16,1930,Huddersfield Town,Sunderland,2-0,2,0,1,1,2,2,H
1931-03-16,1930,Manchester United,Portsmouth,0-1,0,1,1,1,1,-1,A
1931-03-16,1930,West Ham United,Birmingham City,1-2,1,2,1,1,3,-1,A
1931-03-21,1930,Arsenal,Sheffield Wednesday,2-0,2,0,1,1,2,2,H
1931-03-21,1930,Birmingham City,Middlesbrough,1-2,1,2,1,1,3,-1,A
1931-03-21,1930,Blackburn Rovers,Grimsby Town,5-2,5,2,1,1,7,3,H
1931-03-21,1930,Blackpool,Manchester United,5-1,5,1,1,1,6,4,H
1931-03-21,1930,Derby County,Aston Villa,1-1,1,1,1,1,2,0,D
1931-03-21,1930,Leeds United,West Ham United,3-0,3,0,1,1,3,3,H
1931-03-21,1930,Leicester City,Liverpool,3-2,3,2,1,1,5,1,H
1931-03-21,1930,Manchester City,Chelsea,2-0,2,0,1,1,2,2,H
1931-03-21,1930,Portsmouth,Newcastle United,1-2,1,2,1,1,3,-1,A
1931-03-21,1930,Sheffield United,Huddersfield Town,0-2,0,2,1,1,2,-2,A
1931-03-21,1930,Sunderland,Bolton Wanderers,3-1,3,1,1,1,4,2,H
1931-03-24,1930,Grimsby Town,Sunderland,2-1,2,1,1,1,3,1,H
1931-03-25,1930,Chelsea,Birmingham City,1-0,1,0,1,1,1,1,H
1931-03-25,1930,Manchester United,Leicester City,0-0,0,0,1,1,0,0,D
1931-03-28,1930,Aston Villa,Blackpool,4-1,4,1,1,1,5,3,H
1931-03-28,1930,Bolton Wanderers,Manchester City,1-1,1,1,1,1,2,0,D
1931-03-28,1930,Chelsea,Leeds United,1-0,1,0,1,1,1,1,H
1931-03-28,1930,Grimsby Town,Birmingham City,4-1,4,1,1,1,5,3,H
1931-03-28,1930,Huddersfield Town,Blackburn Rovers,1-1,1,1,1,1,2,0,D
1931-03-28,1930,Liverpool,Portsmouth,3-1,3,1,1,1,4,2,H
1931-03-28,1930,Manchester United,Sheffield United,1-2,1,2,1,1,3,-1,A
1931-03-28,1930,Middlesbrough,Arsenal,2-5,2,5,1,1,7,-3,A
1931-03-28,1930,Newcastle United,Sunderland,2-0,2,0,1,1,2,2,H
1931-03-28,1930,Sheffield Wednesday,Leicester City,4-0,4,0,1,1,4,4,H
1931-03-28,1930,West Ham United,Derby County,0-1,0,1,1,1,1,-1,A
1931-04-03,1930,Blackpool,Derby County,1-0,1,0,1,1,1,1,H
1931-04-03,1930,Grimsby Town,Middlesbrough,4-1,4,1,1,1,5,3,H
1931-04-03,1930,Liverpool,Manchester United,1-1,1,1,1,1,2,0,D
1931-04-03,1930,Manchester City,Blackburn Rovers,3-0,3,0,1,1,3,3,H
1931-04-03,1930,Newcastle United,Huddersfield Town,1-1,1,1,1,1,2,0,D
1931-04-03,1930,Portsmouth,Arsenal,1-1,1,1,1,1,2,0,D
1931-04-03,1930,Sunderland,Birmingham City,1-0,1,0,1,1,1,1,H
1931-04-03,1930,West Ham United,Bolton Wanderers,1-4,1,4,1,1,5,-3,A
1931-04-04,1930,Arsenal,Chelsea,2-1,2,1,1,1,3,1,H
1931-04-04,1930,Birmingham City,Bolton Wanderers,0-2,0,2,1,1,2,-2,A
1931-04-04,1930,Blackburn Rovers,Newcastle United,1-0,1,0,1,1,1,1,H
1931-04-04,1930,Blackpool,Sheffield Wednesday,0-4,0,4,1,1,4,-4,A
1931-04-04,1930,Derby County,Middlesbrough,1-2,1,2,1,1,3,-1,A
1931-04-04,1930,Leeds United,Grimsby Town,0-0,0,0,1,1,0,0,D
1931-04-04,1930,Leicester City,West Ham United,1-1,1,1,1,1,2,0,D
1931-04-04,1930,Manchester City,Huddersfield Town,0-1,0,1,1,1,1,-1,A
1931-04-04,1930,Portsmouth,Aston Villa,5-0,5,0,1,1,5,5,H
1931-04-04,1930,Sheffield United,Liverpool,4-1,4,1,1,1,5,3,H
1931-04-04,1930,Sunderland,Manchester United,1-2,1,2,1,1,3,-1,A
1931-04-06,1930,Arsenal,Portsmouth,1-1,1,1,1,1,2,0,D
1931-04-06,1930,Birmingham City,Sunderland,1-0,1,0,1,1,1,1,H
1931-04-06,1930,Bolton Wanderers,West Ham United,4-2,4,2,1,1,6,2,H
1931-04-06,1930,Chelsea,Leicester City,1-0,1,0,1,1,1,1,H
1931-04-06,1930,Derby County,Blackpool,3-2,3,2,1,1,5,1,H
1931-04-06,1930,Manchester United,Liverpool,4-1,4,1,1,1,5,3,H
1931-04-06,1930,Sheffield United,Leeds United,1-1,1,1,1,1,2,0,D
1931-04-07,1930,Aston Villa,Newcastle United,4-3,4,3,1,1,7,1,H
1931-04-07,1930,Huddersfield Town,Sheffield Wednesday,1-1,1,1,1,1,2,0,D
1931-04-07,1930,Leeds United,Sheffield United,4-0,4,0,1,1,4,4,H
1931-04-07,1930,Leicester City,Chelsea,2-1,2,1,1,1,3,1,H
1931-04-11,1930,Aston Villa,Sheffield United,4-0,4,0,1,1,4,4,H
1931-04-11,1930,Bolton Wanderers,Leeds United,2-0,2,0,1,1,2,2,H
1931-04-11,1930,Chelsea,Derby County,1-1,1,1,1,1,2,0,D
1931-04-11,1930,Grimsby Town,Arsenal,0-1,0,1,1,1,1,-1,A
1931-04-11,1930,Huddersfield Town,Birmingham City,1-0,1,0,1,1,1,1,H
1931-04-11,1930,Liverpool,Sunderland,2-4,2,4,1,1,6,-2,A
1931-04-11,1930,Manchester United,Blackburn Rovers,0-1,0,1,1,1,1,-1,A
1931-04-11,1930,Middlesbrough,Leicester City,2-2,2,2,1,1,4,0,D
1931-04-11,1930,Newcastle United,Manchester City,0-1,0,1,1,1,1,-1,A
1931-04-11,1930,Sheffield Wednesday,Portsmouth,2-2,2,2,1,1,4,0,D
1931-04-11,1930,West Ham United,Blackpool,3-2,3,2,1,1,5,1,H
1931-04-15,1930,Liverpool,Birmingham City,0-0,0,0,1,1,0,0,D
1931-04-18,1930,Arsenal,Liverpool,3-1,3,1,1,1,4,2,H
1931-04-18,1930,Birmingham City,Sheffield Wednesday,2-0,2,0,1,1,2,2,H
1931-04-18,1930,Blackburn Rovers,Middlesbrough,4-5,4,5,1,1,9,-1,A
1931-04-18,1930,Blackpool,Huddersfield Town,1-1,1,1,1,1,2,0,D
1931-04-18,1930,Derby County,Manchester United,6-1,6,1,1,1,7,5,H
1931-04-18,1930,Leeds United,Aston Villa,0-2,0,2,1,1,2,-2,A
1931-04-18,1930,Leicester City,Newcastle United,3-1,3,1,1,1,4,2,H
1931-04-18,1930,Manchester City,West Ham United,1-1,1,1,1,1,2,0,D
1931-04-18,1930,Portsmouth,Bolton Wanderers,1-0,1,0,1,1,1,1,H
1931-04-18,1930,Sheffield United,Grimsby Town,2-1,2,1,1,1,3,1,H
1931-04-18,1930,Sunderland,Chelsea,2-0,2,0,1,1,2,2,H
1931-04-20,1930,Sheffield Wednesday,Derby County,3-2,3,2,1,1,5,1,H
1931-04-25,1930,Aston Villa,Manchester City,4-2,4,2,1,1,6,2,H
1931-04-25,1930,Bolton Wanderers,Leicester City,4-1,4,1,1,1,5,3,H
1931-04-25,1930,Chelsea,Portsmouth,2-0,2,0,1,1,2,2,H
1931-04-25,1930,Grimsby Town,Blackpool,6-2,6,2,1,1,8,4,H
1931-04-25,1930,Huddersfield Town,Derby County,3-0,3,0,1,1,3,3,H
1931-04-25,1930,Middlesbrough,Sheffield United,4-1,4,1,1,1,5,3,H
1931-04-25,1930,Newcastle United,Arsenal,1-3,1,3,1,1,4,-2,A
1931-04-25,1930,Sheffield Wednesday,Blackburn Rovers,1-3,1,3,1,1,4,-2,A
1931-04-25,1930,West Ham United,Sunderland,0-3,0,3,1,1,3,-3,A
1931-05-02,1930,Arsenal,Bolton Wanderers,5-0,5,0,1,1,5,5,H
1931-05-02,1930,Birmingham City,Leicester City,2-1,2,1,1,1,3,1,H
1931-05-02,1930,Blackpool,Manchester City,2-2,2,2,1,1,4,0,D
1931-05-02,1930,Chelsea,Newcastle United,1-1,1,1,1,1,2,0,D
1931-05-02,1930,Grimsby Town,Huddersfield Town,2-1,2,1,1,1,3,1,H
1931-05-02,1930,Leeds United,Derby County,3-1,3,1,1,1,4,2,H
1931-05-02,1930,Liverpool,West Ham United,2-0,2,0,1,1,2,2,H
1931-05-02,1930,Manchester United,Middlesbrough,4-4,4,4,1,1,8,0,D
1931-05-02,1930,Portsmouth,Blackburn Rovers,3-0,3,0,1,1,3,3,H
1931-05-02,1930,Sheffield Wednesday,Aston Villa,3-0,3,0,1,1,3,3,H
1931-05-02,1930,Sunderland,Sheffield United,2-1,2,1,1,1,3,1,H
1931-08-29,1931,Arsenal,West Bromwich Albion,0-1,0,1,1,1,1,-1,A
1931-08-29,1931,Aston Villa,Leicester City,3-2,3,2,1,1,5,1,H
1931-08-29,1931,Blackburn Rovers,Sheffield Wednesday,1-6,1,6,1,1,7,-5,A
1931-08-29,1931,Blackpool,Derby County,2-1,2,1,1,1,3,1,H
1931-08-29,1931,Bolton Wanderers,West Ham United,0-1,0,1,1,1,1,-1,A
1931-08-29,1931,Everton,Birmingham City,3-2,3,2,1,1,5,1,H
1931-08-29,1931,Huddersfield Town,Grimsby Town,1-1,1,1,1,1,2,0,D
1931-08-29,1931,Manchester City,Sunderland,1-1,1,1,1,1,2,0,D
1931-08-29,1931,Middlesbrough,Chelsea,0-2,0,2,1,1,2,-2,A
1931-08-29,1931,Newcastle United,Liverpool,0-1,0,1,1,1,1,-1,A
1931-08-29,1931,Sheffield United,Portsmouth,1-2,1,2,1,1,3,-1,A
1931-08-31,1931,Blackburn Rovers,Arsenal,1-1,1,1,1,1,2,0,D
1931-08-31,1931,Blackpool,Sheffield United,2-0,2,0,1,1,2,2,H
1931-08-31,1931,Huddersfield Town,Aston Villa,1-1,1,1,1,1,2,0,D
1931-08-31,1931,Leicester City,Middlesbrough,2-2,2,2,1,1,4,0,D
1931-08-31,1931,Sheffield Wednesday,Grimsby Town,4-1,4,1,1,1,5,3,H
1931-08-31,1931,West Ham United,Chelsea,3-1,3,1,1,1,4,2,H
1931-09-02,1931,Birmingham City,Newcastle United,4-1,4,1,1,1,5,3,H
1931-09-02,1931,Derby County,Manchester City,2-1,2,1,1,1,3,1,H
1931-09-02,1931,Liverpool,Bolton Wanderers,2-2,2,2,1,1,4,0,D
1931-09-02,1931,Portsmouth,Everton,0-3,0,3,1,1,3,-3,A
1931-09-02,1931,Sunderland,West Bromwich Albion,2-1,2,1,1,1,3,1,H
1931-09-05,1931,Birmingham City,Arsenal,2-2,2,2,1,1,4,0,D
1931-09-05,1931,Chelsea,Huddersfield Town,0-1,0,1,1,1,1,-1,A
1931-09-05,1931,Derby County,Sheffield United,1-3,1,3,1,1,4,-2,A
1931-09-05,1931,Grimsby Town,Newcastle United,1-2,1,2,1,1,3,-1,A
1931-09-05,1931,Leicester City,Manchester City,4-0,4,0,1,1,4,4,H
1931-09-05,1931,Liverpool,Aston Villa,2-0,2,0,1,1,2,2,H
1931-09-05,1931,Portsmouth,Blackburn Rovers,2-0,2,0,1,1,2,2,H
1931-09-05,1931,Sheffield Wednesday,Bolton Wanderers,7-1,7,1,1,1,8,6,H
1931-09-05,1931,Sunderland,Everton,2-3,2,3,1,1,5,-1,A
1931-09-05,1931,West Bromwich Albion,Blackpool,4-0,4,0,1,1,4,4,H
1931-09-05,1931,West Ham United,Middlesbrough,0-2,0,2,1,1,2,-2,A
1931-09-07,1931,Huddersfield Town,Leicester City,2-1,2,1,1,1,3,1,H
1931-09-07,1931,Sheffield United,West Ham United,6-0,6,0,1,1,6,6,H
1931-09-07,1931,West Bromwich Albion,Sunderland,1-0,1,0,1,1,1,1,H
1931-09-09,1931,Arsenal,Portsmouth,3-3,3,3,1,1,6,0,D
1931-09-09,1931,Blackpool,Blackburn Rovers,2-1,2,1,1,1,3,1,H
1931-09-09,1931,Bolton Wanderers,Grimsby Town,5-3,5,3,1,1,8,2,H
1931-09-09,1931,Chelsea,Sheffield Wednesday,2-3,2,3,1,1,5,-1,A
1931-09-09,1931,Manchester City,Derby County,3-0,3,0,1,1,3,3,H
1931-09-09,1931,Middlesbrough,Liverpool,4-1,4,1,1,1,5,3,H
1931-09-12,1931,Arsenal,Sunderland,2-0,2,0,1,1,2,2,H
1931-09-12,1931,Aston Villa,Grimsby Town,7-0,7,0,1,1,7,7,H
1931-09-12,1931,Blackburn Rovers,Derby County,3-2,3,2,1,1,5,1,H
1931-09-12,1931,Blackpool,Birmingham City,1-1,1,1,1,1,2,0,D
1931-09-12,1931,Bolton Wanderers,Portsmouth,4-0,4,0,1,1,4,4,H
1931-09-12,1931,Everton,Manchester City,0-1,0,1,1,1,1,-1,A
1931-09-12,1931,Huddersfield Town,West Ham United,3-1,3,1,1,1,4,2,H
1931-09-12,1931,Leicester City,Liverpool,2-1,2,1,1,1,3,1,H
1931-09-12,1931,Middlesbrough,Sheffield Wednesday,4-0,4,0,1,1,4,4,H
1931-09-12,1931,Newcastle United,Chelsea,4-1,4,1,1,1,5,3,H
1931-09-12,1931,Sheffield United,West Bromwich Albion,1-0,1,0,1,1,1,1,H
1931-09-14,1931,West Bromwich Albion,Manchester City,1-1,1,1,1,1,2,0,D
1931-09-15,1931,Grimsby Town,Bolton Wanderers,2-0,2,0,1,1,2,2,H
1931-09-16,1931,Derby County,Everton,3-0,3,0,1,1,3,3,H
1931-09-16,1931,Liverpool,Middlesbrough,7-2,7,2,1,1,9,5,H
1931-09-16,1931,Portsmouth,Arsenal,0-3,0,3,1,1,3,-3,A
1931-09-16,1931,Sunderland,Birmingham City,2-3,2,3,1,1,5,-1,A
1931-09-19,1931,Birmingham City,Sheffield United,1-3,1,3,1,1,4,-2,A
1931-09-19,1931,Bolton Wanderers,Middlesbrough,4-2,4,2,1,1,6,2,H
1931-09-19,1931,Chelsea,Aston Villa,3-6,3,6,1,1,9,-3,A
1931-09-19,1931,Derby County,Portsmouth,2-1,2,1,1,1,3,1,H
1931-09-19,1931,Grimsby Town,Leicester City,3-0,3,0,1,1,3,3,H
1931-09-19,1931,Liverpool,Everton,1-3,1,3,1,1,4,-2,A
1931-09-19,1931,Manchester City,Arsenal,1-3,1,3,1,1,4,-2,A
1931-09-19,1931,Sheffield Wednesday,Huddersfield Town,4-1,4,1,1,1,5,3,H
1931-09-19,1931,Sunderland,Blackpool,4-0,4,0,1,1,4,4,H
1931-09-19,1931,West Bromwich Albion,Blackburn Rovers,4-1,4,1,1,1,5,3,H
1931-09-19,1931,West Ham United,Newcastle United,2-1,2,1,1,1,3,1,H
1931-09-21,1931,Blackburn Rovers,Blackpool,5-1,5,1,1,1,6,4,H
1931-09-21,1931,Sheffield Wednesday,Chelsea,2-2,2,2,1,1,4,0,D
1931-09-21,1931,West Ham United,Sheffield United,1-2,1,2,1,1,3,-1,A
1931-09-23,1931,Birmingham City,Sunderland,0-0,0,0,1,1,0,0,D
1931-09-23,1931,Everton,Derby County,2-1,2,1,1,1,3,1,H
1931-09-23,1931,Manchester City,West Bromwich Albion,2-5,2,5,1,1,7,-3,A
1931-09-26,1931,Arsenal,Everton,3-2,3,2,1,1,5,1,H
1931-09-26,1931,Aston Villa,West Ham United,5-2,5,2,1,1,7,3,H
1931-09-26,1931,Blackburn Rovers,Birmingham City,1-2,1,2,1,1,3,-1,A
1931-09-26,1931,Blackpool,Manchester City,2-2,2,2,1,1,4,0,D
1931-09-26,1931,Huddersfield Town,Bolton Wanderers,2-0,2,0,1,1,2,2,H
1931-09-26,1931,Leicester City,Chelsea,1-0,1,0,1,1,1,1,H
1931-09-26,1931,Liverpool,Grimsby Town,4-0,4,0,1,1,4,4,H
1931-09-26,1931,Middlesbrough,Derby County,5-2,5,2,1,1,7,3,H
1931-09-26,1931,Newcastle United,Sheffield Wednesday,4-1,4,1,1,1,5,3,H
1931-09-26,1931,Portsmouth,West Bromwich Albion,0-1,0,1,1,1,1,-1,A
1931-09-26,1931,Sheffield United,Sunderland,1-1,1,1,1,1,2,0,D
1931-10-03,1931,Birmingham City,Portsmouth,2-1,2,1,1,1,3,1,H
1931-10-03,1931,Bolton Wanderers,Newcastle United,2-1,2,1,1,1,3,1,H
1931-10-03,1931,Chelsea,Liverpool,2-0,2,0,1,1,2,2,H
1931-10-03,1931,Everton,Blackpool,3-2,3,2,1,1,5,1,H
1931-10-03,1931,Grimsby Town,Arsenal,3-1,3,1,1,1,4,2,H
1931-10-03,1931,Manchester City,Sheffield United,1-1,1,1,1,1,2,0,D
1931-10-03,1931,Middlesbrough,Huddersfield Town,1-0,1,0,1,1,1,1,H
1931-10-03,1931,Sheffield Wednesday,Aston Villa,1-0,1,0,1,1,1,1,H
1931-10-03,1931,Sunderland,Blackburn Rovers,2-2,2,2,1,1,4,0,D
1931-10-03,1931,West Bromwich Albion,Derby County,4-0,4,0,1,1,4,4,H
1931-10-03,1931,West Ham United,Leicester City,1-4,1,4,1,1,5,-3,A
1931-10-10,1931,Aston Villa,Bolton Wanderers,2-1,2,1,1,1,3,1,H
1931-10-10,1931,Blackburn Rovers,Manchester City,2-2,2,2,1,1,4,0,D
1931-10-10,1931,Blackpool,Arsenal,1-5,1,5,1,1,6,-4,A
1931-10-10,1931,Derby County,Birmingham City,2-1,2,1,1,1,3,1,H
1931-10-10,1931,Grimsby Town,Chelsea,1-2,1,2,1,1,3,-1,A
1931-10-10,1931,Huddersfield Town,West Bromwich Albion,2-2,2,2,1,1,4,0,D
1931-10-10,1931,Leicester City,Sheffield Wednesday,3-2,3,2,1,1,5,1,H
1931-10-10,1931,Liverpool,West Ham United,2-2,2,2,1,1,4,0,D
1931-10-10,1931,Newcastle United,Middlesbrough,3-1,3,1,1,1,4,2,H
1931-10-10,1931,Portsmouth,Sunderland,0-0,0,0,1,1,0,0,D
1931-10-10,1931,Sheffield United,Everton,1-5,1,5,1,1,6,-4,A
1931-10-15,1931,Leicester City,Huddersfield Town,2-4,2,4,1,1,6,-2,A
1931-10-17,1931,Arsenal,Bolton Wanderers,1-1,1,1,1,1,2,0,D
1931-10-17,1931,Birmingham City,Grimsby Town,2-1,2,1,1,1,3,1,H
1931-10-17,1931,Blackburn Rovers,Newcastle United,0-3,0,3,1,1,3,-3,A
1931-10-17,1931,Blackpool,Middlesbrough,1-2,1,2,1,1,3,-1,A
1931-10-17,1931,Derby County,Leicester City,1-1,1,1,1,1,2,0,D
1931-10-17,1931,Everton,Sheffield Wednesday,9-3,9,3,1,1,12,6,H
1931-10-17,1931,Manchester City,West Ham United,0-1,0,1,1,1,1,-1,A
1931-10-17,1931,Portsmouth,Aston Villa,0-3,0,3,1,1,3,-3,A
1931-10-17,1931,Sheffield United,Huddersfield Town,0-2,0,2,1,1,2,-2,A
1931-10-17,1931,Sunderland,Chelsea,2-1,2,1,1,1,3,1,H
1931-10-17,1931,West Bromwich Albion,Liverpool,1-2,1,2,1,1,3,-1,A
1931-10-24,1931,Aston Villa,Everton,2-3,2,3,1,1,5,-1,A
1931-10-24,1931,Bolton Wanderers,West Bromwich Albion,1-0,1,0,1,1,1,1,H
1931-10-24,1931,Chelsea,Blackburn Rovers,1-2,1,2,1,1,3,-1,A
1931-10-24,1931,Grimsby Town,Sheffield United,0-2,0,2,1,1,2,-2,A
1931-10-24,1931,Huddersfield Town,Sunderland,4-1,4,1,1,1,5,3,H
1931-10-24,1931,Leicester City,Arsenal,1-2,1,2,1,1,3,-1,A
1931-10-24,1931,Liverpool,Blackpool,3-2,3,2,1,1,5,1,H
1931-10-24,1931,Middlesbrough,Birmingham City,2-0,2,0,1,1,2,2,H
1931-10-24,1931,Newcastle United,Manchester City,2-1,2,1,1,1,3,1,H
1931-10-24,1931,Sheffield Wednesday,Derby County,3-1,3,1,1,1,4,2,H
1931-10-24,1931,West Ham United,Portsmouth,2-1,2,1,1,1,3,1,H
1931-10-31,1931,Arsenal,Aston Villa,1-1,1,1,1,1,2,0,D
1931-10-31,1931,Birmingham City,Bolton Wanderers,2-2,2,2,1,1,4,0,D
1931-10-31,1931,Blackburn Rovers,Grimsby Town,3-2,3,2,1,1,5,1,H
1931-10-31,1931,Blackpool,Leicester City,2-3,2,3,1,1,5,-1,A
1931-10-31,1931,Derby County,West Ham United,5-1,5,1,1,1,6,4,H
1931-10-31,1931,Everton,Newcastle United,8-1,8,1,1,1,9,7,H
1931-10-31,1931,Manchester City,Huddersfield Town,3-0,3,0,1,1,3,3,H
1931-10-31,1931,Portsmouth,Chelsea,1-0,1,0,1,1,1,1,H
1931-10-31,1931,Sheffield United,Liverpool,3-0,3,0,1,1,3,3,H
1931-10-31,1931,Sunderland,Middlesbrough,0-0,0,0,1,1,0,0,D
1931-10-31,1931,West Bromwich Albion,Sheffield Wednesday,1-1,1,1,1,1,2,0,D
1931-11-07,1931,Aston Villa,Blackpool,5-1,5,1,1,1,6,4,H
1931-11-07,1931,Bolton Wanderers,Sunderland,3-1,3,1,1,1,4,2,H
1931-11-07,1931,Chelsea,Derby County,2-1,2,1,1,1,3,1,H
1931-11-07,1931,Grimsby Town,Portsmouth,3-1,3,1,1,1,4,2,H
1931-11-07,1931,Huddersfield Town,Everton,0-0,0,0,1,1,0,0,D
1931-11-07,1931,Leicester City,Sheffield United,4-3,4,3,1,1,7,1,H
1931-11-07,1931,Liverpool,Blackburn Rovers,4-2,4,2,1,1,6,2,H
1931-11-07,1931,Middlesbrough,Manchester City,3-3,3,3,1,1,6,0,D
1931-11-07,1931,Newcastle United,Arsenal,3-2,3,2,1,1,5,1,H
1931-11-07,1931,Sheffield Wednesday,Birmingham City,5-1,5,1,1,1,6,4,H
1931-11-07,1931,West Ham United,West Bromwich Albion,1-5,1,5,1,1,6,-4,A
1931-11-14,1931,Arsenal,West Ham United,4-1,4,1,1,1,5,3,H
1931-11-14,1931,Birmingham City,Leicester City,2-0,2,0,1,1,2,2,H
1931-11-14,1931,Blackburn Rovers,Middlesbrough,4-2,4,2,1,1,6,2,H
1931-11-14,1931,Blackpool,Sheffield Wednesday,1-2,1,2,1,1,3,-1,A
1931-11-14,1931,Derby County,Newcastle United,1-1,1,1,1,1,2,0,D
1931-11-14,1931,Everton,Chelsea,7-2,7,2,1,1,9,5,H
1931-11-14,1931,Manchester City,Grimsby Town,4-1,4,1,1,1,5,3,H
1931-11-14,1931,Portsmouth,Huddersfield Town,3-2,3,2,1,1,5,1,H
1931-11-14,1931,Sheffield United,Bolton Wanderers,4-0,4,0,1,1,4,4,H
1931-11-14,1931,Sunderland,Liverpool,1-3,1,3,1,1,4,-2,A
1931-11-14,1931,West Bromwich Albion,Aston Villa,3-0,3,0,1,1,3,3,H
1931-11-21,1931,Aston Villa,Birmingham City,3-2,3,2,1,1,5,1,H
1931-11-21,1931,Bolton Wanderers,Blackburn Rovers,3-1,3,1,1,1,4,2,H
1931-11-21,1931,Chelsea,Arsenal,2-1,2,1,1,1,3,1,H
1931-11-21,1931,Grimsby Town,Everton,1-2,1,2,1,1,3,-1,A
1931-11-21,1931,Huddersfield Town,Derby County,6-0,6,0,1,1,6,6,H
1931-11-21,1931,Leicester City,Sunderland,5-0,5,0,1,1,5,5,H
1931-11-21,1931,Liverpool,Manchester City,4-3,4,3,1,1,7,1,H
1931-11-21,1931,Middlesbrough,Portsmouth,0-1,0,1,1,1,1,-1,A
1931-11-21,1931,Newcastle United,West Bromwich Albion,5-1,5,1,1,1,6,4,H
1931-11-21,1931,Sheffield Wednesday,Sheffield United,2-1,2,1,1,1,3,1,H
1931-11-21,1931,West Ham United,Blackpool,1-1,1,1,1,1,2,0,D
1931-11-28,1931,Arsenal,Liverpool,6-0,6,0,1,1,6,6,H
1931-11-28,1931,Birmingham City,Huddersfield Town,5-0,5,0,1,1,5,5,H
1931-11-28,1931,Blackburn Rovers,West Ham United,2-4,2,4,1,1,6,-2,A
1931-11-28,1931,Blackpool,Grimsby Town,4-3,4,3,1,1,7,1,H
1931-11-28,1931,Derby County,Bolton Wanderers,5-1,5,1,1,1,6,4,H
1931-11-28,1931,Everton,Leicester City,9-2,9,2,1,1,11,7,H
1931-11-28,1931,Manchester City,Aston Villa,3-3,3,3,1,1,6,0,D
1931-11-28,1931,Portsmouth,Sheffield Wednesday,2-0,2,0,1,1,2,2,H
1931-11-28,1931,Sheffield United,Chelsea,4-2,4,2,1,1,6,2,H
1931-11-28,1931,Sunderland,Newcastle United,1-4,1,4,1,1,5,-3,A
1931-11-28,1931,West Bromwich Albion,Middlesbrough,1-1,1,1,1,1,2,0,D
1931-12-05,1931,Aston Villa,Derby County,2-0,2,0,1,1,2,2,H
1931-12-05,1931,Bolton Wanderers,Blackpool,1-2,1,2,1,1,3,-1,A
1931-12-05,1931,Chelsea,Manchester City,3-2,3,2,1,1,5,1,H
1931-12-05,1931,Grimsby Town,Sunderland,1-3,1,3,1,1,4,-2,A
1931-12-05,1931,Huddersfield Town,Blackburn Rovers,1-1,1,1,1,1,2,0,D
1931-12-05,1931,Leicester City,West Bromwich Albion,2-3,2,3,1,1,5,-1,A
1931-12-05,1931,Liverpool,Birmingham City,4-3,4,3,1,1,7,1,H
1931-12-05,1931,Middlesbrough,Sheffield United,4-3,4,3,1,1,7,1,H
1931-12-05,1931,Newcastle United,Portsmouth,0-0,0,0,1,1,0,0,D
1931-12-05,1931,Sheffield Wednesday,Arsenal,1-3,1,3,1,1,4,-2,A
1931-12-05,1931,West Ham United,Everton,4-2,4,2,1,1,6,2,H
1931-12-12,1931,Arsenal,Huddersfield Town,1-1,1,1,1,1,2,0,D
1931-12-12,1931,Birmingham City,West Ham United,4-1,4,1,1,1,5,3,H
1931-12-12,1931,Blackburn Rovers,Leicester City,6-0,6,0,1,1,6,6,H
1931-12-12,1931,Blackpool,Newcastle United,3-1,3,1,1,1,4,2,H
1931-12-12,1931,Derby County,Grimsby Town,3-3,3,3,1,1,6,0,D
1931-12-12,1931,Everton,Middlesbrough,5-1,5,1,1,1,6,4,H
1931-12-12,1931,Manchester City,Bolton Wanderers,2-1,2,1,1,1,3,1,H
1931-12-12,1931,Portsmouth,Liverpool,2-0,2,0,1,1,2,2,H
1931-12-12,1931,Sheffield United,Aston Villa,5-4,5,4,1,1,9,1,H
1931-12-12,1931,Sunderland,Sheffield Wednesday,3-1,3,1,1,1,4,2,H
1931-12-12,1931,West Bromwich Albion,Chelsea,4-0,4,0,1,1,4,4,H
1931-12-19,1931,Aston Villa,Blackburn Rovers,1-5,1,5,1,1,6,-4,A
1931-12-19,1931,Bolton Wanderers,Everton,2-1,2,1,1,1,3,1,H
1931-12-19,1931,Chelsea,Birmingham City,2-1,2,1,1,1,3,1,H
1931-12-19,1931,Grimsby Town,West Bromwich Albion,0-0,0,0,1,1,0,0,D
1931-12-19,1931,Huddersfield Town,Blackpool,5-0,5,0,1,1,5,5,H
1931-12-19,1931,Liverpool,Derby County,1-1,1,1,1,1,2,0,D
1931-12-19,1931,Middlesbrough,Arsenal,2-5,2,5,1,1,7,-3,A
1931-12-19,1931,Newcastle United,Sheffield United,5-3,5,3,1,1,8,2,H
1931-12-19,1931,Sheffield Wednesday,Manchester City,1-1,1,1,1,1,2,0,D
1931-12-19,1931,West Ham United,Sunderland,2-2,2,2,1,1,4,0,D
1931-12-25,1931,Aston Villa,Middlesbrough,7-1,7,1,1,1,8,6,H
1931-12-25,1931,Blackburn Rovers,Everton,5-3,5,3,1,1,8,2,H
1931-12-25,1931,Blackpool,Chelsea,2-4,2,4,1,1,6,-2,A
1931-12-25,1931,Bolton Wanderers,Leicester City,1-0,1,0,1,1,1,1,H
1931-12-25,1931,Grimsby Town,West Ham United,2-1,2,1,1,1,3,1,H
1931-12-25,1931,Liverpool,Sheffield Wednesday,3-1,3,1,1,1,4,2,H
1931-12-25,1931,Newcastle United,Huddersfield Town,2-1,2,1,1,1,3,1,H
1931-12-25,1931,Sheffield United,Arsenal,4-1,4,1,1,1,5,3,H
1931-12-25,1931,West Bromwich Albion,Birmingham City,0-1,0,1,1,1,1,-1,A
1931-12-26,1931,Arsenal,Sheffield United,0-2,0,2,1,1,2,-2,A
1931-12-26,1931,Birmingham City,West Bromwich Albion,1-0,1,0,1,1,1,1,H
1931-12-26,1931,Chelsea,Blackpool,4-1,4,1,1,1,5,3,H
1931-12-26,1931,Derby County,Sunderland,3-1,3,1,1,1,4,2,H
1931-12-26,1931,Everton,Blackburn Rovers,5-0,5,0,1,1,5,5,H
1931-12-26,1931,Huddersfield Town,Newcastle United,1-2,1,2,1,1,3,-1,A
1931-12-26,1931,Leicester City,Bolton Wanderers,1-3,1,3,1,1,4,-2,A
1931-12-26,1931,Middlesbrough,Aston Villa,1-1,1,1,1,1,2,0,D
1931-12-26,1931,Portsmouth,Manchester City,3-2,3,2,1,1,5,1,H
1931-12-26,1931,Sheffield Wednesday,Liverpool,1-1,1,1,1,1,2,0,D
1931-12-26,1931,West Ham United,Grimsby Town,3-1,3,1,1,1,4,2,H
1931-12-28,1931,Aston Villa,Newcastle United,3-0,3,0,1,1,3,3,H
1932-01-01,1931,Bolton Wanderers,Chelsea,1-0,1,0,1,1,1,1,H
1932-01-01,1931,Manchester City,Portsmouth,3-3,3,3,1,1,6,0,D
1932-01-01,1931,Newcastle United,Aston Villa,3-1,3,1,1,1,4,2,H
1932-01-01,1931,Sheffield United,Blackburn Rovers,3-2,3,2,1,1,5,1,H
1932-01-01,1931,Sunderland,Derby County,0-0,0,0,1,1,0,0,D
1932-01-02,1931,Birmingham City,Everton,4-0,4,0,1,1,4,4,H
1932-01-02,1931,Chelsea,Middlesbrough,4-0,4,0,1,1,4,4,H
1932-01-02,1931,Derby County,Blackpool,5-0,5,0,1,1,5,5,H
1932-01-02,1931,Grimsby Town,Huddersfield Town,1-4,1,4,1,1,5,-3,A
1932-01-02,1931,Leicester City,Aston Villa,3-8,3,8,1,1,11,-5,A
1932-01-02,1931,Liverpool,Newcastle United,4-2,4,2,1,1,6,2,H
1932-01-02,1931,Portsmouth,Sheffield United,2-1,2,1,1,1,3,1,H
1932-01-02,1931,Sheffield Wednesday,Blackburn Rovers,5-1,5,1,1,1,6,4,H
1932-01-02,1931,Sunderland,Manchester City,2-5,2,5,1,1,7,-3,A
1932-01-02,1931,West Bromwich Albion,Arsenal,1-0,1,0,1,1,1,1,H
1932-01-02,1931,West Ham United,Bolton Wanderers,3-1,3,1,1,1,4,2,H
1932-01-16,1931,Arsenal,Birmingham City,3-0,3,0,1,1,3,3,H
1932-01-16,1931,Aston Villa,Liverpool,6-1,6,1,1,1,7,5,H
1932-01-16,1931,Blackburn Rovers,Portsmouth,5-3,5,3,1,1,8,2,H
1932-01-16,1931,Blackpool,West Bromwich Albion,1-2,1,2,1,1,3,-1,A
1932-01-16,1931,Bolton Wanderers,Sheffield Wednesday,2-4,2,4,1,1,6,-2,A
1932-01-16,1931,Everton,Sunderland,4-2,4,2,1,1,6,2,H
1932-01-16,1931,Huddersfield Town,Chelsea,2-1,2,1,1,1,3,1,H
1932-01-16,1931,Manchester City,Leicester City,5-1,5,1,1,1,6,4,H
1932-01-16,1931,Middlesbrough,West Ham United,3-2,3,2,1,1,5,1,H
1932-01-16,1931,Newcastle United,Grimsby Town,2-0,2,0,1,1,2,2,H
1932-01-16,1931,Sheffield United,Derby County,3-1,3,1,1,1,4,2,H
1932-01-25,1931,Sheffield Wednesday,Middlesbrough,1-1,1,1,1,1,2,0,D
1932-01-25,1931,West Bromwich Albion,Sheffield United,0-1,0,1,1,1,1,-1,A
1932-01-27,1931,Derby County,Blackburn Rovers,1-1,1,1,1,1,2,0,D
1932-01-27,1931,Liverpool,Leicester City,3-3,3,3,1,1,6,0,D
1932-01-27,1931,Manchester City,Everton,1-0,1,0,1,1,1,1,H
1932-01-30,1931,Arsenal,Manchester City,4-0,4,0,1,1,4,4,H
1932-01-30,1931,Aston Villa,Chelsea,1-3,1,3,1,1,4,-2,A
1932-01-30,1931,Blackburn Rovers,West Bromwich Albion,2-0,2,0,1,1,2,2,H
1932-01-30,1931,Blackpool,Sunderland,3-2,3,2,1,1,5,1,H
1932-01-30,1931,Everton,Liverpool,2-1,2,1,1,1,3,1,H
1932-01-30,1931,Huddersfield Town,Sheffield Wednesday,6-1,6,1,1,1,7,5,H
1932-01-30,1931,Leicester City,Grimsby Town,1-2,1,2,1,1,3,-1,A
1932-01-30,1931,Middlesbrough,Bolton Wanderers,3-1,3,1,1,1,4,2,H
1932-01-30,1931,Newcastle United,West Ham United,2-2,2,2,1,1,4,0,D
1932-01-30,1931,Portsmouth,Derby County,2-0,2,0,1,1,2,2,H
1932-01-30,1931,Sheffield United,Birmingham City,1-0,1,0,1,1,1,1,H
1932-02-01,1931,West Ham United,Huddersfield Town,1-1,1,1,1,1,2,0,D
1932-02-02,1931,Grimsby Town,Aston Villa,2-2,2,2,1,1,4,0,D
1932-02-03,1931,Birmingham City,Blackpool,3-0,3,0,1,1,3,3,H
1932-02-04,1931,Leicester City,Portsmouth,2-1,2,1,1,1,3,1,H
1932-02-06,1931,Birmingham City,Blackburn Rovers,2-1,2,1,1,1,3,1,H
1932-02-06,1931,Bolton Wanderers,Huddersfield Town,1-2,1,2,1,1,3,-1,A
1932-02-06,1931,Chelsea,Leicester City,1-0,1,0,1,1,1,1,H
1932-02-06,1931,Derby County,Middlesbrough,5-2,5,2,1,1,7,3,H
1932-02-06,1931,Everton,Arsenal,1-3,1,3,1,1,4,-2,A
1932-02-06,1931,Grimsby Town,Liverpool,5-1,5,1,1,1,6,4,H
1932-02-06,1931,Manchester City,Blackpool,7-1,7,1,1,1,8,6,H
1932-02-06,1931,Sheffield Wednesday,Newcastle United,2-0,2,0,1,1,2,2,H
1932-02-06,1931,Sunderland,Sheffield United,1-0,1,0,1,1,1,1,H
1932-02-06,1931,West Bromwich Albion,Portsmouth,3-0,3,0,1,1,3,3,H
1932-02-06,1931,West Ham United,Aston Villa,2-1,2,1,1,1,3,1,H
1932-02-13,1931,Blackburn Rovers,Sunderland,5-2,5,2,1,1,7,3,H
1932-02-13,1931,Blackpool,Everton,2-0,2,0,1,1,2,2,H
1932-02-15,1931,Sheffield United,Manchester City,2-1,2,1,1,1,3,1,H
1932-02-17,1931,Arsenal,Grimsby Town,4-0,4,0,1,1,4,4,H
1932-02-17,1931,Derby County,West Bromwich Albion,3-1,3,1,1,1,4,2,H
1932-02-17,1931,Huddersfield Town,Middlesbrough,1-1,1,1,1,1,2,0,D
1932-02-17,1931,Newcastle United,Bolton Wanderers,3-1,3,1,1,1,4,2,H
1932-02-17,1931,Portsmouth,Birmingham City,2-1,2,1,1,1,3,1,H
1932-02-18,1931,Leicester City,West Ham United,2-1,2,1,1,1,3,1,H
1932-02-20,1931,Arsenal,Blackpool,2-0,2,0,1,1,2,2,H
1932-02-20,1931,Birmingham City,Derby County,1-1,1,1,1,1,2,0,D
1932-02-20,1931,Bolton Wanderers,Aston Villa,2-1,2,1,1,1,3,1,H
1932-02-20,1931,Chelsea,Grimsby Town,4-1,4,1,1,1,5,3,H
1932-02-20,1931,Everton,Sheffield United,5-1,5,1,1,1,6,4,H
1932-02-20,1931,Manchester City,Blackburn Rovers,3-1,3,1,1,1,4,2,H
1932-02-20,1931,Middlesbrough,Newcastle United,2-1,2,1,1,1,3,1,H
1932-02-20,1931,Sheffield Wednesday,Leicester City,3-1,3,1,1,1,4,2,H
1932-02-20,1931,Sunderland,Portsmouth,5-1,5,1,1,1,6,4,H
1932-02-20,1931,West Bromwich Albion,Huddersfield Town,3-2,3,2,1,1,5,1,H
1932-02-20,1931,West Ham United,Liverpool,1-0,1,0,1,1,1,1,H
1932-02-24,1931,Aston Villa,Sheffield Wednesday,3-1,3,1,1,1,4,2,H
1932-02-27,1931,Aston Villa,Portsmouth,0-1,0,1,1,1,1,-1,A
1932-02-27,1931,Grimsby Town,Birmingham City,1-1,1,1,1,1,2,0,D
1932-02-27,1931,Leicester City,Derby County,1-1,1,1,1,1,2,0,D
1932-02-27,1931,Middlesbrough,Blackpool,0-3,0,3,1,1,3,-3,A
1932-02-27,1931,Sheffield Wednesday,Everton,1-3,1,3,1,1,4,-2,A
1932-03-02,1931,Bolton Wanderers,Arsenal,1-0,1,0,1,1,1,1,H
1932-03-02,1931,Chelsea,Sunderland,2-2,2,2,1,1,4,0,D
1932-03-02,1931,Huddersfield Town,Sheffield United,2-2,2,2,1,1,4,0,D
1932-03-02,1931,Liverpool,West Bromwich Albion,4-1,4,1,1,1,5,3,H
1932-03-02,1931,Newcastle United,Blackburn Rovers,5-3,5,3,1,1,8,2,H
1932-03-02,1931,West Ham United,Manchester City,1-1,1,1,1,1,2,0,D
1932-03-05,1931,Arsenal,Leicester City,2-1,2,1,1,1,3,1,H
1932-03-05,1931,Birmingham City,Middlesbrough,3-0,3,0,1,1,3,3,H
1932-03-05,1931,Blackburn Rovers,Chelsea,2-2,2,2,1,1,4,0,D
1932-03-05,1931,Blackpool,Liverpool,2-2,2,2,1,1,4,0,D
1932-03-05,1931,Derby County,Sheffield Wednesday,0-1,0,1,1,1,1,-1,A
1932-03-05,1931,Everton,Aston Villa,4-2,4,2,1,1,6,2,H
1932-03-05,1931,Manchester City,Newcastle United,5-1,5,1,1,1,6,4,H
1932-03-05,1931,Portsmouth,West Ham United,3-0,3,0,1,1,3,3,H
1932-03-05,1931,Sheffield United,Grimsby Town,2-1,2,1,1,1,3,1,H
1932-03-05,1931,Sunderland,Huddersfield Town,1-3,1,3,1,1,4,-2,A
1932-03-05,1931,West Bromwich Albion,Bolton Wanderers,3-0,3,0,1,1,3,3,H
1932-03-09,1931,Portsmouth,Bolton Wanderers,3-2,3,2,1,1,5,1,H
1932-03-12,1931,Bolton Wanderers,Birmingham City,5-1,5,1,1,1,6,4,H
1932-03-12,1931,Grimsby Town,Blackburn Rovers,4-3,4,3,1,1,7,1,H
1932-03-12,1931,Leicester City,Blackpool,2-2,2,2,1,1,4,0,D
1932-03-12,1931,Liverpool,Sheffield United,2-1,2,1,1,1,3,1,H
1932-03-12,1931,Middlesbrough,Sunderland,0-1,0,1,1,1,1,-1,A
1932-03-12,1931,Sheffield Wednesday,West Bromwich Albion,2-5,2,5,1,1,7,-3,A
1932-03-12,1931,West Ham United,Derby County,2-1,2,1,1,1,3,1,H
1932-03-16,1931,Chelsea,Portsmouth,0-0,0,0,1,1,0,0,D
1932-03-19,1931,Arsenal,Newcastle United,1-0,1,0,1,1,1,1,H
1932-03-19,1931,Birmingham City,Sheffield Wednesday,1-2,1,2,1,1,3,-1,A
1932-03-19,1931,Blackburn Rovers,Liverpool,1-3,1,3,1,1,4,-2,A
1932-03-19,1931,Blackpool,Aston Villa,1-3,1,3,1,1,4,-2,A
1932-03-19,1931,Derby County,Chelsea,1-0,1,0,1,1,1,1,H
1932-03-19,1931,Everton,Huddersfield Town,4-1,4,1,1,1,5,3,H
1932-03-19,1931,Manchester City,Middlesbrough,1-2,1,2,1,1,3,-1,A
1932-03-19,1931,Portsmouth,Grimsby Town,2-0,2,0,1,1,2,2,H
1932-03-19,1931,Sheffield United,Leicester City,2-2,2,2,1,1,4,0,D
1932-03-19,1931,Sunderland,Bolton Wanderers,3-0,3,0,1,1,3,3,H
1932-03-19,1931,West Bromwich Albion,West Ham United,3-1,3,1,1,1,4,2,H
1932-03-25,1931,Arsenal,Derby County,2-1,2,1,1,1,3,1,H
1932-03-25,1931,Blackpool,Portsmouth,1-1,1,1,1,1,2,0,D
1932-03-25,1931,Chelsea,Bolton Wanderers,3-0,3,0,1,1,3,3,H
1932-03-25,1931,Everton,West Bromwich Albion,2-1,2,1,1,1,3,1,H
1932-03-25,1931,Grimsby Town,Middlesbrough,2-0,2,0,1,1,2,2,H
1932-03-25,1931,Newcastle United,Leicester City,3-2,3,2,1,1,5,1,H
1932-03-25,1931,Sunderland,Aston Villa,1-1,1,1,1,1,2,0,D
1932-03-25,1931,West Ham United,Sheffield Wednesday,1-2,1,2,1,1,3,-1,A
1932-03-26,1931,Aston Villa,West Bromwich Albion,2-0,2,0,1,1,2,2,H
1932-03-26,1931,Bolton Wanderers,Sheffield United,3-1,3,1,1,1,4,2,H
1932-03-26,1931,Chelsea,Everton,0-0,0,0,1,1,0,0,D
1932-03-26,1931,Grimsby Town,Manchester City,2-1,2,1,1,1,3,1,H
1932-03-26,1931,Huddersfield Town,Portsmouth,1-0,1,0,1,1,1,1,H
1932-03-26,1931,Leicester City,Birmingham City,3-1,3,1,1,1,4,2,H
1932-03-26,1931,Liverpool,Sunderland,1-2,1,2,1,1,3,-1,A
1932-03-26,1931,Middlesbrough,Blackburn Rovers,0-2,0,2,1,1,2,-2,A
1932-03-26,1931,Newcastle United,Derby County,3-3,3,3,1,1,6,0,D
1932-03-26,1931,Sheffield Wednesday,Blackpool,3-0,3,0,1,1,3,3,H
1932-03-26,1931,West Ham United,Arsenal,1-1,1,1,1,1,2,0,D
1932-03-28,1931,Aston Villa,Sunderland,2-0,2,0,1,1,2,2,H
1932-03-28,1931,Blackburn Rovers,Sheffield United,1-2,1,2,1,1,3,-1,A
1932-03-28,1931,Derby County,Arsenal,1-1,1,1,1,1,2,0,D
1932-03-28,1931,Liverpool,Huddersfield Town,0-3,0,3,1,1,3,-3,A
1932-03-28,1931,Manchester City,Birmingham City,2-1,2,1,1,1,3,1,H
1932-03-28,1931,Middlesbrough,Grimsby Town,4-0,4,0,1,1,4,4,H
1932-03-28,1931,Portsmouth,Blackpool,2-2,2,2,1,1,4,0,D
1932-03-28,1931,Sheffield Wednesday,West Ham United,6-1,6,1,1,1,7,5,H
1932-03-28,1931,West Bromwich Albion,Everton,1-1,1,1,1,1,2,0,D
1932-03-29,1931,Birmingham City,Manchester City,1-5,1,5,1,1,6,-4,A
1932-03-29,1931,Huddersfield Town,Liverpool,4-3,4,3,1,1,7,1,H
1932-03-29,1931,Leicester City,Newcastle United,4-2,4,2,1,1,6,2,H
1932-04-02,1931,Arsenal,Chelsea,1-1,1,1,1,1,2,0,D
1932-04-02,1931,Birmingham City,Aston Villa,1-1,1,1,1,1,2,0,D
1932-04-02,1931,Blackburn Rovers,Bolton Wanderers,3-1,3,1,1,1,4,2,H
1932-04-02,1931,Blackpool,West Ham United,7-2,7,2,1,1,9,5,H
1932-04-02,1931,Derby County,Huddersfield Town,3-2,3,2,1,1,5,1,H
1932-04-02,1931,Everton,Grimsby Town,4-2,4,2,1,1,6,2,H
1932-04-02,1931,Manchester City,Liverpool,0-1,0,1,1,1,1,-1,A
1932-04-02,1931,Portsmouth,Middlesbrough,2-0,2,0,1,1,2,2,H
1932-04-02,1931,Sheffield United,Sheffield Wednesday,1-1,1,1,1,1,2,0,D
1932-04-02,1931,Sunderland,Leicester City,4-1,4,1,1,1,5,3,H
1932-04-02,1931,West Bromwich Albion,Newcastle United,2-1,2,1,1,1,3,1,H
1932-04-06,1931,Huddersfield Town,Manchester City,1-0,1,0,1,1,1,1,H
1932-04-06,1931,Liverpool,Chelsea,2-1,2,1,1,1,3,1,H
1932-04-06,1931,Sunderland,Arsenal,2-0,2,0,1,1,2,2,H
1932-04-09,1931,Aston Villa,Manchester City,2-1,2,1,1,1,3,1,H
1932-04-09,1931,Bolton Wanderers,Derby County,1-2,1,2,1,1,3,-1,A
1932-04-09,1931,Chelsea,Sheffield United,1-1,1,1,1,1,2,0,D
1932-04-09,1931,Grimsby Town,Blackpool,0-0,0,0,1,1,0,0,D
1932-04-09,1931,Huddersfield Town,Birmingham City,1-1,1,1,1,1,2,0,D
1932-04-09,1931,Leicester City,Everton,0-1,0,1,1,1,1,-1,A
1932-04-09,1931,Liverpool,Arsenal,2-1,2,1,1,1,3,1,H
1932-04-09,1931,Middlesbrough,West Bromwich Albion,1-0,1,0,1,1,1,1,H
1932-04-09,1931,Newcastle United,Sunderland,1-2,1,2,1,1,3,-1,A
1932-04-09,1931,Sheffield Wednesday,Portsmouth,3-1,3,1,1,1,4,2,H
1932-04-09,1931,West Ham United,Blackburn Rovers,1-3,1,3,1,1,4,-2,A
1932-04-14,1931,Chelsea,Newcastle United,4-1,4,1,1,1,5,3,H
1932-04-16,1931,Arsenal,Sheffield Wednesday,3-1,3,1,1,1,4,2,H
1932-04-16,1931,Birmingham City,Liverpool,3-1,3,1,1,1,4,2,H
1932-04-16,1931,Blackburn Rovers,Huddersfield Town,3-0,3,0,1,1,3,3,H
1932-04-16,1931,Blackpool,Bolton Wanderers,0-3,0,3,1,1,3,-3,A
1932-04-16,1931,Derby County,Aston Villa,3-1,3,1,1,1,4,2,H
1932-04-16,1931,Everton,West Ham United,6-1,6,1,1,1,7,5,H
1932-04-16,1931,Manchester City,Chelsea,1-1,1,1,1,1,2,0,D
1932-04-16,1931,Portsmouth,Newcastle United,6-0,6,0,1,1,6,6,H
1932-04-16,1931,Sheffield United,Middlesbrough,2-1,2,1,1,1,3,1,H
1932-04-16,1931,Sunderland,Grimsby Town,2-0,2,0,1,1,2,2,H
1932-04-16,1931,West Bromwich Albion,Leicester City,1-2,1,2,1,1,3,-1,A
1932-04-23,1931,Aston Villa,Sheffield United,5-0,5,0,1,1,5,5,H
1932-04-23,1931,Bolton Wanderers,Manchester City,1-1,1,1,1,1,2,0,D
1932-04-23,1931,Chelsea,West Bromwich Albion,0-2,0,2,1,1,2,-2,A
1932-04-23,1931,Grimsby Town,Derby County,2-1,2,1,1,1,3,1,H
1932-04-23,1931,Leicester City,Blackburn Rovers,1-0,1,0,1,1,1,1,H
1932-04-23,1931,Liverpool,Portsmouth,1-3,1,3,1,1,4,-2,A
1932-04-23,1931,Middlesbrough,Everton,1-0,1,0,1,1,1,1,H
1932-04-23,1931,Sheffield Wednesday,Sunderland,3-2,3,2,1,1,5,1,H
1932-04-23,1931,West Ham United,Birmingham City,2-4,2,4,1,1,6,-2,A
1932-04-25,1931,Aston Villa,Arsenal,1-1,1,1,1,1,2,0,D
1932-04-27,1931,Huddersfield Town,Arsenal,1-2,1,2,1,1,3,-1,A
1932-04-27,1931,Newcastle United,Blackpool,2-2,2,2,1,1,4,0,D
1932-04-30,1931,Arsenal,Middlesbrough,5-0,5,0,1,1,5,5,H
1932-04-30,1931,Birmingham City,Chelsea,4-0,4,0,1,1,4,4,H
1932-04-30,1931,Blackburn Rovers,Aston Villa,2-0,2,0,1,1,2,2,H
1932-04-30,1931,Blackpool,Huddersfield Town,2-0,2,0,1,1,2,2,H
1932-04-30,1931,Derby County,Liverpool,1-2,1,2,1,1,3,-1,A
1932-04-30,1931,Everton,Bolton Wanderers,1-0,1,0,1,1,1,1,H
1932-04-30,1931,Manchester City,Sheffield Wednesday,1-2,1,2,1,1,3,-1,A
1932-04-30,1931,Portsmouth,Leicester City,0-1,0,1,1,1,1,-1,A
1932-04-30,1931,Sheffield United,Newcastle United,0-3,0,3,1,1,3,-3,A
1932-04-30,1931,Sunderland,West Ham United,2-0,2,0,1,1,2,2,H
1932-04-30,1931,West Bromwich Albion,Grimsby Town,5-6,5,6,1,1,11,-1,A
1932-05-04,1931,Newcastle United,Everton,0-0,0,0,1,1,0,0,D
1932-05-07,1931,Arsenal,Blackburn Rovers,4-0,4,0,1,1,4,4,H
1932-05-07,1931,Aston Villa,Huddersfield Town,2-3,2,3,1,1,5,-1,A
1932-05-07,1931,Bolton Wanderers,Liverpool,8-1,8,1,1,1,9,7,H
1932-05-07,1931,Chelsea,West Ham United,3-2,3,2,1,1,5,1,H
1932-05-07,1931,Everton,Portsmouth,0-1,0,1,1,1,1,-1,A
1932-05-07,1931,Grimsby Town,Sheffield Wednesday,3-1,3,1,1,1,4,2,H
1932-05-07,1931,Middlesbrough,Leicester City,1-1,1,1,1,1,2,0,D
1932-05-07,1931,Newcastle United,Birmingham City,0-3,0,3,1,1,3,-3,A
1932-05-07,1931,Sheffield United,Blackpool,1-3,1,3,1,1,4,-2,A
1932-08-27,1932,Birmingham City,Arsenal,0-1,0,1,1,1,1,-1,A
1932-08-27,1932,Bolton Wanderers,Newcastle United,2-2,2,2,1,1,4,0,D
1932-08-27,1932,Chelsea,Blackburn Rovers,2-2,2,2,1,1,4,0,D
1932-08-27,1932,Leeds United,Derby County,0-2,0,2,1,1,2,-2,A
1932-08-27,1932,Leicester City,Sheffield United,1-1,1,1,1,1,2,0,D
1932-08-27,1932,Liverpool,Wolverhampton Wanderers,5-1,5,1,1,1,6,4,H
1932-08-27,1932,Middlesbrough,Aston Villa,0-2,0,2,1,1,2,-2,A
1932-08-27,1932,Portsmouth,Huddersfield Town,1-0,1,0,1,1,1,1,H
1932-08-27,1932,Sheffield Wednesday,Blackpool,4-1,4,1,1,1,5,3,H
1932-08-27,1932,Sunderland,Manchester City,3-2,3,2,1,1,5,1,H
1932-08-27,1932,West Bromwich Albion,Everton,3-1,3,1,1,1,4,2,H
1932-08-29,1932,Aston Villa,Sunderland,1-0,1,0,1,1,1,1,H
1932-08-29,1932,Blackpool,Leeds United,2-1,2,1,1,1,3,1,H
1932-08-29,1932,Huddersfield Town,Leicester City,4-1,4,1,1,1,5,3,H
1932-08-29,1932,Sheffield United,Liverpool,6-2,6,2,1,1,8,4,H
1932-08-29,1932,Wolverhampton Wanderers,Bolton Wanderers,4-1,4,1,1,1,5,3,H
1932-08-31,1932,Arsenal,West Bromwich Albion,1-2,1,2,1,1,3,-1,A
1932-08-31,1932,Derby County,Blackburn Rovers,2-1,2,1,1,1,3,1,H
1932-08-31,1932,Everton,Sheffield Wednesday,2-1,2,1,1,1,3,1,H
1932-08-31,1932,Manchester City,Birmingham City,1-0,1,0,1,1,1,1,H
1932-08-31,1932,Newcastle United,Middlesbrough,5-1,5,1,1,1,6,4,H
1932-08-31,1932,Portsmouth,Chelsea,2-0,2,0,1,1,2,2,H
1932-09-03,1932,Arsenal,Sunderland,6-1,6,1,1,1,7,5,H
1932-09-03,1932,Aston Villa,Bolton Wanderers,6-1,6,1,1,1,7,5,H
1932-09-03,1932,Blackburn Rovers,Leeds United,1-1,1,1,1,1,2,0,D
1932-09-03,1932,Blackpool,West Bromwich Albion,2-4,2,4,1,1,6,-2,A
1932-09-03,1932,Derby County,Sheffield Wednesday,2-0,2,0,1,1,2,2,H
1932-09-03,1932,Everton,Birmingham City,4-1,4,1,1,1,5,3,H
1932-09-03,1932,Huddersfield Town,Chelsea,2-0,2,0,1,1,2,2,H
1932-09-03,1932,Manchester City,Middlesbrough,2-3,2,3,1,1,5,-1,A
1932-09-03,1932,Newcastle United,Liverpool,4-3,4,3,1,1,7,1,H
1932-09-03,1932,Sheffield United,Portsmouth,2-3,2,3,1,1,5,-1,A
1932-09-03,1932,Wolverhampton Wanderers,Leicester City,1-1,1,1,1,1,2,0,D
1932-09-05,1932,Bolton Wanderers,Wolverhampton Wanderers,2-0,2,0,1,1,2,2,H
1932-09-05,1932,Leeds United,Blackpool,3-1,3,1,1,1,4,2,H
1932-09-05,1932,Leicester City,Huddersfield Town,3-1,3,1,1,1,4,2,H
1932-09-05,1932,Sheffield Wednesday,Everton,3-1,3,1,1,1,4,2,H
1932-09-07,1932,Birmingham City,Manchester City,3-0,3,0,1,1,3,3,H
1932-09-07,1932,Chelsea,Portsmouth,4-4,4,4,1,1,8,0,D
1932-09-07,1932,Liverpool,Sheffield United,2-2,2,2,1,1,4,0,D
1932-09-07,1932,Sunderland,Aston Villa,1-1,1,1,1,1,2,0,D
1932-09-10,1932,Birmingham City,Blackpool,2-1,2,1,1,1,3,1,H
1932-09-10,1932,Bolton Wanderers,Middlesbrough,4-3,4,3,1,1,7,1,H
1932-09-10,1932,Chelsea,Sheffield United,3-0,3,0,1,1,3,3,H
1932-09-10,1932,Leeds United,Huddersfield Town,1-1,1,1,1,1,2,0,D
1932-09-10,1932,Leicester City,Newcastle United,0-3,0,3,1,1,3,-3,A
1932-09-10,1932,Liverpool,Aston Villa,0-0,0,0,1,1,0,0,D
1932-09-10,1932,Manchester City,Arsenal,2-3,2,3,1,1,5,-1,A
1932-09-10,1932,Portsmouth,Wolverhampton Wanderers,2-0,2,0,1,1,2,2,H
1932-09-10,1932,Sheffield Wednesday,Blackburn Rovers,1-1,1,1,1,1,2,0,D
1932-09-10,1932,Sunderland,Everton,3-1,3,1,1,1,4,2,H
1932-09-10,1932,West Bromwich Albion,Derby County,2-0,2,0,1,1,2,2,H
1932-09-14,1932,West Bromwich Albion,Arsenal,1-1,1,1,1,1,2,0,D
1932-09-17,1932,Arsenal,Bolton Wanderers,3-2,3,2,1,1,5,1,H
1932-09-17,1932,Aston Villa,Leicester City,4-2,4,2,1,1,6,2,H
1932-09-17,1932,Blackburn Rovers,West Bromwich Albion,4-4,4,4,1,1,8,0,D
1932-09-17,1932,Blackpool,Sunderland,3-1,3,1,1,1,4,2,H
1932-09-17,1932,Derby County,Birmingham City,2-2,2,2,1,1,4,0,D
1932-09-17,1932,Everton,Manchester City,2-1,2,1,1,1,3,1,H
1932-09-17,1932,Leeds United,Sheffield Wednesday,3-2,3,2,1,1,5,1,H
1932-09-17,1932,Middlesbrough,Liverpool,0-1,0,1,1,1,1,-1,A
1932-09-17,1932,Newcastle United,Portsmouth,1-1,1,1,1,1,2,0,D
1932-09-17,1932,Sheffield United,Huddersfield Town,1-2,1,2,1,1,3,-1,A
1932-09-17,1932,Wolverhampton Wanderers,Chelsea,1-2,1,2,1,1,3,-1,A
1932-09-19,1932,Blackburn Rovers,Derby County,3-3,3,3,1,1,6,0,D
1932-09-24,1932,Arsenal,Everton,2-1,2,1,1,1,3,1,H
1932-09-24,1932,Birmingham City,Blackburn Rovers,3-1,3,1,1,1,4,2,H
1932-09-24,1932,Chelsea,Newcastle United,0-1,0,1,1,1,1,-1,A
1932-09-24,1932,Huddersfield Town,Wolverhampton Wanderers,3-2,3,2,1,1,5,1,H
1932-09-24,1932,Leicester City,Middlesbrough,1-1,1,1,1,1,2,0,D
1932-09-24,1932,Liverpool,Bolton Wanderers,0-1,0,1,1,1,1,-1,A
1932-09-24,1932,Manchester City,Blackpool,5-1,5,1,1,1,6,4,H
1932-09-24,1932,Portsmouth,Aston Villa,2-4,2,4,1,1,6,-2,A
1932-09-24,1932,Sheffield Wednesday,Sheffield United,3-3,3,3,1,1,6,0,D
1932-09-24,1932,Sunderland,Derby County,0-2,0,2,1,1,2,-2,A
1932-09-24,1932,West Bromwich Albion,Leeds United,0-1,0,1,1,1,1,-1,A
1932-10-01,1932,Aston Villa,Chelsea,3-1,3,1,1,1,4,2,H
1932-10-01,1932,Blackburn Rovers,Sunderland,1-3,1,3,1,1,4,-2,A
1932-10-01,1932,Blackpool,Arsenal,1-2,1,2,1,1,3,-1,A
1932-10-01,1932,Bolton Wanderers,Leicester City,5-0,5,0,1,1,5,5,H
1932-10-01,1932,Derby County,Manchester City,4-0,4,0,1,1,4,4,H
1932-10-01,1932,Everton,Liverpool,3-1,3,1,1,1,4,2,H
1932-10-01,1932,Leeds United,Birmingham City,1-1,1,1,1,1,2,0,D
1932-10-01,1932,Middlesbrough,Portsmouth,5-4,5,4,1,1,9,1,H
1932-10-01,1932,Newcastle United,Huddersfield Town,0-4,0,4,1,1,4,-4,A
1932-10-01,1932,Sheffield Wednesday,West Bromwich Albion,3-1,3,1,1,1,4,2,H
1932-10-01,1932,Wolverhampton Wanderers,Sheffield United,5-1,5,1,1,1,6,4,H
1932-10-08,1932,Arsenal,Derby County,3-3,3,3,1,1,6,0,D
1932-10-08,1932,Birmingham City,Sheffield Wednesday,2-1,2,1,1,1,3,1,H
1932-10-08,1932,Chelsea,Middlesbrough,2-1,2,1,1,1,3,1,H
1932-10-08,1932,Everton,Blackpool,2-0,2,0,1,1,2,2,H
1932-10-08,1932,Huddersfield Town,Aston Villa,0-0,0,0,1,1,0,0,D
1932-10-08,1932,Leicester City,Liverpool,1-2,1,2,1,1,3,-1,A
1932-10-08,1932,Manchester City,Blackburn Rovers,2-3,2,3,1,1,5,-1,A
1932-10-08,1932,Portsmouth,Bolton Wanderers,2-1,2,1,1,1,3,1,H
1932-10-08,1932,Sheffield United,Newcastle United,3-1,3,1,1,1,4,2,H
1932-10-08,1932,Sunderland,Leeds United,0-0,0,0,1,1,0,0,D
1932-10-08,1932,West Bromwich Albion,Wolverhampton Wanderers,4-1,4,1,1,1,5,3,H
1932-10-15,1932,Aston Villa,Sheffield United,3-0,3,0,1,1,3,3,H
1932-10-15,1932,Blackburn Rovers,Arsenal,2-3,2,3,1,1,5,-1,A
1932-10-15,1932,Blackpool,Leicester City,2-1,2,1,1,1,3,1,H
1932-10-15,1932,Bolton Wanderers,Chelsea,2-3,2,3,1,1,5,-1,A
1932-10-15,1932,Derby County,Everton,2-0,2,0,1,1,2,2,H
1932-10-15,1932,Leeds United,Manchester City,2-1,2,1,1,1,3,1,H
1932-10-15,1932,Liverpool,Portsmouth,4-3,4,3,1,1,7,1,H
1932-10-15,1932,Middlesbrough,Huddersfield Town,1-1,1,1,1,1,2,0,D
1932-10-15,1932,Newcastle United,Wolverhampton Wanderers,3-2,3,2,1,1,5,1,H
1932-10-15,1932,Sheffield Wednesday,Sunderland,3-1,3,1,1,1,4,2,H
1932-10-15,1932,West Bromwich Albion,Birmingham City,1-0,1,0,1,1,1,1,H
1932-10-22,1932,Aston Villa,Birmingham City,1-0,1,0,1,1,1,1,H
1932-10-22,1932,Bolton Wanderers,Manchester City,2-1,2,1,1,1,3,1,H
1932-10-22,1932,Chelsea,Derby County,1-3,1,3,1,1,4,-2,A
1932-10-22,1932,Huddersfield Town,Blackburn Rovers,0-3,0,3,1,1,3,-3,A
1932-10-22,1932,Leicester City,Everton,2-2,2,2,1,1,4,0,D
1932-10-22,1932,Liverpool,Arsenal,2-3,2,3,1,1,5,-1,A
1932-10-22,1932,Middlesbrough,Sunderland,1-2,1,2,1,1,3,-1,A
1932-10-22,1932,Newcastle United,West Bromwich Albion,3-0,3,0,1,1,3,3,H
1932-10-22,1932,Portsmouth,Blackpool,2-1,2,1,1,1,3,1,H
1932-10-22,1932,Sheffield United,Leeds United,0-0,0,0,1,1,0,0,D
1932-10-22,1932,Wolverhampton Wanderers,Sheffield Wednesday,3-5,3,5,1,1,8,-2,A
1932-10-29,1932,Arsenal,Leicester City,8-2,8,2,1,1,10,6,H
1932-10-29,1932,Birmingham City,Middlesbrough,1-4,1,4,1,1,5,-3,A
1932-10-29,1932,Blackburn Rovers,Sheffield United,3-0,3,0,1,1,3,3,H
1932-10-29,1932,Blackpool,Chelsea,4-0,4,0,1,1,4,4,H
1932-10-29,1932,Derby County,Huddersfield Town,2-3,2,3,1,1,5,-1,A
1932-10-29,1932,Everton,Portsmouth,1-1,1,1,1,1,2,0,D
1932-10-29,1932,Leeds United,Wolverhampton Wanderers,2-0,2,0,1,1,2,2,H
1932-10-29,1932,Manchester City,Liverpool,1-1,1,1,1,1,2,0,D
1932-10-29,1932,Sheffield Wednesday,Newcastle United,2-0,2,0,1,1,2,2,H
1932-10-29,1932,Sunderland,Bolton Wanderers,7-4,7,4,1,1,11,3,H
1932-10-29,1932,West Bromwich Albion,Aston Villa,3-1,3,1,1,1,4,2,H
1932-11-05,1932,Aston Villa,Blackpool,6-2,6,2,1,1,8,4,H
1932-11-05,1932,Bolton Wanderers,Blackburn Rovers,4-2,4,2,1,1,6,2,H
1932-11-05,1932,Chelsea,Birmingham City,4-2,4,2,1,1,6,2,H
1932-11-05,1932,Huddersfield Town,Sunderland,2-1,2,1,1,1,3,1,H
1932-11-05,1932,Leicester City,Sheffield Wednesday,0-0,0,0,1,1,0,0,D
1932-11-05,1932,Liverpool,Leeds United,0-1,0,1,1,1,1,-1,A
1932-11-05,1932,Middlesbrough,Derby County,0-3,0,3,1,1,3,-3,A
1932-11-05,1932,Newcastle United,Everton,1-2,1,2,1,1,3,-1,A
1932-11-05,1932,Portsmouth,West Bromwich Albion,3-0,3,0,1,1,3,3,H
1932-11-05,1932,Sheffield United,Manchester City,2-5,2,5,1,1,7,-3,A
1932-11-05,1932,Wolverhampton Wanderers,Arsenal,1-7,1,7,1,1,8,-6,A
1932-11-12,1932,Arsenal,Newcastle United,1-0,1,0,1,1,1,1,H
1932-11-12,1932,Birmingham City,Huddersfield Town,0-2,0,2,1,1,2,-2,A
1932-11-12,1932,Blackburn Rovers,Liverpool,2-2,2,2,1,1,4,0,D
1932-11-12,1932,Blackpool,Middlesbrough,3-1,3,1,1,1,4,2,H
1932-11-12,1932,Derby County,Bolton Wanderers,4-1,4,1,1,1,5,3,H
1932-11-12,1932,Everton,Aston Villa,3-3,3,3,1,1,6,0,D
1932-11-12,1932,Leeds United,Leicester City,1-1,1,1,1,1,2,0,D
1932-11-12,1932,Manchester City,Wolverhampton Wanderers,4-1,4,1,1,1,5,3,H
1932-11-12,1932,Sheffield Wednesday,Portsmouth,2-1,2,1,1,1,3,1,H
1932-11-12,1932,Sunderland,Sheffield United,2-2,2,2,1,1,4,0,D
1932-11-12,1932,West Bromwich Albion,Chelsea,3-2,3,2,1,1,5,1,H
1932-11-19,1932,Aston Villa,Arsenal,5-3,5,3,1,1,8,2,H
1932-11-19,1932,Bolton Wanderers,Blackpool,1-0,1,0,1,1,1,1,H
1932-11-19,1932,Chelsea,Sheffield Wednesday,0-2,0,2,1,1,2,-2,A
1932-11-19,1932,Huddersfield Town,West Bromwich Albion,2-1,2,1,1,1,3,1,H
1932-11-19,1932,Leicester City,Blackburn Rovers,1-1,1,1,1,1,2,0,D
1932-11-19,1932,Liverpool,Derby County,6-1,6,1,1,1,7,5,H
1932-11-19,1932,Middlesbrough,Everton,0-2,0,2,1,1,2,-2,A
1932-11-19,1932,Newcastle United,Manchester City,2-0,2,0,1,1,2,2,H
1932-11-19,1932,Portsmouth,Leeds United,3-3,3,3,1,1,6,0,D
1932-11-19,1932,Sheffield United,Birmingham City,2-1,2,1,1,1,3,1,H
1932-11-19,1932,Wolverhampton Wanderers,Sunderland,0-2,0,2,1,1,2,-2,A
1932-11-26,1932,Arsenal,Middlesbrough,4-2,4,2,1,1,6,2,H
1932-11-26,1932,Birmingham City,Wolverhampton Wanderers,0-0,0,0,1,1,0,0,D
1932-11-26,1932,Blackburn Rovers,Portsmouth,3-2,3,2,1,1,5,1,H
1932-11-26,1932,Blackpool,Liverpool,4-1,4,1,1,1,5,3,H
1932-11-26,1932,Derby County,Leicester City,3-2,3,2,1,1,5,1,H
1932-11-26,1932,Everton,Bolton Wanderers,2-2,2,2,1,1,4,0,D
1932-11-26,1932,Leeds United,Chelsea,2-0,2,0,1,1,2,2,H
1932-11-26,1932,Manchester City,Aston Villa,5-2,5,2,1,1,7,3,H
1932-11-26,1932,Sheffield Wednesday,Huddersfield Town,2-1,2,1,1,1,3,1,H
1932-11-26,1932,Sunderland,Newcastle United,0-2,0,2,1,1,2,-2,A
1932-11-26,1932,West Bromwich Albion,Sheffield United,0-1,0,1,1,1,1,-1,A
1932-12-03,1932,Aston Villa,Sheffield Wednesday,3-6,3,6,1,1,9,-3,A
1932-12-03,1932,Bolton Wanderers,Birmingham City,2-2,2,2,1,1,4,0,D
1932-12-03,1932,Chelsea,Everton,1-0,1,0,1,1,1,1,H
1932-12-03,1932,Huddersfield Town,Blackpool,0-1,0,1,1,1,1,-1,A
1932-12-03,1932,Leicester City,Manchester City,1-2,1,2,1,1,3,-1,A
1932-12-03,1932,Liverpool,Sunderland,3-3,3,3,1,1,6,0,D
1932-12-03,1932,Middlesbrough,West Bromwich Albion,3-1,3,1,1,1,4,2,H
1932-12-03,1932,Newcastle United,Leeds United,3-1,3,1,1,1,4,2,H
1932-12-03,1932,Portsmouth,Arsenal,1-3,1,3,1,1,4,-2,A
1932-12-03,1932,Sheffield United,Derby County,4-3,4,3,1,1,7,1,H
1932-12-03,1932,Wolverhampton Wanderers,Blackburn Rovers,5-3,5,3,1,1,8,2,H
1932-12-10,1932,Arsenal,Chelsea,4-1,4,1,1,1,5,3,H
1932-12-10,1932,Birmingham City,Liverpool,3-0,3,0,1,1,3,3,H
1932-12-10,1932,Blackburn Rovers,Newcastle United,2-1,2,1,1,1,3,1,H
1932-12-10,1932,Blackpool,Sheffield United,0-3,0,3,1,1,3,-3,A
1932-12-10,1932,Derby County,Wolverhampton Wanderers,4-4,4,4,1,1,8,0,D
1932-12-10,1932,Everton,Huddersfield Town,2-0,2,0,1,1,2,2,H
1932-12-10,1932,Leeds United,Aston Villa,1-1,1,1,1,1,2,0,D
1932-12-10,1932,Manchester City,Portsmouth,3-1,3,1,1,1,4,2,H
1932-12-10,1932,Sheffield Wednesday,Middlesbrough,2-1,2,1,1,1,3,1,H
1932-12-10,1932,Sunderland,Leicester City,2-1,2,1,1,1,3,1,H
1932-12-10,1932,West Bromwich Albion,Bolton Wanderers,4-0,4,0,1,1,4,4,H
1932-12-17,1932,Aston Villa,Blackburn Rovers,4-0,4,0,1,1,4,4,H
1932-12-17,1932,Bolton Wanderers,Sheffield Wednesday,3-0,3,0,1,1,3,3,H
1932-12-17,1932,Chelsea,Manchester City,3-1,3,1,1,1,4,2,H
1932-12-17,1932,Huddersfield Town,Arsenal,0-1,0,1,1,1,1,-1,A
1932-12-17,1932,Leicester City,Birmingham City,2-2,2,2,1,1,4,0,D
1932-12-17,1932,Liverpool,West Bromwich Albion,2-0,2,0,1,1,2,2,H
1932-12-17,1932,Middlesbrough,Leeds United,0-1,0,1,1,1,1,-1,A
1932-12-17,1932,Newcastle United,Derby County,0-0,0,0,1,1,0,0,D
1932-12-17,1932,Portsmouth,Sunderland,1-3,1,3,1,1,4,-2,A
1932-12-17,1932,Sheffield United,Everton,3-2,3,2,1,1,5,1,H
1932-12-17,1932,Wolverhampton Wanderers,Blackpool,2-3,2,3,1,1,5,-1,A
1932-12-24,1932,Arsenal,Sheffield United,9-2,9,2,1,1,11,7,H
1932-12-24,1932,Birmingham City,Portsmouth,4-0,4,0,1,1,4,4,H
1932-12-24,1932,Blackburn Rovers,Middlesbrough,4-2,4,2,1,1,6,2,H
1932-12-24,1932,Blackpool,Newcastle United,0-4,0,4,1,1,4,-4,A
1932-12-24,1932,Derby County,Aston Villa,0-0,0,0,1,1,0,0,D
1932-12-24,1932,Everton,Wolverhampton Wanderers,5-1,5,1,1,1,6,4,H
1932-12-24,1932,Leeds United,Bolton Wanderers,4-3,4,3,1,1,7,1,H
1932-12-24,1932,Manchester City,Huddersfield Town,3-0,3,0,1,1,3,3,H
1932-12-24,1932,Sheffield Wednesday,Liverpool,3-0,3,0,1,1,3,3,H
1932-12-24,1932,Sunderland,Chelsea,2-1,2,1,1,1,3,1,H
1932-12-24,1932,West Bromwich Albion,Leicester City,4-3,4,3,1,1,7,1,H
1932-12-26,1932,Arsenal,Leeds United,1-2,1,2,1,1,3,-1,A
1932-12-26,1932,Aston Villa,Wolverhampton Wanderers,1-3,1,3,1,1,4,-2,A
1932-12-26,1932,Blackburn Rovers,Everton,3-1,3,1,1,1,4,2,H
1932-12-26,1932,Bolton Wanderers,Huddersfield Town,2-1,2,1,1,1,3,1,H
1932-12-26,1932,Derby County,Blackpool,1-1,1,1,1,1,2,0,D
1932-12-26,1932,Liverpool,Chelsea,3-0,3,0,1,1,3,3,H
1932-12-26,1932,Manchester City,Sheffield Wednesday,2-2,2,2,1,1,4,0,D
1932-12-26,1932,Newcastle United,Birmingham City,2-1,2,1,1,1,3,1,H
1932-12-26,1932,Portsmouth,Leicester City,2-1,2,1,1,1,3,1,H
1932-12-26,1932,West Bromwich Albion,Sunderland,5-1,5,1,1,1,6,4,H
1932-12-27,1932,Birmingham City,Newcastle United,1-2,1,2,1,1,3,-1,A
1932-12-27,1932,Blackpool,Derby County,4-1,4,1,1,1,5,3,H
1932-12-27,1932,Chelsea,Liverpool,0-2,0,2,1,1,2,-2,A
1932-12-27,1932,Everton,Blackburn Rovers,6-1,6,1,1,1,7,5,H
1932-12-27,1932,Huddersfield Town,Bolton Wanderers,2-1,2,1,1,1,3,1,H
1932-12-27,1932,Leeds United,Arsenal,0-0,0,0,1,1,0,0,D
1932-12-27,1932,Leicester City,Portsmouth,2-1,2,1,1,1,3,1,H
1932-12-27,1932,Middlesbrough,Sheffield United,2-2,2,2,1,1,4,0,D
1932-12-27,1932,Sheffield Wednesday,Manchester City,2-1,2,1,1,1,3,1,H
1932-12-27,1932,Wolverhampton Wanderers,Aston Villa,2-4,2,4,1,1,6,-2,A
1932-12-31,1932,Arsenal,Birmingham City,3-0,3,0,1,1,3,3,H
1932-12-31,1932,Aston Villa,Middlesbrough,3-1,3,1,1,1,4,2,H
1932-12-31,1932,Blackburn Rovers,Chelsea,1-3,1,3,1,1,4,-2,A
1932-12-31,1932,Blackpool,Sheffield Wednesday,3-4,3,4,1,1,7,-1,A
1932-12-31,1932,Derby County,Leeds United,5-1,5,1,1,1,6,4,H
1932-12-31,1932,Everton,West Bromwich Albion,1-2,1,2,1,1,3,-1,A
1932-12-31,1932,Huddersfield Town,Portsmouth,2-2,2,2,1,1,4,0,D
1932-12-31,1932,Manchester City,Sunderland,2-4,2,4,1,1,6,-2,A
1932-12-31,1932,Newcastle United,Bolton Wanderers,3-1,3,1,1,1,4,2,H
1932-12-31,1932,Sheffield United,Leicester City,5-2,5,2,1,1,7,3,H
1932-12-31,1932,Wolverhampton Wanderers,Liverpool,3-1,3,1,1,1,4,2,H
1933-01-02,1932,Blackburn Rovers,Blackpool,6-5,6,5,1,1,11,1,H
1933-01-02,1932,Bolton Wanderers,Sheffield United,3-3,3,3,1,1,6,0,D
1933-01-02,1932,Middlesbrough,Newcastle United,2-3,2,3,1,1,5,-1,A
1933-01-02,1932,Sheffield Wednesday,Arsenal,3-2,3,2,1,1,5,1,H
1933-01-02,1932,Sunderland,West Bromwich Albion,2-2,2,2,1,1,4,0,D
1933-01-07,1932,Birmingham City,Everton,4-0,4,0,1,1,4,4,H
1933-01-07,1932,Bolton Wanderers,Aston Villa,0-1,0,1,1,1,1,-1,A
1933-01-07,1932,Chelsea,Huddersfield Town,0-1,0,1,1,1,1,-1,A
1933-01-07,1932,Leeds United,Blackburn Rovers,3-1,3,1,1,1,4,2,H
1933-01-07,1932,Leicester City,Wolverhampton Wanderers,2-2,2,2,1,1,4,0,D
1933-01-07,1932,Liverpool,Newcastle United,3-0,3,0,1,1,3,3,H
1933-01-07,1932,Middlesbrough,Manchester City,2-0,2,0,1,1,2,2,H
1933-01-07,1932,Portsmouth,Sheffield United,1-0,1,0,1,1,1,1,H
1933-01-07,1932,Sheffield Wednesday,Derby County,0-0,0,0,1,1,0,0,D
1933-01-07,1932,Sunderland,Arsenal,3-2,3,2,1,1,5,1,H
1933-01-07,1932,West Bromwich Albion,Blackpool,2-1,2,1,1,1,3,1,H
1933-01-21,1932,Arsenal,Manchester City,2-1,2,1,1,1,3,1,H
1933-01-21,1932,Aston Villa,Liverpool,5-2,5,2,1,1,7,3,H
1933-01-21,1932,Blackburn Rovers,Sheffield Wednesday,1-1,1,1,1,1,2,0,D
1933-01-21,1932,Blackpool,Birmingham City,0-1,0,1,1,1,1,-1,A
1933-01-21,1932,Derby County,West Bromwich Albion,2-2,2,2,1,1,4,0,D
1933-01-21,1932,Everton,Sunderland,6-1,6,1,1,1,7,5,H
1933-01-21,1932,Huddersfield Town,Leeds United,2-2,2,2,1,1,4,0,D
1933-01-21,1932,Middlesbrough,Bolton Wanderers,2-1,2,1,1,1,3,1,H
1933-01-21,1932,Newcastle United,Leicester City,2-1,2,1,1,1,3,1,H
1933-01-21,1932,Sheffield United,Chelsea,4-1,4,1,1,1,5,3,H
1933-01-21,1932,Wolverhampton Wanderers,Portsmouth,5-2,5,2,1,1,7,3,H
1933-01-28,1932,Chelsea,Wolverhampton Wanderers,3-1,3,1,1,1,4,2,H
1933-01-28,1932,Portsmouth,Newcastle United,2-0,2,0,1,1,2,2,H
1933-02-01,1932,Birmingham City,Derby County,3-1,3,1,1,1,4,2,H
1933-02-01,1932,Bolton Wanderers,Arsenal,0-4,0,4,1,1,4,-4,A
1933-02-01,1932,Huddersfield Town,Sheffield United,1-0,1,0,1,1,1,1,H
1933-02-01,1932,Liverpool,Middlesbrough,1-3,1,3,1,1,4,-2,A
1933-02-01,1932,Manchester City,Everton,3-0,3,0,1,1,3,3,H
1933-02-01,1932,Sunderland,Blackpool,1-1,1,1,1,1,2,0,D
1933-02-04,1932,Aston Villa,Portsmouth,4-1,4,1,1,1,5,3,H
1933-02-04,1932,Blackburn Rovers,Birmingham City,2-0,2,0,1,1,2,2,H
1933-02-04,1932,Blackpool,Manchester City,1-0,1,0,1,1,1,1,H
1933-02-04,1932,Bolton Wanderers,Liverpool,3-3,3,3,1,1,6,0,D
1933-02-04,1932,Derby County,Sunderland,3-0,3,0,1,1,3,3,H
1933-02-04,1932,Everton,Arsenal,1-1,1,1,1,1,2,0,D
1933-02-04,1932,Leeds United,West Bromwich Albion,1-1,1,1,1,1,2,0,D
1933-02-04,1932,Middlesbrough,Leicester City,1-1,1,1,1,1,2,0,D
1933-02-04,1932,Newcastle United,Chelsea,2-0,2,0,1,1,2,2,H
1933-02-04,1932,Sheffield United,Sheffield Wednesday,2-3,2,3,1,1,5,-1,A
1933-02-04,1932,Wolverhampton Wanderers,Huddersfield Town,6-4,6,4,1,1,10,2,H
1933-02-08,1932,Sheffield Wednesday,Leeds United,2-0,2,0,1,1,2,2,H
1933-02-08,1932,West Bromwich Albion,Blackburn Rovers,1-3,1,3,1,1,4,-2,A
1933-02-09,1932,Leicester City,Aston Villa,3-0,3,0,1,1,3,3,H
1933-02-11,1932,Arsenal,Blackpool,1-1,1,1,1,1,2,0,D
1933-02-11,1932,Birmingham City,Leeds United,2-1,2,1,1,1,3,1,H
1933-02-11,1932,Chelsea,Aston Villa,0-1,0,1,1,1,1,-1,A
1933-02-11,1932,Huddersfield Town,Newcastle United,4-0,4,0,1,1,4,4,H
1933-02-11,1932,Leicester City,Bolton Wanderers,2-0,2,0,1,1,2,2,H
1933-02-11,1932,Liverpool,Everton,7-4,7,4,1,1,11,3,H
1933-02-11,1932,Manchester City,Derby County,2-1,2,1,1,1,3,1,H
1933-02-11,1932,Portsmouth,Middlesbrough,2-0,2,0,1,1,2,2,H
1933-02-11,1932,Sheffield United,Wolverhampton Wanderers,0-0,0,0,1,1,0,0,D
1933-02-11,1932,Sunderland,Blackburn Rovers,4-2,4,2,1,1,6,2,H
1933-02-11,1932,West Bromwich Albion,Sheffield Wednesday,2-0,2,0,1,1,2,2,H
1933-02-18,1932,Aston Villa,Huddersfield Town,0-3,0,3,1,1,3,-3,A
1933-02-18,1932,Liverpool,Leicester City,1-2,1,2,1,1,3,-1,A
1933-02-18,1932,Newcastle United,Sheffield United,2-0,2,0,1,1,2,2,H
1933-02-18,1932,Wolverhampton Wanderers,West Bromwich Albion,3-3,3,3,1,1,6,0,D
1933-02-22,1932,Blackpool,Everton,2-1,2,1,1,1,3,1,H
1933-02-22,1932,Bolton Wanderers,Portsmouth,4-1,4,1,1,1,5,3,H
1933-02-22,1932,Derby County,Arsenal,2-2,2,2,1,1,4,0,D
1933-02-22,1932,Leeds United,Sunderland,2-3,2,3,1,1,5,-1,A
1933-02-23,1932,Blackburn Rovers,Manchester City,1-0,1,0,1,1,1,1,H
1933-02-25,1932,Arsenal,Blackburn Rovers,8-0,8,0,1,1,8,8,H
1933-02-25,1932,Chelsea,Bolton Wanderers,1-1,1,1,1,1,2,0,D
1933-02-25,1932,Everton,Derby County,4-2,4,2,1,1,6,2,H
1933-02-25,1932,Portsmouth,Liverpool,2-1,2,1,1,1,3,1,H
1933-02-25,1932,Sunderland,Sheffield Wednesday,1-2,1,2,1,1,3,-1,A
1933-03-01,1932,Middlesbrough,Chelsea,2-1,2,1,1,1,3,1,H
1933-03-04,1932,Arsenal,Liverpool,0-1,0,1,1,1,1,-1,A
1933-03-04,1932,Blackburn Rovers,Huddersfield Town,4-2,4,2,1,1,6,2,H
1933-03-04,1932,Blackpool,Portsmouth,0-2,0,2,1,1,2,-2,A
1933-03-04,1932,Leeds United,Sheffield United,1-3,1,3,1,1,4,-2,A
1933-03-04,1932,Sheffield Wednesday,Wolverhampton Wanderers,2-0,2,0,1,1,2,2,H
1933-03-04,1932,West Bromwich Albion,Newcastle United,3-2,3,2,1,1,5,1,H
1933-03-06,1932,Wolverhampton Wanderers,Newcastle United,1-1,1,1,1,1,2,0,D
1933-03-08,1932,Birmingham City,Aston Villa,3-2,3,2,1,1,5,1,H
1933-03-08,1932,Everton,Leicester City,6-3,6,3,1,1,9,3,H
1933-03-08,1932,Manchester City,Bolton Wanderers,2-1,2,1,1,1,3,1,H
1933-03-11,1932,Aston Villa,West Bromwich Albion,3-2,3,2,1,1,5,1,H
1933-03-11,1932,Bolton Wanderers,Sunderland,0-0,0,0,1,1,0,0,D
1933-03-11,1932,Chelsea,Blackpool,1-0,1,0,1,1,1,1,H
1933-03-11,1932,Huddersfield Town,Derby County,0-0,0,0,1,1,0,0,D
1933-03-11,1932,Leicester City,Arsenal,1-1,1,1,1,1,2,0,D
1933-03-11,1932,Liverpool,Manchester City,1-1,1,1,1,1,2,0,D
1933-03-11,1932,Middlesbrough,Birmingham City,2-2,2,2,1,1,4,0,D
1933-03-11,1932,Newcastle United,Sheffield Wednesday,3-1,3,1,1,1,4,2,H
1933-03-11,1932,Portsmouth,Everton,2-2,2,2,1,1,4,0,D
1933-03-11,1932,Sheffield United,Blackburn Rovers,2-1,2,1,1,1,3,1,H
1933-03-11,1932,Wolverhampton Wanderers,Leeds United,3-3,3,3,1,1,6,0,D
1933-03-15,1932,Huddersfield Town,Middlesbrough,0-1,0,1,1,1,1,-1,A
1933-03-18,1932,Arsenal,Wolverhampton Wanderers,1-2,1,2,1,1,3,-1,A
1933-03-18,1932,Birmingham City,Chelsea,0-0,0,0,1,1,0,0,D
1933-03-18,1932,Blackburn Rovers,Bolton Wanderers,3-2,3,2,1,1,5,1,H
1933-03-18,1932,Blackpool,Aston Villa,6-2,6,2,1,1,8,4,H
1933-03-18,1932,Leeds United,Liverpool,5-0,5,0,1,1,5,5,H
1933-03-18,1932,Sheffield Wednesday,Leicester City,4-1,4,1,1,1,5,3,H
1933-03-18,1932,Sunderland,Huddersfield Town,1-2,1,2,1,1,3,-1,A
1933-03-18,1932,West Bromwich Albion,Portsmouth,4-2,4,2,1,1,6,2,H
1933-03-22,1932,Manchester City,Sheffield United,1-0,1,0,1,1,1,1,H
1933-03-22,1932,Sunderland,Middlesbrough,0-0,0,0,1,1,0,0,D
1933-03-25,1932,Aston Villa,Everton,2-1,2,1,1,1,3,1,H
1933-03-25,1932,Bolton Wanderers,Derby County,1-1,1,1,1,1,2,0,D
1933-03-25,1932,Chelsea,West Bromwich Albion,1-2,1,2,1,1,3,-1,A
1933-03-25,1932,Huddersfield Town,Birmingham City,0-0,0,0,1,1,0,0,D
1933-03-25,1932,Leicester City,Leeds United,3-1,3,1,1,1,4,2,H
1933-03-25,1932,Liverpool,Blackburn Rovers,2-2,2,2,1,1,4,0,D
1933-03-25,1932,Middlesbrough,Blackpool,2-0,2,0,1,1,2,2,H
1933-03-25,1932,Newcastle United,Arsenal,2-1,2,1,1,1,3,1,H
1933-03-25,1932,Portsmouth,Sheffield Wednesday,3-0,3,0,1,1,3,3,H
1933-03-25,1932,Sheffield United,Sunderland,3-0,3,0,1,1,3,3,H
1933-03-25,1932,Wolverhampton Wanderers,Manchester City,1-2,1,2,1,1,3,-1,A
1933-03-27,1932,Sheffield United,Middlesbrough,2-0,2,0,1,1,2,2,H
1933-03-29,1932,Derby County,Chelsea,0-1,0,1,1,1,1,-1,A
1933-03-30,1932,Leicester City,Blackpool,3-0,3,0,1,1,3,3,H
1933-04-01,1932,Arsenal,Aston Villa,5-0,5,0,1,1,5,5,H
1933-04-01,1932,Birmingham City,Sheffield United,4-1,4,1,1,1,5,3,H
1933-04-01,1932,Blackburn Rovers,Leicester City,1-1,1,1,1,1,2,0,D
1933-04-01,1932,Blackpool,Bolton Wanderers,1-3,1,3,1,1,4,-2,A
1933-04-01,1932,Derby County,Liverpool,1-1,1,1,1,1,2,0,D
1933-04-01,1932,Everton,Middlesbrough,0-0,0,0,1,1,0,0,D
1933-04-01,1932,Leeds United,Portsmouth,0-1,0,1,1,1,1,-1,A
1933-04-01,1932,Manchester City,Newcastle United,1-2,1,2,1,1,3,-1,A
1933-04-01,1932,Sheffield Wednesday,Chelsea,2-2,2,2,1,1,4,0,D
1933-04-01,1932,Sunderland,Wolverhampton Wanderers,0-1,0,1,1,1,1,-1,A
1933-04-01,1932,West Bromwich Albion,Huddersfield Town,2-1,2,1,1,1,3,1,H
1933-04-05,1932,Derby County,Middlesbrough,2-2,2,2,1,1,4,0,D
1933-04-05,1932,Everton,Newcastle United,0-0,0,0,1,1,0,0,D
1933-04-05,1932,Manchester City,Leeds United,0-0,0,0,1,1,0,0,D
1933-04-05,1932,Sheffield Wednesday,Birmingham City,1-1,1,1,1,1,2,0,D
1933-04-08,1932,Aston Villa,Manchester City,1-1,1,1,1,1,2,0,D
1933-04-08,1932,Bolton Wanderers,Everton,2-4,2,4,1,1,6,-2,A
1933-04-08,1932,Chelsea,Leeds United,6-0,6,0,1,1,6,6,H
1933-04-08,1932,Huddersfield Town,Sheffield Wednesday,4-0,4,0,1,1,4,4,H
1933-04-08,1932,Leicester City,Derby County,4-0,4,0,1,1,4,4,H
1933-04-08,1932,Liverpool,Blackpool,4-3,4,3,1,1,7,1,H
1933-04-08,1932,Middlesbrough,Arsenal,3-4,3,4,1,1,7,-1,A
1933-04-08,1932,Newcastle United,Sunderland,0-1,0,1,1,1,1,-1,A
1933-04-08,1932,Portsmouth,Blackburn Rovers,2-0,2,0,1,1,2,2,H
1933-04-08,1932,Sheffield United,West Bromwich Albion,1-1,1,1,1,1,2,0,D
1933-04-08,1932,Wolverhampton Wanderers,Birmingham City,1-0,1,0,1,1,1,1,H
1933-04-14,1932,Arsenal,Sheffield Wednesday,4-2,4,2,1,1,6,2,H
1933-04-14,1932,Blackpool,Blackburn Rovers,3-0,3,0,1,1,3,3,H
1933-04-14,1932,Chelsea,Leicester City,4-1,4,1,1,1,5,3,H
1933-04-14,1932,Liverpool,Huddersfield Town,2-2,2,2,1,1,4,0,D
1933-04-14,1932,Manchester City,West Bromwich Albion,1-0,1,0,1,1,1,1,H
1933-04-14,1932,Portsmouth,Derby County,2-0,2,0,1,1,2,2,H
1933-04-14,1932,Sunderland,Birmingham City,1-0,1,0,1,1,1,1,H
1933-04-14,1932,Wolverhampton Wanderers,Middlesbrough,2-0,2,0,1,1,2,2,H
1933-04-15,1932,Arsenal,Portsmouth,2-0,2,0,1,1,2,2,H
1933-04-15,1932,Birmingham City,Bolton Wanderers,2-1,2,1,1,1,3,1,H
1933-04-15,1932,Blackburn Rovers,Wolverhampton Wanderers,1-0,1,0,1,1,1,1,H
1933-04-15,1932,Blackpool,Huddersfield Town,1-1,1,1,1,1,2,0,D
1933-04-15,1932,Derby County,Sheffield United,3-0,3,0,1,1,3,3,H
1933-04-15,1932,Everton,Chelsea,3-2,3,2,1,1,5,1,H
1933-04-15,1932,Leeds United,Newcastle United,6-1,6,1,1,1,7,5,H
1933-04-15,1932,Manchester City,Leicester City,4-1,4,1,1,1,5,3,H
1933-04-15,1932,Sheffield Wednesday,Aston Villa,0-2,0,2,1,1,2,-2,A
1933-04-15,1932,Sunderland,Liverpool,0-0,0,0,1,1,0,0,D
1933-04-15,1932,West Bromwich Albion,Middlesbrough,0-1,0,1,1,1,1,-1,A
1933-04-17,1932,Birmingham City,Sunderland,2-0,2,0,1,1,2,2,H
1933-04-17,1932,Derby County,Portsmouth,2-0,2,0,1,1,2,2,H
1933-04-17,1932,Everton,Leeds United,0-1,0,1,1,1,1,-1,A
1933-04-17,1932,Middlesbrough,Wolverhampton Wanderers,2-1,2,1,1,1,3,1,H
1933-04-17,1932,Newcastle United,Aston Villa,3-1,3,1,1,1,4,2,H
1933-04-17,1932,Sheffield United,Bolton Wanderers,3-2,3,2,1,1,5,1,H
1933-04-17,1932,West Bromwich Albion,Manchester City,4-0,4,0,1,1,4,4,H
1933-04-18,1932,Aston Villa,Newcastle United,3-0,3,0,1,1,3,3,H
1933-04-18,1932,Huddersfield Town,Liverpool,3-1,3,1,1,1,4,2,H
1933-04-18,1932,Leeds United,Everton,1-0,1,0,1,1,1,1,H
1933-04-18,1932,Leicester City,Chelsea,1-1,1,1,1,1,2,0,D
1933-04-22,1932,Aston Villa,Leeds United,0-0,0,0,1,1,0,0,D
1933-04-22,1932,Bolton Wanderers,West Bromwich Albion,2-2,2,2,1,1,4,0,D
1933-04-22,1932,Chelsea,Arsenal,1-3,1,3,1,1,4,-2,A
1933-04-22,1932,Huddersfield Town,Everton,0-0,0,0,1,1,0,0,D
1933-04-22,1932,Leicester City,Sunderland,4-2,4,2,1,1,6,2,H
1933-04-22,1932,Liverpool,Birmingham City,1-0,1,0,1,1,1,1,H
1933-04-22,1932,Middlesbrough,Sheffield Wednesday,1-1,1,1,1,1,2,0,D
1933-04-22,1932,Newcastle United,Blackburn Rovers,2-1,2,1,1,1,3,1,H
1933-04-22,1932,Portsmouth,Manchester City,1-2,1,2,1,1,3,-1,A
1933-04-22,1932,Sheffield United,Blackpool,1-0,1,0,1,1,1,1,H
1933-04-22,1932,Wolverhampton Wanderers,Derby County,3-1,3,1,1,1,4,2,H
1933-04-24,1932,Sheffield United,Aston Villa,1-0,1,0,1,1,1,1,H
1933-04-26,1932,Birmingham City,West Bromwich Albion,1-1,1,1,1,1,2,0,D
1933-04-29,1932,Arsenal,Huddersfield Town,2-2,2,2,1,1,4,0,D
1933-04-29,1932,Birmingham City,Leicester City,0-4,0,4,1,1,4,-4,A
1933-04-29,1932,Blackburn Rovers,Aston Villa,0-5,0,5,1,1,5,-5,A
1933-04-29,1932,Blackpool,Wolverhampton Wanderers,2-2,2,2,1,1,4,0,D
1933-04-29,1932,Derby County,Newcastle United,3-2,3,2,1,1,5,1,H
1933-04-29,1932,Leeds United,Middlesbrough,0-1,0,1,1,1,1,-1,A
1933-04-29,1932,Sheffield Wednesday,Bolton Wanderers,2-0,2,0,1,1,2,2,H
1933-04-29,1932,Sunderland,Portsmouth,0-3,0,3,1,1,3,-3,A
1933-04-29,1932,West Bromwich Albion,Liverpool,2-1,2,1,1,1,3,1,H
1933-05-03,1932,Everton,Sheffield United,1-0,1,0,1,1,1,1,H
1933-05-03,1932,Manchester City,Chelsea,1-4,1,4,1,1,5,-3,A
1933-05-06,1932,Aston Villa,Derby County,2-0,2,0,1,1,2,2,H
1933-05-06,1932,Bolton Wanderers,Leeds United,5-0,5,0,1,1,5,5,H
1933-05-06,1932,Chelsea,Sunderland,1-1,1,1,1,1,2,0,D
1933-05-06,1932,Huddersfield Town,Manchester City,1-0,1,0,1,1,1,1,H
1933-05-06,1932,Leicester City,West Bromwich Albion,6-2,6,2,1,1,8,4,H
1933-05-06,1932,Liverpool,Sheffield Wednesday,4-1,4,1,1,1,5,3,H
1933-05-06,1932,Middlesbrough,Blackburn Rovers,4-0,4,0,1,1,4,4,H
1933-05-06,1932,Newcastle United,Blackpool,1-2,1,2,1,1,3,-1,A
1933-05-06,1932,Portsmouth,Birmingham City,1-1,1,1,1,1,2,0,D
1933-05-06,1932,Sheffield United,Arsenal,3-1,3,1,1,1,4,2,H
1933-05-06,1932,Wolverhampton Wanderers,Everton,4-2,4,2,1,1,6,2,H
1933-08-26,1933,Arsenal,Birmingham City,1-1,1,1,1,1,2,0,D
1933-08-26,1933,Aston Villa,Leicester City,2-3,2,3,1,1,5,-1,A
1933-08-26,1933,Blackburn Rovers,Leeds United,4-2,4,2,1,1,6,2,H
1933-08-26,1933,Everton,West Bromwich Albion,1-0,1,0,1,1,1,1,H
1933-08-26,1933,Huddersfield Town,Sunderland,2-1,2,1,1,1,3,1,H
1933-08-26,1933,Manchester City,Sheffield Wednesday,2-3,2,3,1,1,5,-1,A
1933-08-26,1933,Middlesbrough,Derby County,3-1,3,1,1,1,4,2,H
1933-08-26,1933,Newcastle United,Portsmouth,2-2,2,2,1,1,4,0,D
1933-08-26,1933,Sheffield United,Tottenham Hotspur,0-0,0,0,1,1,0,0,D
1933-08-26,1933,Stoke City,Chelsea,1-0,1,0,1,1,1,1,H
1933-08-26,1933,Wolverhampton Wanderers,Liverpool,3-2,3,2,1,1,5,1,H
1933-08-28,1933,Leeds United,Middlesbrough,5-2,5,2,1,1,7,3,H
1933-08-28,1933,Leicester City,Sheffield United,4-0,4,0,1,1,4,4,H
1933-08-28,1933,Sheffield Wednesday,Aston Villa,1-2,1,2,1,1,3,-1,A
1933-08-28,1933,Tottenham Hotspur,Wolverhampton Wanderers,4-0,4,0,1,1,4,4,H
1933-08-30,1933,Birmingham City,Manchester City,0-1,0,1,1,1,1,-1,A
1933-08-30,1933,Derby County,Everton,1-1,1,1,1,1,2,0,D
1933-08-30,1933,Liverpool,Stoke City,1-1,1,1,1,1,2,0,D
1933-08-30,1933,Sunderland,Portsmouth,0-2,0,2,1,1,2,-2,A
1933-09-02,1933,Birmingham City,Everton,2-2,2,2,1,1,4,0,D
1933-09-02,1933,Chelsea,Wolverhampton Wanderers,5-2,5,2,1,1,7,3,H
1933-09-02,1933,Derby County,Blackburn Rovers,1-1,1,1,1,1,2,0,D
1933-09-02,1933,Leeds United,Newcastle United,3-0,3,0,1,1,3,3,H
1933-09-02,1933,Leicester City,Manchester City,0-0,0,0,1,1,0,0,D
1933-09-02,1933,Liverpool,Sheffield United,3-2,3,2,1,1,5,1,H
1933-09-02,1933,Portsmouth,Huddersfield Town,3-0,3,0,1,1,3,3,H
1933-09-02,1933,Sheffield Wednesday,Arsenal,1-2,1,2,1,1,3,-1,A
1933-09-02,1933,Sunderland,Stoke City,4-1,4,1,1,1,5,3,H
1933-09-02,1933,Tottenham Hotspur,Aston Villa,3-2,3,2,1,1,5,1,H
1933-09-02,1933,West Bromwich Albion,Middlesbrough,3-0,3,0,1,1,3,3,H
1933-09-04,1933,Aston Villa,Sheffield Wednesday,1-0,1,0,1,1,1,1,H
1933-09-04,1933,Huddersfield Town,Chelsea,6-1,6,1,1,1,7,5,H
1933-09-04,1933,Sheffield United,Leicester City,2-1,2,1,1,1,3,1,H
1933-09-04,1933,Stoke City,Liverpool,1-1,1,1,1,1,2,0,D
1933-09-04,1933,Wolverhampton Wanderers,Tottenham Hotspur,1-0,1,0,1,1,1,1,H
1933-09-06,1933,Arsenal,West Bromwich Albion,3-1,3,1,1,1,4,2,H
1933-09-06,1933,Manchester City,Birmingham City,1-0,1,0,1,1,1,1,H
1933-09-06,1933,Newcastle United,Blackburn Rovers,3-1,3,1,1,1,4,2,H
1933-09-06,1933,Portsmouth,Sunderland,0-0,0,0,1,1,0,0,D
1933-09-09,1933,Arsenal,Manchester City,1-1,1,1,1,1,2,0,D
1933-09-09,1933,Aston Villa,Liverpool,4-2,4,2,1,1,6,2,H
1933-09-09,1933,Blackburn Rovers,West Bromwich Albion,4-0,4,0,1,1,4,4,H
1933-09-09,1933,Everton,Sheffield Wednesday,2-3,2,3,1,1,5,-1,A
1933-09-09,1933,Huddersfield Town,Leeds United,0-0,0,0,1,1,0,0,D
1933-09-09,1933,Leicester City,Tottenham Hotspur,1-3,1,3,1,1,4,-2,A
1933-09-09,1933,Middlesbrough,Birmingham City,0-3,0,3,1,1,3,-3,A
1933-09-09,1933,Newcastle United,Derby County,1-1,1,1,1,1,2,0,D
1933-09-09,1933,Sheffield United,Chelsea,4-1,4,1,1,1,5,3,H
1933-09-09,1933,Stoke City,Portsmouth,2-1,2,1,1,1,3,1,H
1933-09-09,1933,Wolverhampton Wanderers,Sunderland,1-6,1,6,1,1,7,-5,A
1933-09-13,1933,Chelsea,Huddersfield Town,2-3,2,3,1,1,5,-1,A
1933-09-13,1933,West Bromwich Albion,Arsenal,1-0,1,0,1,1,1,1,H
1933-09-16,1933,Birmingham City,Blackburn Rovers,2-0,2,0,1,1,2,2,H
1933-09-16,1933,Chelsea,Aston Villa,1-0,1,0,1,1,1,1,H
1933-09-16,1933,Derby County,Leeds United,3-1,3,1,1,1,4,2,H
1933-09-16,1933,Huddersfield Town,Stoke City,2-2,2,2,1,1,4,0,D
1933-09-16,1933,Liverpool,Leicester City,1-3,1,3,1,1,4,-2,A
1933-09-16,1933,Manchester City,Everton,2-2,2,2,1,1,4,0,D
1933-09-16,1933,Portsmouth,Wolverhampton Wanderers,1-1,1,1,1,1,2,0,D
1933-09-16,1933,Sheffield Wednesday,Middlesbrough,3-0,3,0,1,1,3,3,H
1933-09-16,1933,Sunderland,Sheffield United,5-0,5,0,1,1,5,5,H
1933-09-16,1933,Tottenham Hotspur,Arsenal,1-1,1,1,1,1,2,0,D
1933-09-16,1933,West Bromwich Albion,Newcastle United,1-1,1,1,1,1,2,0,D
1933-09-18,1933,Blackburn Rovers,Newcastle United,3-2,3,2,1,1,5,1,H
1933-09-23,1933,Aston Villa,Sunderland,2-1,2,1,1,1,3,1,H
1933-09-23,1933,Blackburn Rovers,Sheffield Wednesday,3-1,3,1,1,1,4,2,H
1933-09-23,1933,Everton,Arsenal,3-1,3,1,1,1,4,2,H
1933-09-23,1933,Leeds United,West Bromwich Albion,3-0,3,0,1,1,3,3,H
1933-09-23,1933,Leicester City,Chelsea,1-1,1,1,1,1,2,0,D
1933-09-23,1933,Middlesbrough,Manchester City,2-1,2,1,1,1,3,1,H
1933-09-23,1933,Newcastle United,Birmingham City,0-0,0,0,1,1,0,0,D
1933-09-23,1933,Sheffield United,Portsmouth,0-1,0,1,1,1,1,-1,A
1933-09-23,1933,Stoke City,Derby County,0-4,0,4,1,1,4,-4,A
1933-09-23,1933,Tottenham Hotspur,Liverpool,0-3,0,3,1,1,3,-3,A
1933-09-23,1933,Wolverhampton Wanderers,Huddersfield Town,5-2,5,2,1,1,7,3,H
1933-09-30,1933,Arsenal,Middlesbrough,6-0,6,0,1,1,6,6,H
1933-09-30,1933,Birmingham City,Leeds United,4-0,4,0,1,1,4,4,H
1933-09-30,1933,Chelsea,Tottenham Hotspur,0-4,0,4,1,1,4,-4,A
1933-09-30,1933,Huddersfield Town,Sheffield United,6-1,6,1,1,1,7,5,H
1933-09-30,1933,Liverpool,Everton,3-2,3,2,1,1,5,1,H
1933-09-30,1933,Manchester City,Blackburn Rovers,3-1,3,1,1,1,4,2,H
1933-09-30,1933,Portsmouth,Aston Villa,3-2,3,2,1,1,5,1,H
1933-09-30,1933,Sheffield Wednesday,Newcastle United,3-1,3,1,1,1,4,2,H
1933-09-30,1933,Stoke City,Wolverhampton Wanderers,1-1,1,1,1,1,2,0,D
1933-09-30,1933,Sunderland,Leicester City,2-1,2,1,1,1,3,1,H
1933-09-30,1933,West Bromwich Albion,Derby County,5-1,5,1,1,1,6,4,H
1933-10-07,1933,Aston Villa,Huddersfield Town,4-3,4,3,1,1,7,1,H
1933-10-07,1933,Blackburn Rovers,Arsenal,2-2,2,2,1,1,4,0,D
1933-10-07,1933,Derby County,Birmingham City,4-0,4,0,1,1,4,4,H
1933-10-07,1933,Leeds United,Sheffield Wednesday,2-1,2,1,1,1,3,1,H
1933-10-07,1933,Leicester City,Portsmouth,2-1,2,1,1,1,3,1,H
1933-10-07,1933,Liverpool,Chelsea,3-0,3,0,1,1,3,3,H
1933-10-07,1933,Middlesbrough,Everton,2-0,2,0,1,1,2,2,H
1933-10-07,1933,Newcastle United,Manchester City,2-2,2,2,1,1,4,0,D
1933-10-07,1933,Sheffield United,Stoke City,1-2,1,2,1,1,3,-1,A
1933-10-07,1933,Tottenham Hotspur,Sunderland,3-1,3,1,1,1,4,2,H
1933-10-07,1933,Wolverhampton Wanderers,West Bromwich Albion,0-0,0,0,1,1,0,0,D
1933-10-14,1933,Arsenal,Newcastle United,3-0,3,0,1,1,3,3,H
1933-10-14,1933,Birmingham City,West Bromwich Albion,0-1,0,1,1,1,1,-1,A
1933-10-14,1933,Chelsea,Middlesbrough,2-3,2,3,1,1,5,-1,A
1933-10-14,1933,Everton,Blackburn Rovers,7-1,7,1,1,1,8,6,H
1933-10-14,1933,Huddersfield Town,Leicester City,5-1,5,1,1,1,6,4,H
1933-10-14,1933,Manchester City,Leeds United,0-1,0,1,1,1,1,-1,A
1933-10-14,1933,Portsmouth,Tottenham Hotspur,0-1,0,1,1,1,1,-1,A
1933-10-14,1933,Sheffield Wednesday,Derby County,1-1,1,1,1,1,2,0,D
1933-10-14,1933,Stoke City,Aston Villa,1-1,1,1,1,1,2,0,D
1933-10-14,1933,Sunderland,Liverpool,4-1,4,1,1,1,5,3,H
1933-10-14,1933,Wolverhampton Wanderers,Sheffield United,3-2,3,2,1,1,5,1,H
1933-10-21,1933,Arsenal,Leicester City,2-0,2,0,1,1,2,2,H
1933-10-21,1933,Birmingham City,Wolverhampton Wanderers,0-0,0,0,1,1,0,0,D
1933-10-21,1933,Blackburn Rovers,Chelsea,4-2,4,2,1,1,6,2,H
1933-10-21,1933,Derby County,Huddersfield Town,1-1,1,1,1,1,2,0,D
1933-10-21,1933,Everton,Tottenham Hotspur,1-1,1,1,1,1,2,0,D
1933-10-21,1933,Leeds United,Portsmouth,1-0,1,0,1,1,1,1,H
1933-10-21,1933,Manchester City,Aston Villa,1-0,1,0,1,1,1,1,H
1933-10-21,1933,Middlesbrough,Liverpool,4-1,4,1,1,1,5,3,H
1933-10-21,1933,Newcastle United,Sunderland,2-1,2,1,1,1,3,1,H
1933-10-21,1933,Sheffield Wednesday,Sheffield United,0-1,0,1,1,1,1,-1,A
1933-10-21,1933,West Bromwich Albion,Stoke City,5-1,5,1,1,1,6,4,H
1933-10-28,1933,Aston Villa,Arsenal,2-3,2,3,1,1,5,-1,A
1933-10-28,1933,Chelsea,Newcastle United,2-1,2,1,1,1,3,1,H
1933-10-28,1933,Huddersfield Town,West Bromwich Albion,3-1,3,1,1,1,4,2,H
1933-10-28,1933,Leicester City,Everton,3-1,3,1,1,1,4,2,H
1933-10-28,1933,Liverpool,Blackburn Rovers,4-0,4,0,1,1,4,4,H
1933-10-28,1933,Portsmouth,Derby County,1-0,1,0,1,1,1,1,H
1933-10-28,1933,Sheffield United,Manchester City,1-1,1,1,1,1,2,0,D
1933-10-28,1933,Stoke City,Birmingham City,1-1,1,1,1,1,2,0,D
1933-10-28,1933,Sunderland,Leeds United,4-2,4,2,1,1,6,2,H
1933-10-28,1933,Tottenham Hotspur,Middlesbrough,2-0,2,0,1,1,2,2,H
1933-10-28,1933,Wolverhampton Wanderers,Sheffield Wednesday,6-2,6,2,1,1,8,4,H
1933-11-04,1933,Arsenal,Portsmouth,1-1,1,1,1,1,2,0,D
1933-11-04,1933,Birmingham City,Liverpool,1-2,1,2,1,1,3,-1,A
1933-11-04,1933,Blackburn Rovers,Wolverhampton Wanderers,7-1,7,1,1,1,8,6,H
1933-11-04,1933,Derby County,Leicester City,2-1,2,1,1,1,3,1,H
1933-11-04,1933,Everton,Huddersfield Town,0-1,0,1,1,1,1,-1,A
1933-11-04,1933,Leeds United,Aston Villa,2-4,2,4,1,1,6,-2,A
1933-11-04,1933,Manchester City,Sunderland,4-1,4,1,1,1,5,3,H
1933-11-04,1933,Middlesbrough,Stoke City,6-1,6,1,1,1,7,5,H
1933-11-04,1933,Newcastle United,Sheffield United,3-1,3,1,1,1,4,2,H
1933-11-04,1933,Sheffield Wednesday,Chelsea,2-1,2,1,1,1,3,1,H
1933-11-04,1933,West Bromwich Albion,Tottenham Hotspur,1-2,1,2,1,1,3,-1,A
1933-11-11,1933,Aston Villa,Middlesbrough,3-0,3,0,1,1,3,3,H
1933-11-11,1933,Chelsea,Derby County,0-2,0,2,1,1,2,-2,A
1933-11-11,1933,Huddersfield Town,Sheffield Wednesday,3-2,3,2,1,1,5,1,H
1933-11-11,1933,Leicester City,Blackburn Rovers,1-2,1,2,1,1,3,-1,A
1933-11-11,1933,Liverpool,Leeds United,4-3,4,3,1,1,7,1,H
1933-11-11,1933,Portsmouth,Birmingham City,0-2,0,2,1,1,2,-2,A
1933-11-11,1933,Sheffield United,Everton,1-1,1,1,1,1,2,0,D
1933-11-11,1933,Stoke City,Manchester City,0-1,0,1,1,1,1,-1,A
1933-11-11,1933,Sunderland,West Bromwich Albion,2-2,2,2,1,1,4,0,D
1933-11-11,1933,Tottenham Hotspur,Newcastle United,4-0,4,0,1,1,4,4,H
1933-11-11,1933,Wolverhampton Wanderers,Arsenal,0-1,0,1,1,1,1,-1,A
1933-11-18,1933,Arsenal,Stoke City,3-0,3,0,1,1,3,3,H
1933-11-18,1933,Birmingham City,Sunderland,1-1,1,1,1,1,2,0,D
1933-11-18,1933,Blackburn Rovers,Aston Villa,2-1,2,1,1,1,3,1,H
1933-11-18,1933,Derby County,Liverpool,3-1,3,1,1,1,4,2,H
1933-11-18,1933,Everton,Wolverhampton Wanderers,1-2,1,2,1,1,3,-1,A
1933-11-18,1933,Leeds United,Tottenham Hotspur,0-0,0,0,1,1,0,0,D
1933-11-18,1933,Manchester City,Huddersfield Town,2-2,2,2,1,1,4,0,D
1933-11-18,1933,Middlesbrough,Sheffield United,10-3,10,3,1,1,13,7,H
1933-11-18,1933,Newcastle United,Leicester City,1-1,1,1,1,1,2,0,D
1933-11-18,1933,Sheffield Wednesday,Portsmouth,1-2,1,2,1,1,3,-1,A
1933-11-18,1933,West Bromwich Albion,Chelsea,3-1,3,1,1,1,4,2,H
1933-11-25,1933,Aston Villa,Newcastle United,2-3,2,3,1,1,5,-1,A
1933-11-25,1933,Chelsea,Birmingham City,1-1,1,1,1,1,2,0,D
1933-11-25,1933,Huddersfield Town,Arsenal,0-1,0,1,1,1,1,-1,A
1933-11-25,1933,Leicester City,Leeds United,2-2,2,2,1,1,4,0,D
1933-11-25,1933,Liverpool,West Bromwich Albion,1-1,1,1,1,1,2,0,D
1933-11-25,1933,Portsmouth,Manchester City,2-0,2,0,1,1,2,2,H
1933-11-25,1933,Sheffield United,Blackburn Rovers,1-0,1,0,1,1,1,1,H
1933-11-25,1933,Stoke City,Everton,1-2,1,2,1,1,3,-1,A
1933-11-25,1933,Sunderland,Sheffield Wednesday,4-0,4,0,1,1,4,4,H
1933-11-25,1933,Tottenham Hotspur,Derby County,1-2,1,2,1,1,3,-1,A
1933-11-25,1933,Wolverhampton Wanderers,Middlesbrough,0-1,0,1,1,1,1,-1,A
1933-12-02,1933,Arsenal,Liverpool,2-1,2,1,1,1,3,1,H
1933-12-02,1933,Birmingham City,Aston Villa,0-0,0,0,1,1,0,0,D
1933-12-02,1933,Blackburn Rovers,Portsmouth,3-2,3,2,1,1,5,1,H
1933-12-02,1933,Derby County,Wolverhampton Wanderers,3-1,3,1,1,1,4,2,H
1933-12-02,1933,Everton,Chelsea,2-1,2,1,1,1,3,1,H
1933-12-02,1933,Leeds United,Stoke City,2-0,2,0,1,1,2,2,H
1933-12-02,1933,Manchester City,Tottenham Hotspur,2-0,2,0,1,1,2,2,H
1933-12-02,1933,Middlesbrough,Sunderland,0-4,0,4,1,1,4,-4,A
1933-12-02,1933,Newcastle United,Huddersfield Town,3-3,3,3,1,1,6,0,D
1933-12-02,1933,Sheffield Wednesday,Leicester City,1-1,1,1,1,1,2,0,D
1933-12-02,1933,West Bromwich Albion,Sheffield United,3-0,3,0,1,1,3,3,H
1933-12-09,1933,Aston Villa,Derby County,0-2,0,2,1,1,2,-2,A
1933-12-09,1933,Chelsea,Manchester City,1-2,1,2,1,1,3,-1,A
1933-12-09,1933,Huddersfield Town,Middlesbrough,2-1,2,1,1,1,3,1,H
1933-12-09,1933,Leicester City,West Bromwich Albion,0-1,0,1,1,1,1,-1,A
1933-12-09,1933,Liverpool,Sheffield Wednesday,1-3,1,3,1,1,4,-2,A
1933-12-09,1933,Portsmouth,Everton,0-0,0,0,1,1,0,0,D
1933-12-09,1933,Sheffield United,Leeds United,2-1,2,1,1,1,3,1,H
1933-12-09,1933,Stoke City,Blackburn Rovers,2-0,2,0,1,1,2,2,H
1933-12-09,1933,Sunderland,Arsenal,3-0,3,0,1,1,3,3,H
1933-12-09,1933,Tottenham Hotspur,Birmingham City,3-2,3,2,1,1,5,1,H
1933-12-09,1933,Wolverhampton Wanderers,Newcastle United,2-1,2,1,1,1,3,1,H
1933-12-16,1933,Arsenal,Chelsea,2-1,2,1,1,1,3,1,H
1933-12-16,1933,Blackburn Rovers,Huddersfield Town,2-2,2,2,1,1,4,0,D
1933-12-16,1933,Derby County,Sheffield United,5-1,5,1,1,1,6,4,H
1933-12-16,1933,Everton,Sunderland,1-0,1,0,1,1,1,1,H
1933-12-16,1933,Leeds United,Wolverhampton Wanderers,3-3,3,3,1,1,6,0,D
1933-12-16,1933,Manchester City,Liverpool,2-1,2,1,1,1,3,1,H
1933-12-16,1933,Middlesbrough,Portsmouth,2-0,2,0,1,1,2,2,H
1933-12-16,1933,Newcastle United,Stoke City,2-2,2,2,1,1,4,0,D
1933-12-16,1933,Sheffield Wednesday,Tottenham Hotspur,2-1,2,1,1,1,3,1,H
1933-12-16,1933,West Bromwich Albion,Aston Villa,2-1,2,1,1,1,3,1,H
1933-12-23,1933,Aston Villa,Everton,2-1,2,1,1,1,3,1,H
1933-12-23,1933,Chelsea,Leeds United,1-1,1,1,1,1,2,0,D
1933-12-23,1933,Huddersfield Town,Birmingham City,0-0,0,0,1,1,0,0,D
1933-12-23,1933,Leicester City,Middlesbrough,1-2,1,2,1,1,3,-1,A
1933-12-23,1933,Liverpool,Newcastle United,1-2,1,2,1,1,3,-1,A
1933-12-23,1933,Portsmouth,West Bromwich Albion,2-2,2,2,1,1,4,0,D
1933-12-23,1933,Sheffield United,Arsenal,1-3,1,3,1,1,4,-2,A
1933-12-23,1933,Stoke City,Sheffield Wednesday,0-1,0,1,1,1,1,-1,A
1933-12-23,1933,Sunderland,Derby County,0-0,0,0,1,1,0,0,D
1933-12-23,1933,Tottenham Hotspur,Blackburn Rovers,4-1,4,1,1,1,5,3,H
1933-12-23,1933,Wolverhampton Wanderers,Manchester City,8-0,8,0,1,1,8,8,H
1933-12-25,1933,Aston Villa,Wolverhampton Wanderers,6-2,6,2,1,1,8,4,H
1933-12-25,1933,Blackburn Rovers,Middlesbrough,0-0,0,0,1,1,0,0,D
1933-12-25,1933,Derby County,Manchester City,4-1,4,1,1,1,5,3,H
1933-12-25,1933,Leeds United,Arsenal,0-1,0,1,1,1,1,-1,A
1933-12-25,1933,Liverpool,Portsmouth,2-2,2,2,1,1,4,0,D
1933-12-25,1933,Newcastle United,Everton,1-2,1,2,1,1,3,-1,A
1933-12-25,1933,Sheffield United,Birmingham City,2-1,2,1,1,1,3,1,H
1933-12-25,1933,Stoke City,Leicester City,2-1,2,1,1,1,3,1,H
1933-12-25,1933,Tottenham Hotspur,Huddersfield Town,1-3,1,3,1,1,4,-2,A
1933-12-26,1933,Arsenal,Leeds United,2-0,2,0,1,1,2,2,H
1933-12-26,1933,Birmingham City,Sheffield United,4-2,4,2,1,1,6,2,H
1933-12-26,1933,Chelsea,Sunderland,4-0,4,0,1,1,4,4,H
1933-12-26,1933,Everton,Newcastle United,3-7,3,7,1,1,10,-4,A
1933-12-26,1933,Huddersfield Town,Tottenham Hotspur,2-0,2,0,1,1,2,2,H
1933-12-26,1933,Leicester City,Stoke City,3-1,3,1,1,1,4,2,H
1933-12-26,1933,Manchester City,Derby County,2-0,2,0,1,1,2,2,H
1933-12-26,1933,Middlesbrough,Blackburn Rovers,3-1,3,1,1,1,4,2,H
1933-12-26,1933,Portsmouth,Liverpool,1-0,1,0,1,1,1,1,H
1933-12-26,1933,Sheffield Wednesday,West Bromwich Albion,3-1,3,1,1,1,4,2,H
1933-12-26,1933,Wolverhampton Wanderers,Aston Villa,4-3,4,3,1,1,7,1,H
1933-12-27,1933,West Bromwich Albion,Sheffield Wednesday,1-1,1,1,1,1,2,0,D
1933-12-30,1933,Birmingham City,Arsenal,0-0,0,0,1,1,0,0,D
1933-12-30,1933,Chelsea,Stoke City,2-0,2,0,1,1,2,2,H
1933-12-30,1933,Derby County,Middlesbrough,2-0,2,0,1,1,2,2,H
1933-12-30,1933,Leeds United,Blackburn Rovers,4-0,4,0,1,1,4,4,H
1933-12-30,1933,Leicester City,Aston Villa,1-1,1,1,1,1,2,0,D
1933-12-30,1933,Liverpool,Wolverhampton Wanderers,1-1,1,1,1,1,2,0,D
1933-12-30,1933,Portsmouth,Newcastle United,2-0,2,0,1,1,2,2,H
1933-12-30,1933,Sheffield Wednesday,Manchester City,1-1,1,1,1,1,2,0,D
1933-12-30,1933,Sunderland,Huddersfield Town,1-1,1,1,1,1,2,0,D
1933-12-30,1933,Tottenham Hotspur,Sheffield United,4-1,4,1,1,1,5,3,H
1933-12-30,1933,West Bromwich Albion,Everton,3-3,3,3,1,1,6,0,D
1934-01-01,1933,Blackburn Rovers,Tottenham Hotspur,1-0,1,0,1,1,1,1,H
1934-01-01,1933,Everton,Derby County,0-3,0,3,1,1,3,-3,A
1934-01-01,1933,Manchester City,West Bromwich Albion,2-7,2,7,1,1,9,-5,A
1934-01-01,1933,Middlesbrough,Leeds United,2-1,2,1,1,1,3,1,H
1934-01-01,1933,Newcastle United,Liverpool,9-2,9,2,1,1,11,7,H
1934-01-01,1933,Sheffield United,Aston Villa,3-3,3,3,1,1,6,0,D
1934-01-01,1933,Sunderland,Chelsea,0-0,0,0,1,1,0,0,D
1934-01-02,1933,Sheffield Wednesday,Birmingham City,2-1,2,1,1,1,3,1,H
1934-01-06,1933,Arsenal,Sheffield Wednesday,1-1,1,1,1,1,2,0,D
1934-01-06,1933,Aston Villa,Tottenham Hotspur,1-5,1,5,1,1,6,-4,A
1934-01-06,1933,Blackburn Rovers,Derby County,2-1,2,1,1,1,3,1,H
1934-01-06,1933,Everton,Birmingham City,2-0,2,0,1,1,2,2,H
1934-01-06,1933,Huddersfield Town,Portsmouth,4-0,4,0,1,1,4,4,H
1934-01-06,1933,Manchester City,Leicester City,1-1,1,1,1,1,2,0,D
1934-01-06,1933,Middlesbrough,West Bromwich Albion,3-0,3,0,1,1,3,3,H
1934-01-06,1933,Newcastle United,Leeds United,2-0,2,0,1,1,2,2,H
1934-01-06,1933,Sheffield United,Liverpool,2-2,2,2,1,1,4,0,D
1934-01-06,1933,Stoke City,Sunderland,3-0,3,0,1,1,3,3,H
1934-01-06,1933,Wolverhampton Wanderers,Chelsea,1-1,1,1,1,1,2,0,D
1934-01-20,1933,Birmingham City,Middlesbrough,0-0,0,0,1,1,0,0,D
1934-01-20,1933,Chelsea,Sheffield United,5-0,5,0,1,1,5,5,H
1934-01-20,1933,Derby County,Newcastle United,1-1,1,1,1,1,2,0,D
1934-01-20,1933,Leeds United,Huddersfield Town,1-1,1,1,1,1,2,0,D
1934-01-20,1933,Liverpool,Aston Villa,2-3,2,3,1,1,5,-1,A
1934-01-20,1933,Manchester City,Arsenal,2-1,2,1,1,1,3,1,H
1934-01-20,1933,Portsmouth,Stoke City,3-1,3,1,1,1,4,2,H
1934-01-20,1933,Sheffield Wednesday,Everton,0-0,0,0,1,1,0,0,D
1934-01-20,1933,Sunderland,Wolverhampton Wanderers,3-3,3,3,1,1,6,0,D
1934-01-20,1933,Tottenham Hotspur,Leicester City,0-1,0,1,1,1,1,-1,A
1934-01-20,1933,West Bromwich Albion,Blackburn Rovers,0-1,0,1,1,1,1,-1,A
1934-01-27,1933,Newcastle United,West Bromwich Albion,1-2,1,2,1,1,3,-1,A
1934-01-29,1933,Blackburn Rovers,Birmingham City,3-1,3,1,1,1,4,2,H
1934-01-29,1933,Sheffield United,Sunderland,2-0,2,0,1,1,2,2,H
1934-01-29,1933,Stoke City,Huddersfield Town,3-0,3,0,1,1,3,3,H
1934-01-31,1933,Arsenal,Tottenham Hotspur,1-3,1,3,1,1,4,-2,A
1934-01-31,1933,Leeds United,Derby County,0-2,0,2,1,1,2,-2,A
1934-02-01,1933,Leicester City,Liverpool,1-0,1,0,1,1,1,1,H
1934-02-03,1933,Arsenal,Everton,1-2,1,2,1,1,3,-1,A
1934-02-03,1933,Birmingham City,Newcastle United,1-2,1,2,1,1,3,-1,A
1934-02-03,1933,Derby County,Stoke City,5-1,5,1,1,1,6,4,H
1934-02-03,1933,Huddersfield Town,Wolverhampton Wanderers,3-1,3,1,1,1,4,2,H
1934-02-03,1933,Liverpool,Tottenham Hotspur,3-1,3,1,1,1,4,2,H
1934-02-03,1933,Manchester City,Middlesbrough,5-2,5,2,1,1,7,3,H
1934-02-03,1933,Portsmouth,Sheffield United,1-1,1,1,1,1,2,0,D
1934-02-03,1933,Sheffield Wednesday,Blackburn Rovers,4-0,4,0,1,1,4,4,H
1934-02-03,1933,Sunderland,Aston Villa,5-1,5,1,1,1,6,4,H
1934-02-03,1933,West Bromwich Albion,Leeds United,0-3,0,3,1,1,3,-3,A
1934-02-07,1933,Aston Villa,Chelsea,2-0,2,0,1,1,2,2,H
1934-02-07,1933,Everton,Manchester City,2-0,2,0,1,1,2,2,H
1934-02-07,1933,Middlesbrough,Sheffield Wednesday,2-3,2,3,1,1,5,-1,A
1934-02-07,1933,Wolverhampton Wanderers,Portsmouth,1-1,1,1,1,1,2,0,D
1934-02-10,1933,Aston Villa,Portsmouth,1-1,1,1,1,1,2,0,D
1934-02-10,1933,Blackburn Rovers,Manchester City,3-0,3,0,1,1,3,3,H
1934-02-10,1933,Derby County,West Bromwich Albion,1-1,1,1,1,1,2,0,D
1934-02-10,1933,Everton,Liverpool,0-0,0,0,1,1,0,0,D
1934-02-10,1933,Leeds United,Birmingham City,1-0,1,0,1,1,1,1,H
1934-02-10,1933,Leicester City,Sunderland,0-0,0,0,1,1,0,0,D
1934-02-10,1933,Middlesbrough,Arsenal,0-2,0,2,1,1,2,-2,A
1934-02-10,1933,Newcastle United,Sheffield Wednesday,0-0,0,0,1,1,0,0,D
1934-02-10,1933,Sheffield United,Huddersfield Town,1-4,1,4,1,1,5,-3,A
1934-02-10,1933,Tottenham Hotspur,Chelsea,2-1,2,1,1,1,3,1,H
1934-02-10,1933,Wolverhampton Wanderers,Stoke City,0-2,0,2,1,1,2,-2,A
1934-02-17,1933,Everton,Middlesbrough,1-1,1,1,1,1,2,0,D
1934-02-17,1933,West Bromwich Albion,Wolverhampton Wanderers,2-0,2,0,1,1,2,2,H
1934-02-21,1933,Arsenal,Blackburn Rovers,2-1,2,1,1,1,3,1,H
1934-02-21,1933,Birmingham City,Derby County,2-1,2,1,1,1,3,1,H
1934-02-21,1933,Chelsea,Liverpool,2-0,2,0,1,1,2,2,H
1934-02-21,1933,Huddersfield Town,Aston Villa,2-1,2,1,1,1,3,1,H
1934-02-21,1933,Portsmouth,Leicester City,3-5,3,5,1,1,8,-2,A
1934-02-21,1933,Sunderland,Tottenham Hotspur,6-0,6,0,1,1,6,6,H
1934-02-22,1933,Stoke City,Sheffield United,3-0,3,0,1,1,3,3,H
1934-02-24,1933,Aston Villa,Stoke City,1-2,1,2,1,1,3,-1,A
1934-02-24,1933,Blackburn Rovers,Everton,1-1,1,1,1,1,2,0,D
1934-02-24,1933,Derby County,Sheffield Wednesday,1-1,1,1,1,1,2,0,D
1934-02-24,1933,Leeds United,Manchester City,3-1,3,1,1,1,4,2,H
1934-02-24,1933,Leicester City,Huddersfield Town,1-0,1,0,1,1,1,1,H
1934-02-24,1933,Liverpool,Sunderland,1-1,1,1,1,1,2,0,D
1934-02-24,1933,Middlesbrough,Chelsea,2-2,2,2,1,1,4,0,D
1934-02-24,1933,Newcastle United,Arsenal,0-1,0,1,1,1,1,-1,A
1934-02-24,1933,Sheffield United,Wolverhampton Wanderers,3-1,3,1,1,1,4,2,H
1934-02-24,1933,Tottenham Hotspur,Portsmouth,0-0,0,0,1,1,0,0,D
1934-02-24,1933,West Bromwich Albion,Birmingham City,1-2,1,2,1,1,3,-1,A
1934-02-26,1933,Sheffield Wednesday,Leeds United,0-2,0,2,1,1,2,-2,A
1934-03-03,1933,Chelsea,Blackburn Rovers,3-0,3,0,1,1,3,3,H
1934-03-03,1933,Huddersfield Town,Derby County,2-0,2,0,1,1,2,2,H
1934-03-03,1933,Liverpool,Middlesbrough,6-2,6,2,1,1,8,4,H
1934-03-03,1933,Sheffield United,Sheffield Wednesday,5-1,5,1,1,1,6,4,H
1934-03-03,1933,Sunderland,Newcastle United,2-0,2,0,1,1,2,2,H
1934-03-03,1933,Tottenham Hotspur,Everton,3-0,3,0,1,1,3,3,H
1934-03-03,1933,Wolverhampton Wanderers,Birmingham City,2-0,2,0,1,1,2,2,H
1934-03-07,1933,Aston Villa,Manchester City,0-0,0,0,1,1,0,0,D
1934-03-07,1933,Portsmouth,Leeds United,2-1,2,1,1,1,3,1,H
1934-03-08,1933,Leicester City,Arsenal,4-1,4,1,1,1,5,3,H
1934-03-08,1933,Stoke City,West Bromwich Albion,4-1,4,1,1,1,5,3,H
1934-03-10,1933,Arsenal,Aston Villa,3-2,3,2,1,1,5,1,H
1934-03-10,1933,Birmingham City,Stoke City,0-1,0,1,1,1,1,-1,A
1934-03-10,1933,Blackburn Rovers,Liverpool,3-1,3,1,1,1,4,2,H
1934-03-10,1933,Derby County,Portsmouth,0-1,0,1,1,1,1,-1,A
1934-03-10,1933,Everton,Leicester City,1-1,1,1,1,1,2,0,D
1934-03-10,1933,Leeds United,Sunderland,3-1,3,1,1,1,4,2,H
1934-03-10,1933,Manchester City,Sheffield United,4-1,4,1,1,1,5,3,H
1934-03-10,1933,Middlesbrough,Tottenham Hotspur,1-1,1,1,1,1,2,0,D
1934-03-10,1933,Newcastle United,Chelsea,2-2,2,2,1,1,4,0,D
1934-03-10,1933,Sheffield Wednesday,Wolverhampton Wanderers,2-1,2,1,1,1,3,1,H
1934-03-10,1933,West Bromwich Albion,Huddersfield Town,2-3,2,3,1,1,5,-1,A
1934-03-17,1933,Chelsea,Sheffield Wednesday,0-1,0,1,1,1,1,-1,A
1934-03-17,1933,Derby County,Sunderland,0-0,0,0,1,1,0,0,D
1934-03-17,1933,Liverpool,Birmingham City,4-1,4,1,1,1,5,3,H
1934-03-17,1933,Sheffield United,Newcastle United,4-0,4,0,1,1,4,4,H
1934-03-17,1933,Stoke City,Middlesbrough,2-0,2,0,1,1,2,2,H
1934-03-17,1933,Tottenham Hotspur,West Bromwich Albion,2-1,2,1,1,1,3,1,H
1934-03-17,1933,Wolverhampton Wanderers,Blackburn Rovers,5-3,5,3,1,1,8,2,H
1934-03-21,1933,Manchester City,Newcastle United,1-1,1,1,1,1,2,0,D
1934-03-24,1933,Arsenal,Wolverhampton Wanderers,3-2,3,2,1,1,5,1,H
1934-03-24,1933,Birmingham City,Portsmouth,3-1,3,1,1,1,4,2,H
1934-03-24,1933,Blackburn Rovers,Leicester City,3-0,3,0,1,1,3,3,H
1934-03-24,1933,Derby County,Chelsea,1-0,1,0,1,1,1,1,H
1934-03-24,1933,Everton,Sheffield United,4-0,4,0,1,1,4,4,H
1934-03-24,1933,Leeds United,Liverpool,5-1,5,1,1,1,6,4,H
1934-03-24,1933,Manchester City,Stoke City,4-2,4,2,1,1,6,2,H
1934-03-24,1933,Middlesbrough,Aston Villa,1-2,1,2,1,1,3,-1,A
1934-03-24,1933,Newcastle United,Tottenham Hotspur,1-3,1,3,1,1,4,-2,A
1934-03-24,1933,Sheffield Wednesday,Huddersfield Town,1-2,1,2,1,1,3,-1,A
1934-03-24,1933,West Bromwich Albion,Sunderland,6-5,6,5,1,1,11,1,H
1934-03-28,1933,Birmingham City,Leicester City,3-0,3,0,1,1,3,3,H
1934-03-30,1933,Arsenal,Derby County,1-0,1,0,1,1,1,1,H
1934-03-30,1933,Leeds United,Everton,2-2,2,2,1,1,4,0,D
1934-03-30,1933,Liverpool,Huddersfield Town,2-2,2,2,1,1,4,0,D
1934-03-30,1933,Newcastle United,Middlesbrough,1-1,1,1,1,1,2,0,D
1934-03-30,1933,Portsmouth,Chelsea,0-2,0,2,1,1,2,-2,A
1934-03-30,1933,Sunderland,Blackburn Rovers,3-0,3,0,1,1,3,3,H
1934-03-30,1933,Tottenham Hotspur,Stoke City,0-0,0,0,1,1,0,0,D
1934-03-31,1933,Aston Villa,Blackburn Rovers,1-1,1,1,1,1,2,0,D
1934-03-31,1933,Chelsea,West Bromwich Albion,3-2,3,2,1,1,5,1,H
1934-03-31,1933,Huddersfield Town,Manchester City,1-0,1,0,1,1,1,1,H
1934-03-31,1933,Leicester City,Newcastle United,3-2,3,2,1,1,5,1,H
1934-03-31,1933,Liverpool,Derby County,4-2,4,2,1,1,6,2,H
1934-03-31,1933,Portsmouth,Sheffield Wednesday,0-2,0,2,1,1,2,-2,A
1934-03-31,1933,Sheffield United,Middlesbrough,3-1,3,1,1,1,4,2,H
1934-03-31,1933,Stoke City,Arsenal,1-1,1,1,1,1,2,0,D
1934-03-31,1933,Sunderland,Birmingham City,4-1,4,1,1,1,5,3,H
1934-03-31,1933,Tottenham Hotspur,Leeds United,5-1,5,1,1,1,6,4,H
1934-03-31,1933,Wolverhampton Wanderers,Everton,2-0,2,0,1,1,2,2,H
1934-04-02,1933,Aston Villa,Sheffield United,3-0,3,0,1,1,3,3,H
1934-04-02,1933,Blackburn Rovers,Sunderland,0-0,0,0,1,1,0,0,D
1934-04-02,1933,Chelsea,Portsmouth,4-0,4,0,1,1,4,4,H
1934-04-02,1933,Derby County,Arsenal,2-4,2,4,1,1,6,-2,A
1934-04-02,1933,Everton,Leeds United,2-0,2,0,1,1,2,2,H
1934-04-02,1933,Middlesbrough,Newcastle United,1-0,1,0,1,1,1,1,H
1934-04-02,1933,Stoke City,Tottenham Hotspur,2-0,2,0,1,1,2,2,H
1934-04-02,1933,West Bromwich Albion,Manchester City,4-0,4,0,1,1,4,4,H
1934-04-02,1933,Wolverhampton Wanderers,Leicester City,1-1,1,1,1,1,2,0,D
1934-04-03,1933,Birmingham City,Sheffield Wednesday,3-0,3,0,1,1,3,3,H
1934-04-03,1933,Huddersfield Town,Liverpool,0-2,0,2,1,1,2,-2,A
1934-04-03,1933,Leicester City,Wolverhampton Wanderers,1-1,1,1,1,1,2,0,D
1934-04-07,1933,Arsenal,Huddersfield Town,3-1,3,1,1,1,4,2,H
1934-04-07,1933,Birmingham City,Chelsea,0-3,0,3,1,1,3,-3,A
1934-04-07,1933,Blackburn Rovers,Sheffield United,3-1,3,1,1,1,4,2,H
1934-04-07,1933,Derby County,Tottenham Hotspur,4-3,4,3,1,1,7,1,H
1934-04-07,1933,Everton,Stoke City,2-2,2,2,1,1,4,0,D
1934-04-07,1933,Leeds United,Leicester City,8-0,8,0,1,1,8,8,H
1934-04-07,1933,Manchester City,Portsmouth,2-1,2,1,1,1,3,1,H
1934-04-07,1933,Middlesbrough,Wolverhampton Wanderers,0-0,0,0,1,1,0,0,D
1934-04-07,1933,Newcastle United,Aston Villa,1-1,1,1,1,1,2,0,D
1934-04-07,1933,Sheffield Wednesday,Sunderland,2-0,2,0,1,1,2,2,H
1934-04-07,1933,West Bromwich Albion,Liverpool,2-2,2,2,1,1,4,0,D
1934-04-11,1933,Sunderland,Manchester City,0-0,0,0,1,1,0,0,D
1934-04-14,1933,Aston Villa,Birmingham City,1-1,1,1,1,1,2,0,D
1934-04-14,1933,Chelsea,Everton,2-0,2,0,1,1,2,2,H
1934-04-14,1933,Huddersfield Town,Newcastle United,4-1,4,1,1,1,5,3,H
1934-04-14,1933,Leicester City,Sheffield Wednesday,2-0,2,0,1,1,2,2,H
1934-04-14,1933,Liverpool,Arsenal,2-3,2,3,1,1,5,-1,A
1934-04-14,1933,Portsmouth,Blackburn Rovers,2-0,2,0,1,1,2,2,H
1934-04-14,1933,Sheffield United,West Bromwich Albion,0-1,0,1,1,1,1,-1,A
1934-04-14,1933,Stoke City,Leeds United,1-2,1,2,1,1,3,-1,A
1934-04-14,1933,Sunderland,Middlesbrough,2-0,2,0,1,1,2,2,H
1934-04-14,1933,Tottenham Hotspur,Manchester City,5-1,5,1,1,1,6,4,H
1934-04-14,1933,Wolverhampton Wanderers,Derby County,3-0,3,0,1,1,3,3,H
1934-04-18,1933,Portsmouth,Arsenal,1-0,1,0,1,1,1,1,H
1934-04-19,1933,Leicester City,Derby County,2-0,2,0,1,1,2,2,H
1934-04-21,1933,Arsenal,Sunderland,2-1,2,1,1,1,3,1,H
1934-04-21,1933,Birmingham City,Tottenham Hotspur,2-0,2,0,1,1,2,2,H
1934-04-21,1933,Blackburn Rovers,Stoke City,4-1,4,1,1,1,5,3,H
1934-04-21,1933,Derby County,Aston Villa,1-1,1,1,1,1,2,0,D
1934-04-21,1933,Everton,Portsmouth,1-1,1,1,1,1,2,0,D
1934-04-21,1933,Leeds United,Sheffield United,1-1,1,1,1,1,2,0,D
1934-04-21,1933,Manchester City,Chelsea,4-2,4,2,1,1,6,2,H
1934-04-21,1933,Middlesbrough,Huddersfield Town,3-0,3,0,1,1,3,3,H
1934-04-21,1933,Newcastle United,Wolverhampton Wanderers,5-1,5,1,1,1,6,4,H
1934-04-21,1933,Sheffield Wednesday,Liverpool,1-2,1,2,1,1,3,-1,A
1934-04-21,1933,West Bromwich Albion,Leicester City,2-0,2,0,1,1,2,2,H
1934-04-23,1933,Chelsea,Leicester City,2-0,2,0,1,1,2,2,H
1934-04-25,1933,Huddersfield Town,Everton,1-0,1,0,1,1,1,1,H
1934-04-28,1933,Aston Villa,West Bromwich Albion,4-4,4,4,1,1,8,0,D
1934-04-28,1933,Chelsea,Arsenal,2-2,2,2,1,1,4,0,D
1934-04-28,1933,Huddersfield Town,Blackburn Rovers,5-3,5,3,1,1,8,2,H
1934-04-28,1933,Leicester City,Birmingham City,3-7,3,7,1,1,10,-4,A
1934-04-28,1933,Sheffield United,Derby County,2-0,2,0,1,1,2,2,H
1934-04-28,1933,Stoke City,Newcastle United,2-1,2,1,1,1,3,1,H
1934-04-28,1933,Sunderland,Everton,3-2,3,2,1,1,5,1,H
1934-04-28,1933,Tottenham Hotspur,Sheffield Wednesday,4-3,4,3,1,1,7,1,H
1934-04-28,1933,Wolverhampton Wanderers,Leeds United,2-0,2,0,1,1,2,2,H
1934-04-30,1933,Aston Villa,Leeds United,3-0,3,0,1,1,3,3,H
1934-04-30,1933,Portsmouth,Middlesbrough,4-1,4,1,1,1,5,3,H
1934-05-02,1933,Liverpool,Manchester City,3-2,3,2,1,1,5,1,H
1934-05-05,1933,Arsenal,Sheffield United,2-0,2,0,1,1,2,2,H
1934-05-05,1933,Birmingham City,Huddersfield Town,1-3,1,3,1,1,4,-2,A
1934-05-05,1933,Everton,Aston Villa,2-2,2,2,1,1,4,0,D
1934-05-05,1933,Leeds United,Chelsea,3-1,3,1,1,1,4,2,H
1934-05-05,1933,Manchester City,Wolverhampton Wanderers,4-0,4,0,1,1,4,4,H
1934-05-05,1933,Middlesbrough,Leicester City,4-1,4,1,1,1,5,3,H
1934-05-05,1933,Sheffield Wednesday,Stoke City,2-2,2,2,1,1,4,0,D
1934-05-05,1933,West Bromwich Albion,Portsmouth,2-1,2,1,1,1,3,1,H
1934-08-25,1934,Birmingham City,Aston Villa,2-1,2,1,1,1,3,1,H
1934-08-25,1934,Derby County,Chelsea,3-0,3,0,1,1,3,3,H
1934-08-25,1934,Leeds United,Middlesbrough,2-4,2,4,1,1,6,-2,A
1934-08-25,1934,Leicester City,Wolverhampton Wanderers,1-1,1,1,1,1,2,0,D
1934-08-25,1934,Liverpool,Blackburn Rovers,2-0,2,0,1,1,2,2,H
1934-08-25,1934,Portsmouth,Arsenal,3-3,3,3,1,1,6,0,D
1934-08-25,1934,Preston North End,Grimsby Town,1-0,1,0,1,1,1,1,H
1934-08-25,1934,Sheffield Wednesday,Stoke City,4-1,4,1,1,1,5,3,H
1934-08-25,1934,Sunderland,Huddersfield Town,4-1,4,1,1,1,5,3,H
1934-08-25,1934,Tottenham Hotspur,Everton,1-1,1,1,1,1,2,0,D
1934-08-25,1934,West Bromwich Albion,Manchester City,1-1,1,1,1,1,2,0,D
1934-08-27,1934,Aston Villa,Wolverhampton Wanderers,2-1,2,1,1,1,3,1,H
1934-08-27,1934,Huddersfield Town,Derby County,1-0,1,0,1,1,1,1,H
1934-08-27,1934,Stoke City,Leeds United,8-1,8,1,1,1,9,7,H
1934-08-27,1934,Tottenham Hotspur,Preston North End,1-2,1,2,1,1,3,-1,A
1934-08-28,1934,Grimsby Town,Sunderland,0-0,0,0,1,1,0,0,D
1934-08-29,1934,Chelsea,Sheffield Wednesday,1-2,1,2,1,1,3,-1,A
1934-08-29,1934,Everton,Leicester City,2-1,2,1,1,1,3,1,H
1934-08-29,1934,Manchester City,Liverpool,3-1,3,1,1,1,4,2,H
1934-08-29,1934,Middlesbrough,Portsmouth,1-1,1,1,1,1,2,0,D
1934-08-29,1934,West Bromwich Albion,Birmingham City,1-2,1,2,1,1,3,-1,A
1934-09-01,1934,Arsenal,Liverpool,8-1,8,1,1,1,9,7,H
1934-09-01,1934,Aston Villa,Derby County,3-2,3,2,1,1,5,1,H
1934-09-01,1934,Blackburn Rovers,Leeds United,1-1,1,1,1,1,2,0,D
1934-09-01,1934,Chelsea,Leicester City,3-1,3,1,1,1,4,2,H
1934-09-01,1934,Everton,Preston North End,4-1,4,1,1,1,5,3,H
1934-09-01,1934,Grimsby Town,Portsmouth,3-0,3,0,1,1,3,3,H
1934-09-01,1934,Huddersfield Town,Tottenham Hotspur,0-0,0,0,1,1,0,0,D
1934-09-01,1934,Manchester City,Sheffield Wednesday,4-1,4,1,1,1,5,3,H
1934-09-01,1934,Middlesbrough,West Bromwich Albion,0-0,0,0,1,1,0,0,D
1934-09-01,1934,Stoke City,Birmingham City,2-0,2,0,1,1,2,2,H
1934-09-01,1934,Wolverhampton Wanderers,Sunderland,1-2,1,2,1,1,3,-1,A
1934-09-03,1934,Birmingham City,West Bromwich Albion,1-2,1,2,1,1,3,-1,A
1934-09-03,1934,Leeds United,Stoke City,4-2,4,2,1,1,6,2,H
1934-09-03,1934,Leicester City,Everton,5-2,5,2,1,1,7,3,H
1934-09-03,1934,Preston North End,Tottenham Hotspur,1-0,1,0,1,1,1,1,H
1934-09-03,1934,Sheffield Wednesday,Chelsea,3-1,3,1,1,1,4,2,H
1934-09-03,1934,Wolverhampton Wanderers,Aston Villa,5-2,5,2,1,1,7,3,H
1934-09-05,1934,Arsenal,Blackburn Rovers,4-0,4,0,1,1,4,4,H
1934-09-05,1934,Derby County,Huddersfield Town,4-1,4,1,1,1,5,3,H
1934-09-05,1934,Liverpool,Manchester City,2-1,2,1,1,1,3,1,H
1934-09-05,1934,Portsmouth,Middlesbrough,1-0,1,0,1,1,1,1,H
1934-09-05,1934,Sunderland,Grimsby Town,3-0,3,0,1,1,3,3,H
1934-09-08,1934,Birmingham City,Manchester City,1-3,1,3,1,1,4,-2,A
1934-09-08,1934,Derby County,Stoke City,0-2,0,2,1,1,2,-2,A
1934-09-08,1934,Grimsby Town,Everton,0-0,0,0,1,1,0,0,D
1934-09-08,1934,Leeds United,Arsenal,1-1,1,1,1,1,2,0,D
1934-09-08,1934,Leicester City,Aston Villa,5-0,5,0,1,1,5,5,H
1934-09-08,1934,Liverpool,Portsmouth,0-1,0,1,1,1,1,-1,A
1934-09-08,1934,Preston North End,Huddersfield Town,2-0,2,0,1,1,2,2,H
1934-09-08,1934,Sheffield Wednesday,Middlesbrough,3-3,3,3,1,1,6,0,D
1934-09-08,1934,Sunderland,Chelsea,4-0,4,0,1,1,4,4,H
1934-09-08,1934,Tottenham Hotspur,Wolverhampton Wanderers,3-1,3,1,1,1,4,2,H
1934-09-08,1934,West Bromwich Albion,Blackburn Rovers,2-2,2,2,1,1,4,0,D
1934-09-15,1934,Arsenal,West Bromwich Albion,4-3,4,3,1,1,7,1,H
1934-09-15,1934,Aston Villa,Sunderland,1-1,1,1,1,1,2,0,D
1934-09-15,1934,Blackburn Rovers,Sheffield Wednesday,2-1,2,1,1,1,3,1,H
1934-09-15,1934,Chelsea,Tottenham Hotspur,1-3,1,3,1,1,4,-2,A
1934-09-15,1934,Derby County,Leicester City,1-1,1,1,1,1,2,0,D
1934-09-15,1934,Everton,Liverpool,1-0,1,0,1,1,1,1,H
1934-09-15,1934,Huddersfield Town,Grimsby Town,1-5,1,5,1,1,6,-4,A
1934-09-15,1934,Manchester City,Stoke City,3-1,3,1,1,1,4,2,H
1934-09-15,1934,Middlesbrough,Birmingham City,0-1,0,1,1,1,1,-1,A
1934-09-15,1934,Portsmouth,Leeds United,0-0,0,0,1,1,0,0,D
1934-09-15,1934,Wolverhampton Wanderers,Preston North End,2-2,2,2,1,1,4,0,D
1934-09-17,1934,Blackburn Rovers,Arsenal,2-0,2,0,1,1,2,2,H
1934-09-22,1934,Birmingham City,Blackburn Rovers,1-0,1,0,1,1,1,1,H
1934-09-22,1934,Everton,Huddersfield Town,4-2,4,2,1,1,6,2,H
1934-09-22,1934,Grimsby Town,Wolverhampton Wanderers,2-1,2,1,1,1,3,1,H
1934-09-22,1934,Leeds United,Liverpool,0-3,0,3,1,1,3,-3,A
1934-09-22,1934,Leicester City,Manchester City,1-3,1,3,1,1,4,-2,A
1934-09-22,1934,Preston North End,Chelsea,2-0,2,0,1,1,2,2,H
1934-09-22,1934,Sheffield Wednesday,Arsenal,0-0,0,0,1,1,0,0,D
1934-09-22,1934,Stoke City,Middlesbrough,2-0,2,0,1,1,2,2,H
1934-09-22,1934,Sunderland,Derby County,1-4,1,4,1,1,5,-3,A
1934-09-22,1934,Tottenham Hotspur,Aston Villa,0-2,0,2,1,1,2,-2,A
1934-09-22,1934,West Bromwich Albion,Portsmouth,4-2,4,2,1,1,6,2,H
1934-09-29,1934,Arsenal,Birmingham City,5-1,5,1,1,1,6,4,H
1934-09-29,1934,Aston Villa,Preston North End,4-2,4,2,1,1,6,2,H
1934-09-29,1934,Blackburn Rovers,Stoke City,0-1,0,1,1,1,1,-1,A
1934-09-29,1934,Chelsea,Grimsby Town,2-0,2,0,1,1,2,2,H
1934-09-29,1934,Derby County,Tottenham Hotspur,2-1,2,1,1,1,3,1,H
1934-09-29,1934,Leeds United,Huddersfield Town,2-0,2,0,1,1,2,2,H
1934-09-29,1934,Leicester City,Sunderland,0-2,0,2,1,1,2,-2,A
1934-09-29,1934,Liverpool,West Bromwich Albion,3-2,3,2,1,1,5,1,H
1934-09-29,1934,Middlesbrough,Manchester City,1-2,1,2,1,1,3,-1,A
1934-09-29,1934,Portsmouth,Sheffield Wednesday,2-1,2,1,1,1,3,1,H
1934-09-29,1934,Wolverhampton Wanderers,Everton,4-2,4,2,1,1,6,2,H
1934-10-06,1934,Birmingham City,Portsmouth,2-1,2,1,1,1,3,1,H
1934-10-06,1934,Everton,Chelsea,3-2,3,2,1,1,5,1,H
1934-10-06,1934,Grimsby Town,Aston Villa,5-1,5,1,1,1,6,4,H
1934-10-06,1934,Huddersfield Town,Wolverhampton Wanderers,4-1,4,1,1,1,5,3,H
1934-10-06,1934,Manchester City,Blackburn Rovers,3-3,3,3,1,1,6,0,D
1934-10-06,1934,Preston North End,Derby County,0-1,0,1,1,1,1,-1,A
1934-10-06,1934,Sheffield Wednesday,Liverpool,4-1,4,1,1,1,5,3,H
1934-10-06,1934,Stoke City,Arsenal,2-2,2,2,1,1,4,0,D
1934-10-06,1934,Sunderland,Middlesbrough,1-1,1,1,1,1,2,0,D
1934-10-06,1934,Tottenham Hotspur,Leicester City,2-2,2,2,1,1,4,0,D
1934-10-06,1934,West Bromwich Albion,Leeds United,6-3,6,3,1,1,9,3,H
1934-10-13,1934,Arsenal,Manchester City,3-0,3,0,1,1,3,3,H
1934-10-13,1934,Aston Villa,Everton,2-2,2,2,1,1,4,0,D
1934-10-13,1934,Blackburn Rovers,Middlesbrough,3-2,3,2,1,1,5,1,H
1934-10-13,1934,Chelsea,Huddersfield Town,2-1,2,1,1,1,3,1,H
1934-10-13,1934,Derby County,Grimsby Town,1-4,1,4,1,1,5,-3,A
1934-10-13,1934,Leeds United,Sheffield Wednesday,0-0,0,0,1,1,0,0,D
1934-10-13,1934,Leicester City,Preston North End,0-0,0,0,1,1,0,0,D
1934-10-13,1934,Liverpool,Birmingham City,5-4,5,4,1,1,9,1,H
1934-10-13,1934,Portsmouth,Stoke City,0-1,0,1,1,1,1,-1,A
1934-10-13,1934,Sunderland,Tottenham Hotspur,1-2,1,2,1,1,3,-1,A
1934-10-13,1934,Wolverhampton Wanderers,West Bromwich Albion,3-2,3,2,1,1,5,1,H
1934-10-20,1934,Arsenal,Tottenham Hotspur,5-1,5,1,1,1,6,4,H
1934-10-20,1934,Birmingham City,Chelsea,0-1,0,1,1,1,1,-1,A
1934-10-20,1934,Blackburn Rovers,Sunderland,0-0,0,0,1,1,0,0,D
1934-10-20,1934,Leeds United,Everton,2-0,2,0,1,1,2,2,H
1934-10-20,1934,Liverpool,Grimsby Town,1-1,1,1,1,1,2,0,D
1934-10-20,1934,Manchester City,Derby County,0-1,0,1,1,1,1,-1,A
1934-10-20,1934,Middlesbrough,Leicester City,1-0,1,0,1,1,1,1,H
1934-10-20,1934,Sheffield Wednesday,Wolverhampton Wanderers,3-1,3,1,1,1,4,2,H
1934-10-20,1934,Stoke City,Aston Villa,4-1,4,1,1,1,5,3,H
1934-10-20,1934,West Bromwich Albion,Huddersfield Town,4-1,4,1,1,1,5,3,H
1934-10-24,1934,Portsmouth,Preston North End,4-0,4,0,1,1,4,4,H
1934-10-27,1934,Aston Villa,Manchester City,4-2,4,2,1,1,6,2,H
1934-10-27,1934,Chelsea,Stoke City,0-2,0,2,1,1,2,-2,A
1934-10-27,1934,Derby County,Middlesbrough,2-0,2,0,1,1,2,2,H
1934-10-27,1934,Everton,West Bromwich Albion,4-0,4,0,1,1,4,4,H
1934-10-27,1934,Grimsby Town,Leeds United,3-2,3,2,1,1,5,1,H
1934-10-27,1934,Huddersfield Town,Sheffield Wednesday,4-0,4,0,1,1,4,4,H
1934-10-27,1934,Leicester City,Blackburn Rovers,0-1,0,1,1,1,1,-1,A
1934-10-27,1934,Preston North End,Liverpool,2-2,2,2,1,1,4,0,D
1934-10-27,1934,Sunderland,Arsenal,2-1,2,1,1,1,3,1,H
1934-10-27,1934,Tottenham Hotspur,Portsmouth,4-1,4,1,1,1,5,3,H
1934-10-27,1934,Wolverhampton Wanderers,Birmingham City,3-1,3,1,1,1,4,2,H
1934-11-03,1934,Arsenal,Everton,2-0,2,0,1,1,2,2,H
1934-11-03,1934,Birmingham City,Leicester City,2-3,2,3,1,1,5,-1,A
1934-11-03,1934,Blackburn Rovers,Grimsby Town,2-2,2,2,1,1,4,0,D
1934-11-03,1934,Leeds United,Chelsea,5-2,5,2,1,1,7,3,H
1934-11-03,1934,Liverpool,Wolverhampton Wanderers,2-1,2,1,1,1,3,1,H
1934-11-03,1934,Manchester City,Tottenham Hotspur,3-1,3,1,1,1,4,2,H
1934-11-03,1934,Middlesbrough,Preston North End,3-3,3,3,1,1,6,0,D
1934-11-03,1934,Portsmouth,Huddersfield Town,5-0,5,0,1,1,5,5,H
1934-11-03,1934,Sheffield Wednesday,Derby County,1-0,1,0,1,1,1,1,H
1934-11-03,1934,Stoke City,Sunderland,0-3,0,3,1,1,3,-3,A
1934-11-03,1934,West Bromwich Albion,Aston Villa,2-2,2,2,1,1,4,0,D
1934-11-10,1934,Aston Villa,Sheffield Wednesday,4-0,4,0,1,1,4,4,H
1934-11-10,1934,Chelsea,West Bromwich Albion,2-3,2,3,1,1,5,-1,A
1934-11-10,1934,Derby County,Birmingham City,1-1,1,1,1,1,2,0,D
1934-11-10,1934,Everton,Portsmouth,3-2,3,2,1,1,5,1,H
1934-11-10,1934,Grimsby Town,Arsenal,2-2,2,2,1,1,4,0,D
1934-11-10,1934,Huddersfield Town,Liverpool,8-0,8,0,1,1,8,8,H
1934-11-10,1934,Leicester City,Stoke City,0-3,0,3,1,1,3,-3,A
1934-11-10,1934,Preston North End,Blackburn Rovers,3-1,3,1,1,1,4,2,H
1934-11-10,1934,Sunderland,Manchester City,3-2,3,2,1,1,5,1,H
1934-11-10,1934,Tottenham Hotspur,Middlesbrough,3-1,3,1,1,1,4,2,H
1934-11-10,1934,Wolverhampton Wanderers,Leeds United,1-2,1,2,1,1,3,-1,A
1934-11-12,1934,Blackburn Rovers,Chelsea,1-2,1,2,1,1,3,-1,A
1934-11-17,1934,Arsenal,Aston Villa,1-2,1,2,1,1,3,-1,A
1934-11-17,1934,Birmingham City,Grimsby Town,3-2,3,2,1,1,5,1,H
1934-11-17,1934,Leeds United,Sunderland,2-4,2,4,1,1,6,-2,A
1934-11-17,1934,Liverpool,Leicester City,5-1,5,1,1,1,6,4,H
1934-11-17,1934,Manchester City,Huddersfield Town,0-0,0,0,1,1,0,0,D
1934-11-17,1934,Middlesbrough,Wolverhampton Wanderers,2-2,2,2,1,1,4,0,D
1934-11-17,1934,Portsmouth,Derby County,5-1,5,1,1,1,6,4,H
1934-11-17,1934,Sheffield Wednesday,Preston North End,2-1,2,1,1,1,3,1,H
1934-11-17,1934,Stoke City,Everton,3-2,3,2,1,1,5,1,H
1934-11-17,1934,West Bromwich Albion,Tottenham Hotspur,4-0,4,0,1,1,4,4,H
1934-11-24,1934,Chelsea,Arsenal,2-5,2,5,1,1,7,-3,A
1934-11-24,1934,Derby County,Liverpool,1-2,1,2,1,1,3,-1,A
1934-11-24,1934,Everton,Manchester City,1-2,1,2,1,1,3,-1,A
1934-11-24,1934,Grimsby Town,Stoke City,3-1,3,1,1,1,4,2,H
1934-11-24,1934,Huddersfield Town,Middlesbrough,3-1,3,1,1,1,4,2,H
1934-11-24,1934,Leicester City,Leeds United,1-0,1,0,1,1,1,1,H
1934-11-24,1934,Preston North End,Birmingham City,0-1,0,1,1,1,1,-1,A
1934-11-24,1934,Sunderland,West Bromwich Albion,0-1,0,1,1,1,1,-1,A
1934-11-24,1934,Tottenham Hotspur,Sheffield Wednesday,3-2,3,2,1,1,5,1,H
1934-11-24,1934,Wolverhampton Wanderers,Blackburn Rovers,2-1,2,1,1,1,3,1,H
1934-11-26,1934,Aston Villa,Portsmouth,5-4,5,4,1,1,9,1,H
1934-12-01,1934,Arsenal,Wolverhampton Wanderers,7-0,7,0,1,1,7,7,H
1934-12-01,1934,Birmingham City,Tottenham Hotspur,2-1,2,1,1,1,3,1,H
1934-12-01,1934,Blackburn Rovers,Huddersfield Town,4-2,4,2,1,1,6,2,H
1934-12-01,1934,Leeds United,Derby County,4-2,4,2,1,1,6,2,H
1934-12-01,1934,Liverpool,Aston Villa,3-1,3,1,1,1,4,2,H
1934-12-01,1934,Manchester City,Grimsby Town,1-0,1,0,1,1,1,1,H
1934-12-01,1934,Middlesbrough,Everton,3-2,3,2,1,1,5,1,H
1934-12-01,1934,Portsmouth,Chelsea,1-1,1,1,1,1,2,0,D
1934-12-01,1934,Sheffield Wednesday,Sunderland,2-2,2,2,1,1,4,0,D
1934-12-01,1934,Stoke City,Preston North End,3-1,3,1,1,1,4,2,H
1934-12-01,1934,West Bromwich Albion,Leicester City,4-1,4,1,1,1,5,3,H
1934-12-08,1934,Aston Villa,Leeds United,1-1,1,1,1,1,2,0,D
1934-12-08,1934,Chelsea,Liverpool,4-1,4,1,1,1,5,3,H
1934-12-08,1934,Derby County,West Bromwich Albion,9-3,9,3,1,1,12,6,H
1934-12-08,1934,Everton,Blackburn Rovers,5-2,5,2,1,1,7,3,H
1934-12-08,1934,Grimsby Town,Middlesbrough,2-2,2,2,1,1,4,0,D
1934-12-08,1934,Huddersfield Town,Arsenal,1-1,1,1,1,1,2,0,D
1934-12-08,1934,Leicester City,Sheffield Wednesday,0-1,0,1,1,1,1,-1,A
1934-12-08,1934,Preston North End,Manchester City,2-4,2,4,1,1,6,-2,A
1934-12-08,1934,Sunderland,Birmingham City,5-1,5,1,1,1,6,4,H
1934-12-08,1934,Tottenham Hotspur,Stoke City,3-2,3,2,1,1,5,1,H
1934-12-08,1934,Wolverhampton Wanderers,Portsmouth,2-3,2,3,1,1,5,-1,A
1934-12-15,1934,Arsenal,Leicester City,8-0,8,0,1,1,8,8,H
1934-12-15,1934,Birmingham City,Huddersfield Town,0-4,0,4,1,1,4,-4,A
1934-12-15,1934,Blackburn Rovers,Derby County,2-5,2,5,1,1,7,-3,A
1934-12-15,1934,Leeds United,Preston North End,3-3,3,3,1,1,6,0,D
1934-12-15,1934,Liverpool,Tottenham Hotspur,4-1,4,1,1,1,5,3,H
1934-12-15,1934,Manchester City,Chelsea,2-0,2,0,1,1,2,2,H
1934-12-15,1934,Middlesbrough,Aston Villa,4-1,4,1,1,1,5,3,H
1934-12-15,1934,Portsmouth,Sunderland,2-4,2,4,1,1,6,-2,A
1934-12-15,1934,Sheffield Wednesday,Everton,0-0,0,0,1,1,0,0,D
1934-12-15,1934,Stoke City,Wolverhampton Wanderers,1-2,1,2,1,1,3,-1,A
1934-12-15,1934,West Bromwich Albion,Grimsby Town,4-2,4,2,1,1,6,2,H
1934-12-22,1934,Aston Villa,Blackburn Rovers,1-1,1,1,1,1,2,0,D
1934-12-22,1934,Chelsea,Middlesbrough,2-1,2,1,1,1,3,1,H
1934-12-22,1934,Derby County,Arsenal,3-1,3,1,1,1,4,2,H
1934-12-22,1934,Everton,Birmingham City,2-0,2,0,1,1,2,2,H
1934-12-22,1934,Grimsby Town,Sheffield Wednesday,3-1,3,1,1,1,4,2,H
1934-12-22,1934,Huddersfield Town,Stoke City,1-4,1,4,1,1,5,-3,A
1934-12-22,1934,Leicester City,Portsmouth,6-3,6,3,1,1,9,3,H
1934-12-22,1934,Preston North End,West Bromwich Albion,1-2,1,2,1,1,3,-1,A
1934-12-22,1934,Sunderland,Liverpool,2-3,2,3,1,1,5,-1,A
1934-12-22,1934,Tottenham Hotspur,Leeds United,1-1,1,1,1,1,2,0,D
1934-12-22,1934,Wolverhampton Wanderers,Manchester City,5-0,5,0,1,1,5,5,H
1934-12-25,1934,Arsenal,Preston North End,5-3,5,3,1,1,8,2,H
1934-12-25,1934,Blackburn Rovers,Portsmouth,0-0,0,0,1,1,0,0,D
1934-12-25,1934,Chelsea,Aston Villa,2-0,2,0,1,1,2,2,H
1934-12-25,1934,Everton,Sunderland,6-2,6,2,1,1,8,4,H
1934-12-25,1934,Grimsby Town,Tottenham Hotspur,3-0,3,0,1,1,3,3,H
1934-12-25,1934,Leeds United,Manchester City,1-2,1,2,1,1,3,-1,A
1934-12-25,1934,Leicester City,Huddersfield Town,0-3,0,3,1,1,3,-3,A
1934-12-25,1934,Sheffield Wednesday,Birmingham City,2-1,2,1,1,1,3,1,H
1934-12-25,1934,West Bromwich Albion,Stoke City,3-0,3,0,1,1,3,3,H
1934-12-25,1934,Wolverhampton Wanderers,Derby County,5-1,5,1,1,1,6,4,H
1934-12-26,1934,Aston Villa,Chelsea,0-3,0,3,1,1,3,-3,A
1934-12-26,1934,Birmingham City,Sheffield Wednesday,0-4,0,4,1,1,4,-4,A
1934-12-26,1934,Derby County,Wolverhampton Wanderers,2-0,2,0,1,1,2,2,H
1934-12-26,1934,Huddersfield Town,Leicester City,2-3,2,3,1,1,5,-1,A
1934-12-26,1934,Liverpool,Middlesbrough,2-2,2,2,1,1,4,0,D
1934-12-26,1934,Manchester City,Leeds United,3-0,3,0,1,1,3,3,H
1934-12-26,1934,Portsmouth,Blackburn Rovers,3-1,3,1,1,1,4,2,H
1934-12-26,1934,Preston North End,Arsenal,2-1,2,1,1,1,3,1,H
1934-12-26,1934,Stoke City,West Bromwich Albion,3-0,3,0,1,1,3,3,H
1934-12-26,1934,Sunderland,Everton,7-0,7,0,1,1,7,7,H
1934-12-26,1934,Tottenham Hotspur,Grimsby Town,2-1,2,1,1,1,3,1,H
1934-12-29,1934,Arsenal,Portsmouth,1-1,1,1,1,1,2,0,D
1934-12-29,1934,Aston Villa,Birmingham City,2-2,2,2,1,1,4,0,D
1934-12-29,1934,Blackburn Rovers,Liverpool,0-2,0,2,1,1,2,-2,A
1934-12-29,1934,Chelsea,Derby County,1-1,1,1,1,1,2,0,D
1934-12-29,1934,Everton,Tottenham Hotspur,5-2,5,2,1,1,7,3,H
1934-12-29,1934,Grimsby Town,Preston North End,3-1,3,1,1,1,4,2,H
1934-12-29,1934,Huddersfield Town,Sunderland,0-3,0,3,1,1,3,-3,A
1934-12-29,1934,Manchester City,West Bromwich Albion,3-2,3,2,1,1,5,1,H
1934-12-29,1934,Middlesbrough,Leeds United,3-3,3,3,1,1,6,0,D
1934-12-29,1934,Stoke City,Sheffield Wednesday,1-1,1,1,1,1,2,0,D
1934-12-29,1934,Wolverhampton Wanderers,Leicester City,3-1,3,1,1,1,4,2,H
1935-01-01,1934,Blackburn Rovers,Tottenham Hotspur,2-0,2,0,1,1,2,2,H
1935-01-01,1934,Everton,Derby County,2-2,2,2,1,1,4,0,D
1935-01-01,1934,Middlesbrough,Liverpool,2-0,2,0,1,1,2,2,H
1935-01-01,1934,Sheffield Wednesday,West Bromwich Albion,2-1,2,1,1,1,3,1,H
1935-01-05,1934,Birmingham City,Stoke City,0-0,0,0,1,1,0,0,D
1935-01-05,1934,Derby County,Aston Villa,1-1,1,1,1,1,2,0,D
1935-01-05,1934,Leeds United,Blackburn Rovers,5-1,5,1,1,1,6,4,H
1935-01-05,1934,Leicester City,Chelsea,1-0,1,0,1,1,1,1,H
1935-01-05,1934,Liverpool,Arsenal,0-2,0,2,1,1,2,-2,A
1935-01-05,1934,Portsmouth,Grimsby Town,1-0,1,0,1,1,1,1,H
1935-01-05,1934,Preston North End,Everton,2-2,2,2,1,1,4,0,D
1935-01-05,1934,Sheffield Wednesday,Manchester City,1-0,1,0,1,1,1,1,H
1935-01-05,1934,Sunderland,Wolverhampton Wanderers,0-0,0,0,1,1,0,0,D
1935-01-05,1934,Tottenham Hotspur,Huddersfield Town,0-0,0,0,1,1,0,0,D
1935-01-05,1934,West Bromwich Albion,Middlesbrough,6-3,6,3,1,1,9,3,H
1935-01-19,1934,Arsenal,Leeds United,3-0,3,0,1,1,3,3,H
1935-01-19,1934,Aston Villa,Leicester City,5-0,5,0,1,1,5,5,H
1935-01-19,1934,Blackburn Rovers,West Bromwich Albion,3-0,3,0,1,1,3,3,H
1935-01-19,1934,Chelsea,Sunderland,2-2,2,2,1,1,4,0,D
1935-01-19,1934,Everton,Grimsby Town,3-1,3,1,1,1,4,2,H
1935-01-19,1934,Huddersfield Town,Preston North End,3-4,3,4,1,1,7,-1,A
1935-01-19,1934,Manchester City,Birmingham City,0-0,0,0,1,1,0,0,D
1935-01-19,1934,Middlesbrough,Sheffield Wednesday,5-3,5,3,1,1,8,2,H
1935-01-19,1934,Portsmouth,Liverpool,1-2,1,2,1,1,3,-1,A
1935-01-19,1934,Stoke City,Derby County,1-1,1,1,1,1,2,0,D
1935-01-19,1934,Wolverhampton Wanderers,Tottenham Hotspur,6-2,6,2,1,1,8,4,H
1935-01-26,1934,Stoke City,Manchester City,2-0,2,0,1,1,2,2,H
1935-01-28,1934,Preston North End,Wolverhampton Wanderers,2-1,2,1,1,1,3,1,H
1935-01-28,1934,Sheffield Wednesday,Blackburn Rovers,2-2,2,2,1,1,4,0,D
1935-01-30,1934,Tottenham Hotspur,Chelsea,1-3,1,3,1,1,4,-2,A
1935-01-30,1934,West Bromwich Albion,Arsenal,0-3,0,3,1,1,3,-3,A
1935-01-31,1934,Leicester City,Derby County,0-1,0,1,1,1,1,-1,A
1935-02-02,1934,Arsenal,Sheffield Wednesday,4-1,4,1,1,1,5,3,H
1935-02-02,1934,Aston Villa,Tottenham Hotspur,1-0,1,0,1,1,1,1,H
1935-02-02,1934,Blackburn Rovers,Birmingham City,3-1,3,1,1,1,4,2,H
1935-02-02,1934,Chelsea,Preston North End,0-0,0,0,1,1,0,0,D
1935-02-02,1934,Derby County,Sunderland,3-1,3,1,1,1,4,2,H
1935-02-02,1934,Huddersfield Town,Everton,1-1,1,1,1,1,2,0,D
1935-02-02,1934,Liverpool,Leeds United,4-2,4,2,1,1,6,2,H
1935-02-02,1934,Manchester City,Leicester City,6-3,6,3,1,1,9,3,H
1935-02-02,1934,Middlesbrough,Stoke City,2-0,2,0,1,1,2,2,H
1935-02-02,1934,Portsmouth,West Bromwich Albion,0-2,0,2,1,1,2,-2,A
1935-02-02,1934,Wolverhampton Wanderers,Grimsby Town,0-3,0,3,1,1,3,-3,A
1935-02-06,1934,Birmingham City,Middlesbrough,4-2,4,2,1,1,6,2,H
1935-02-06,1934,Sunderland,Aston Villa,3-3,3,3,1,1,6,0,D
1935-02-09,1934,Birmingham City,Arsenal,3-0,3,0,1,1,3,3,H
1935-02-09,1934,Everton,Wolverhampton Wanderers,5-2,5,2,1,1,7,3,H
1935-02-09,1934,Grimsby Town,Chelsea,3-1,3,1,1,1,4,2,H
1935-02-09,1934,Huddersfield Town,Leeds United,3-1,3,1,1,1,4,2,H
1935-02-09,1934,Manchester City,Middlesbrough,6-2,6,2,1,1,8,4,H
1935-02-09,1934,Preston North End,Aston Villa,0-0,0,0,1,1,0,0,D
1935-02-09,1934,Sheffield Wednesday,Portsmouth,3-0,3,0,1,1,3,3,H
1935-02-09,1934,Stoke City,Blackburn Rovers,3-1,3,1,1,1,4,2,H
1935-02-09,1934,Sunderland,Leicester City,2-0,2,0,1,1,2,2,H
1935-02-09,1934,Tottenham Hotspur,Derby County,2-2,2,2,1,1,4,0,D
1935-02-09,1934,West Bromwich Albion,Liverpool,1-1,1,1,1,1,2,0,D
1935-02-16,1934,Aston Villa,Grimsby Town,3-2,3,2,1,1,5,1,H
1935-02-16,1934,Middlesbrough,Sunderland,0-0,0,0,1,1,0,0,D
1935-02-16,1934,Wolverhampton Wanderers,Huddersfield Town,2-3,2,3,1,1,5,-1,A
1935-02-20,1934,Arsenal,Stoke City,2-0,2,0,1,1,2,2,H
1935-02-20,1934,Chelsea,Everton,3-0,3,0,1,1,3,3,H
1935-02-20,1934,Leeds United,West Bromwich Albion,4-1,4,1,1,1,5,3,H
1935-02-20,1934,Liverpool,Sheffield Wednesday,1-2,1,2,1,1,3,-1,A
1935-02-23,1934,Birmingham City,Liverpool,1-3,1,3,1,1,4,-2,A
1935-02-23,1934,Everton,Aston Villa,2-2,2,2,1,1,4,0,D
1935-02-23,1934,Grimsby Town,Derby County,1-3,1,3,1,1,4,-2,A
1935-02-23,1934,Huddersfield Town,Chelsea,3-0,3,0,1,1,3,3,H
1935-02-23,1934,Manchester City,Arsenal,1-1,1,1,1,1,2,0,D
1935-02-23,1934,Middlesbrough,Blackburn Rovers,3-3,3,3,1,1,6,0,D
1935-02-23,1934,Preston North End,Leicester City,2-0,2,0,1,1,2,2,H
1935-02-23,1934,Sheffield Wednesday,Leeds United,1-0,1,0,1,1,1,1,H
1935-02-23,1934,Stoke City,Portsmouth,1-2,1,2,1,1,3,-1,A
1935-02-23,1934,Tottenham Hotspur,Sunderland,1-1,1,1,1,1,2,0,D
1935-02-23,1934,West Bromwich Albion,Wolverhampton Wanderers,5-2,5,2,1,1,7,3,H
1935-03-02,1934,Aston Villa,Stoke City,4-1,4,1,1,1,5,3,H
1935-03-02,1934,Derby County,Manchester City,1-2,1,2,1,1,3,-1,A
1935-03-02,1934,Grimsby Town,Liverpool,3-2,3,2,1,1,5,1,H
1935-03-02,1934,Leeds United,Portsmouth,3-1,3,1,1,1,4,2,H
1935-03-02,1934,Leicester City,Middlesbrough,3-1,3,1,1,1,4,2,H
1935-03-02,1934,Sunderland,Blackburn Rovers,3-0,3,0,1,1,3,3,H
1935-03-04,1934,Blackburn Rovers,Manchester City,1-0,1,0,1,1,1,1,H
1935-03-04,1934,Wolverhampton Wanderers,Sheffield Wednesday,2-2,2,2,1,1,4,0,D
1935-03-06,1934,Chelsea,Birmingham City,2-2,2,2,1,1,4,0,D
1935-03-06,1934,Everton,Leeds United,4-4,4,4,1,1,8,0,D
1935-03-06,1934,Huddersfield Town,West Bromwich Albion,3-0,3,0,1,1,3,3,H
1935-03-06,1934,Preston North End,Portsmouth,1-1,1,1,1,1,2,0,D
1935-03-06,1934,Tottenham Hotspur,Arsenal,0-6,0,6,1,1,6,-6,A
1935-03-09,1934,Arsenal,Sunderland,0-0,0,0,1,1,0,0,D
1935-03-09,1934,Birmingham City,Wolverhampton Wanderers,1-1,1,1,1,1,2,0,D
1935-03-09,1934,Blackburn Rovers,Leicester City,0-0,0,0,1,1,0,0,D
1935-03-09,1934,Leeds United,Grimsby Town,3-1,3,1,1,1,4,2,H
1935-03-09,1934,Liverpool,Preston North End,0-0,0,0,1,1,0,0,D
1935-03-09,1934,Manchester City,Aston Villa,4-1,4,1,1,1,5,3,H
1935-03-09,1934,Middlesbrough,Derby County,1-1,1,1,1,1,2,0,D
1935-03-09,1934,Portsmouth,Tottenham Hotspur,1-1,1,1,1,1,2,0,D
1935-03-09,1934,Sheffield Wednesday,Huddersfield Town,1-1,1,1,1,1,2,0,D
1935-03-09,1934,Stoke City,Chelsea,0-1,0,1,1,1,1,-1,A
1935-03-09,1934,West Bromwich Albion,Everton,0-1,0,1,1,1,1,-1,A
1935-03-16,1934,Chelsea,Leeds United,7-1,7,1,1,1,8,6,H
1935-03-16,1934,Everton,Arsenal,0-2,0,2,1,1,2,-2,A
1935-03-16,1934,Grimsby Town,Blackburn Rovers,1-2,1,2,1,1,3,-1,A
1935-03-16,1934,Huddersfield Town,Portsmouth,2-0,2,0,1,1,2,2,H
1935-03-16,1934,Leicester City,Birmingham City,2-1,2,1,1,1,3,1,H
1935-03-16,1934,Preston North End,Middlesbrough,2-0,2,0,1,1,2,2,H
1935-03-16,1934,Sunderland,Stoke City,4-1,4,1,1,1,5,3,H
1935-03-16,1934,Tottenham Hotspur,Manchester City,0-0,0,0,1,1,0,0,D
1935-03-16,1934,Wolverhampton Wanderers,Liverpool,5-3,5,3,1,1,8,2,H
1935-03-20,1934,Derby County,Sheffield Wednesday,4-0,4,0,1,1,4,4,H
1935-03-20,1934,Liverpool,Everton,2-1,2,1,1,1,3,1,H
1935-03-23,1934,Arsenal,Grimsby Town,1-1,1,1,1,1,2,0,D
1935-03-23,1934,Birmingham City,Derby County,3-2,3,2,1,1,5,1,H
1935-03-23,1934,Blackburn Rovers,Preston North End,1-0,1,0,1,1,1,1,H
1935-03-23,1934,Leeds United,Wolverhampton Wanderers,1-1,1,1,1,1,2,0,D
1935-03-23,1934,Liverpool,Huddersfield Town,3-2,3,2,1,1,5,1,H
1935-03-23,1934,Middlesbrough,Tottenham Hotspur,3-1,3,1,1,1,4,2,H
1935-03-23,1934,Portsmouth,Everton,5-1,5,1,1,1,6,4,H
1935-03-23,1934,Sheffield Wednesday,Aston Villa,2-1,2,1,1,1,3,1,H
1935-03-23,1934,Stoke City,Leicester City,3-0,3,0,1,1,3,3,H
1935-03-23,1934,West Bromwich Albion,Chelsea,2-2,2,2,1,1,4,0,D
1935-03-28,1934,Leicester City,Tottenham Hotspur,6-0,6,0,1,1,6,6,H
1935-03-30,1934,Aston Villa,Arsenal,1-3,1,3,1,1,4,-2,A
1935-03-30,1934,Chelsea,Blackburn Rovers,4-2,4,2,1,1,6,2,H
1935-03-30,1934,Derby County,Portsmouth,0-1,0,1,1,1,1,-1,A
1935-03-30,1934,Everton,Stoke City,5-0,5,0,1,1,5,5,H
1935-03-30,1934,Grimsby Town,Birmingham City,4-3,4,3,1,1,7,1,H
1935-03-30,1934,Huddersfield Town,Manchester City,3-0,3,0,1,1,3,3,H
1935-03-30,1934,Leicester City,Liverpool,3-1,3,1,1,1,4,2,H
1935-03-30,1934,Preston North End,Sheffield Wednesday,2-1,2,1,1,1,3,1,H
1935-03-30,1934,Sunderland,Leeds United,3-0,3,0,1,1,3,3,H
1935-03-30,1934,Tottenham Hotspur,West Bromwich Albion,0-1,0,1,1,1,1,-1,A
1935-03-30,1934,Wolverhampton Wanderers,Middlesbrough,5-3,5,3,1,1,8,2,H
1935-04-02,1934,Grimsby Town,Huddersfield Town,1-1,1,1,1,1,2,0,D
1935-04-03,1934,Aston Villa,West Bromwich Albion,2-3,2,3,1,1,5,-1,A
1935-04-06,1934,Arsenal,Chelsea,2-2,2,2,1,1,4,0,D
1935-04-06,1934,Birmingham City,Preston North End,3-0,3,0,1,1,3,3,H
1935-04-06,1934,Blackburn Rovers,Wolverhampton Wanderers,4-2,4,2,1,1,6,2,H
1935-04-06,1934,Leeds United,Leicester City,0-2,0,2,1,1,2,-2,A
1935-04-06,1934,Liverpool,Derby County,1-3,1,3,1,1,4,-2,A
1935-04-06,1934,Manchester City,Everton,2-2,2,2,1,1,4,0,D
1935-04-06,1934,Middlesbrough,Huddersfield Town,2-1,2,1,1,1,3,1,H
1935-04-06,1934,Portsmouth,Aston Villa,0-1,0,1,1,1,1,-1,A
1935-04-06,1934,Sheffield Wednesday,Tottenham Hotspur,4-0,4,0,1,1,4,4,H
1935-04-06,1934,Stoke City,Grimsby Town,0-0,0,0,1,1,0,0,D
1935-04-06,1934,West Bromwich Albion,Sunderland,1-1,1,1,1,1,2,0,D
1935-04-10,1934,Derby County,Preston North End,0-3,0,3,1,1,3,-3,A
1935-04-10,1934,Manchester City,Sunderland,1-0,1,0,1,1,1,1,H
1935-04-10,1934,Portsmouth,Birmingham City,2-1,2,1,1,1,3,1,H
1935-04-13,1934,Aston Villa,Liverpool,4-2,4,2,1,1,6,2,H
1935-04-13,1934,Chelsea,Portsmouth,1-1,1,1,1,1,2,0,D
1935-04-13,1934,Derby County,Leeds United,1-2,1,2,1,1,3,-1,A
1935-04-13,1934,Everton,Middlesbrough,1-1,1,1,1,1,2,0,D
1935-04-13,1934,Grimsby Town,Manchester City,1-1,1,1,1,1,2,0,D
1935-04-13,1934,Huddersfield Town,Blackburn Rovers,6-0,6,0,1,1,6,6,H
1935-04-13,1934,Leicester City,West Bromwich Albion,0-0,0,0,1,1,0,0,D
1935-04-13,1934,Preston North End,Stoke City,5-2,5,2,1,1,7,3,H
1935-04-13,1934,Sunderland,Sheffield Wednesday,2-2,2,2,1,1,4,0,D
1935-04-13,1934,Tottenham Hotspur,Birmingham City,1-1,1,1,1,1,2,0,D
1935-04-13,1934,Wolverhampton Wanderers,Arsenal,1-1,1,1,1,1,2,0,D
1935-04-19,1934,Arsenal,Middlesbrough,8-0,8,0,1,1,8,8,H
1935-04-19,1934,Aston Villa,Huddersfield Town,1-1,1,1,1,1,2,0,D
1935-04-19,1934,Chelsea,Wolverhampton Wanderers,4-2,4,2,1,1,6,2,H
1935-04-19,1934,Grimsby Town,Leicester City,3-1,3,1,1,1,4,2,H
1935-04-19,1934,Leeds United,Birmingham City,1-1,1,1,1,1,2,0,D
1935-04-19,1934,Liverpool,Stoke City,5-0,5,0,1,1,5,5,H
1935-04-19,1934,Manchester City,Portsmouth,2-4,2,4,1,1,6,-2,A
1935-04-19,1934,Sunderland,Preston North End,3-1,3,1,1,1,4,2,H
1935-04-19,1934,Tottenham Hotspur,Blackburn Rovers,1-0,1,0,1,1,1,1,H
1935-04-20,1934,Arsenal,Huddersfield Town,1-0,1,0,1,1,1,1,H
1935-04-20,1934,Birmingham City,Sunderland,2-2,2,2,1,1,4,0,D
1935-04-20,1934,Blackburn Rovers,Everton,6-2,6,2,1,1,8,4,H
1935-04-20,1934,Leeds United,Aston Villa,1-1,1,1,1,1,2,0,D
1935-04-20,1934,Liverpool,Chelsea,6-0,6,0,1,1,6,6,H
1935-04-20,1934,Manchester City,Preston North End,1-2,1,2,1,1,3,-1,A
1935-04-20,1934,Middlesbrough,Grimsby Town,0-2,0,2,1,1,2,-2,A
1935-04-20,1934,Portsmouth,Wolverhampton Wanderers,0-1,0,1,1,1,1,-1,A
1935-04-20,1934,Sheffield Wednesday,Leicester City,1-1,1,1,1,1,2,0,D
1935-04-20,1934,Stoke City,Tottenham Hotspur,4-1,4,1,1,1,5,3,H
1935-04-20,1934,West Bromwich Albion,Derby County,4-3,4,3,1,1,7,1,H
1935-04-22,1934,Birmingham City,Leeds United,3-1,3,1,1,1,4,2,H
1935-04-22,1934,Derby County,Everton,4-1,4,1,1,1,5,3,H
1935-04-22,1934,Leicester City,Grimsby Town,2-2,2,2,1,1,4,0,D
1935-04-22,1934,Middlesbrough,Arsenal,0-1,0,1,1,1,1,-1,A
1935-04-22,1934,Portsmouth,Manchester City,4-2,4,2,1,1,6,2,H
1935-04-22,1934,Preston North End,Sunderland,1-1,1,1,1,1,2,0,D
1935-04-22,1934,Stoke City,Liverpool,1-1,1,1,1,1,2,0,D
1935-04-22,1934,West Bromwich Albion,Sheffield Wednesday,1-1,1,1,1,1,2,0,D
1935-04-22,1934,Wolverhampton Wanderers,Chelsea,6-1,6,1,1,1,7,5,H
1935-04-24,1934,Huddersfield Town,Aston Villa,1-1,1,1,1,1,2,0,D
1935-04-27,1934,Aston Villa,Middlesbrough,0-3,0,3,1,1,3,-3,A
1935-04-27,1934,Chelsea,Manchester City,4-2,4,2,1,1,6,2,H
1935-04-27,1934,Derby County,Blackburn Rovers,1-1,1,1,1,1,2,0,D
1935-04-27,1934,Huddersfield Town,Birmingham City,2-2,2,2,1,1,4,0,D
1935-04-27,1934,Leicester City,Arsenal,3-5,3,5,1,1,8,-2,A
1935-04-27,1934,Preston North End,Leeds United,0-2,0,2,1,1,2,-2,A
1935-04-27,1934,Sunderland,Portsmouth,4-1,4,1,1,1,5,3,H
1935-04-27,1934,Tottenham Hotspur,Liverpool,5-1,5,1,1,1,6,4,H
1935-04-27,1934,Wolverhampton Wanderers,Stoke City,2-1,2,1,1,1,3,1,H
1935-05-01,1934,Everton,Sheffield Wednesday,2-2,2,2,1,1,4,0,D
1935-05-01,1934,Grimsby Town,West Bromwich Albion,3-0,3,0,1,1,3,3,H
1935-05-04,1934,Arsenal,Derby County,0-1,0,1,1,1,1,-1,A
1935-05-04,1934,Birmingham City,Everton,2-3,2,3,1,1,5,-1,A
1935-05-04,1934,Blackburn Rovers,Aston Villa,5-0,5,0,1,1,5,5,H
1935-05-04,1934,Leeds United,Tottenham Hotspur,4-3,4,3,1,1,7,1,H
1935-05-04,1934,Liverpool,Sunderland,2-2,2,2,1,1,4,0,D
1935-05-04,1934,Manchester City,Wolverhampton Wanderers,5-0,5,0,1,1,5,5,H
1935-05-04,1934,Middlesbrough,Chelsea,2-2,2,2,1,1,4,0,D
1935-05-04,1934,Portsmouth,Leicester City,1-1,1,1,1,1,2,0,D
1935-05-04,1934,Sheffield Wednesday,Grimsby Town,1-0,1,0,1,1,1,1,H
1935-05-04,1934,Stoke City,Huddersfield Town,2-0,2,0,1,1,2,2,H
1935-05-04,1934,West Bromwich Albion,Preston North End,0-0,0,0,1,1,0,0,D
1935-08-31,1935,Arsenal,Sunderland,3-1,3,1,1,1,4,2,H
1935-08-31,1935,Aston Villa,Sheffield Wednesday,1-2,1,2,1,1,3,-1,A
1935-08-31,1935,Blackburn Rovers,Grimsby Town,1-0,1,0,1,1,1,1,H
1935-08-31,1935,Bolton Wanderers,Brentford,0-2,0,2,1,1,2,-2,A
1935-08-31,1935,Chelsea,Liverpool,2-2,2,2,1,1,4,0,D
1935-08-31,1935,Everton,Derby County,4-0,4,0,1,1,4,4,H
1935-08-31,1935,Huddersfield Town,Preston North End,1-0,1,0,1,1,1,1,H
1935-08-31,1935,Manchester City,West Bromwich Albion,1-0,1,0,1,1,1,1,H
1935-08-31,1935,Middlesbrough,Portsmouth,3-2,3,2,1,1,5,1,H
1935-08-31,1935,Stoke City,Leeds United,3-1,3,1,1,1,4,2,H
1935-08-31,1935,Wolverhampton Wanderers,Birmingham City,3-1,3,1,1,1,4,2,H
1935-09-02,1935,Bolton Wanderers,Sheffield Wednesday,1-1,1,1,1,1,2,0,D
1935-09-02,1935,Preston North End,Derby County,1-0,1,0,1,1,1,1,H
1935-09-02,1935,Wolverhampton Wanderers,Huddersfield Town,2-2,2,2,1,1,4,0,D
1935-09-03,1935,Grimsby Town,Arsenal,1-0,1,0,1,1,1,1,H
1935-09-04,1935,Chelsea,Stoke City,3-5,3,5,1,1,8,-2,A
1935-09-04,1935,Leeds United,Birmingham City,0-0,0,0,1,1,0,0,D
1935-09-04,1935,Liverpool,Manchester City,0-2,0,2,1,1,2,-2,A
1935-09-04,1935,Middlesbrough,Aston Villa,1-2,1,2,1,1,3,-1,A
1935-09-04,1935,Portsmouth,Everton,2-0,2,0,1,1,2,2,H
1935-09-04,1935,West Bromwich Albion,Sunderland,1-3,1,3,1,1,4,-2,A
1935-09-05,1935,Brentford,Blackburn Rovers,3-1,3,1,1,1,4,2,H
1935-09-07,1935,Birmingham City,Arsenal,1-1,1,1,1,1,2,0,D
1935-09-07,1935,Brentford,Huddersfield Town,1-2,1,2,1,1,3,-1,A
1935-09-07,1935,Derby County,Bolton Wanderers,4-0,4,0,1,1,4,4,H
1935-09-07,1935,Grimsby Town,Chelsea,1-3,1,3,1,1,4,-2,A
1935-09-07,1935,Leeds United,Blackburn Rovers,1-4,1,4,1,1,5,-3,A
1935-09-07,1935,Liverpool,Everton,6-0,6,0,1,1,6,6,H
1935-09-07,1935,Portsmouth,Aston Villa,3-0,3,0,1,1,3,3,H
1935-09-07,1935,Preston North End,Middlesbrough,0-5,0,5,1,1,5,-5,A
1935-09-07,1935,Sheffield Wednesday,Wolverhampton Wanderers,0-0,0,0,1,1,0,0,D
1935-09-07,1935,Sunderland,Manchester City,2-0,2,0,1,1,2,2,H
1935-09-07,1935,West Bromwich Albion,Stoke City,2-0,2,0,1,1,2,2,H
1935-09-09,1935,Aston Villa,Middlesbrough,2-7,2,7,1,1,9,-5,A
1935-09-09,1935,Sheffield Wednesday,Bolton Wanderers,2-2,2,2,1,1,4,0,D
1935-09-09,1935,Stoke City,Chelsea,3-0,3,0,1,1,3,3,H
1935-09-11,1935,Arsenal,Grimsby Town,6-0,6,0,1,1,6,6,H
1935-09-11,1935,Birmingham City,Leeds United,2-0,2,0,1,1,2,2,H
1935-09-11,1935,Derby County,Preston North End,2-0,2,0,1,1,2,2,H
1935-09-11,1935,Everton,Portsmouth,3-0,3,0,1,1,3,3,H
1935-09-11,1935,Huddersfield Town,Wolverhampton Wanderers,3-0,3,0,1,1,3,3,H
1935-09-11,1935,Manchester City,Liverpool,6-0,6,0,1,1,6,6,H
1935-09-11,1935,Sunderland,West Bromwich Albion,6-1,6,1,1,1,7,5,H
1935-09-14,1935,Arsenal,Sheffield Wednesday,2-2,2,2,1,1,4,0,D
1935-09-14,1935,Aston Villa,Preston North End,5-1,5,1,1,1,6,4,H
1935-09-14,1935,Blackburn Rovers,West Bromwich Albion,3-1,3,1,1,1,4,2,H
1935-09-14,1935,Bolton Wanderers,Everton,2-0,2,0,1,1,2,2,H
1935-09-14,1935,Chelsea,Leeds United,1-0,1,0,1,1,1,1,H
1935-09-14,1935,Huddersfield Town,Derby County,1-1,1,1,1,1,2,0,D
1935-09-14,1935,Liverpool,Grimsby Town,7-2,7,2,1,1,9,5,H
1935-09-14,1935,Manchester City,Birmingham City,3-1,3,1,1,1,4,2,H
1935-09-14,1935,Middlesbrough,Brentford,0-0,0,0,1,1,0,0,D
1935-09-14,1935,Stoke City,Sunderland,0-2,0,2,1,1,2,-2,A
1935-09-14,1935,Wolverhampton Wanderers,Portsmouth,2-0,2,0,1,1,2,2,H
1935-09-16,1935,Aston Villa,Sunderland,2-2,2,2,1,1,4,0,D
1935-09-16,1935,Blackburn Rovers,Chelsea,1-0,1,0,1,1,1,1,H
1935-09-16,1935,Sheffield Wednesday,Huddersfield Town,1-2,1,2,1,1,3,-1,A
1935-09-18,1935,Derby County,Brentford,2-1,2,1,1,1,3,1,H
1935-09-18,1935,Leeds United,Arsenal,1-1,1,1,1,1,2,0,D
1935-09-18,1935,Liverpool,Stoke City,2-0,2,0,1,1,2,2,H
1935-09-18,1935,Middlesbrough,Wolverhampton Wanderers,4-2,4,2,1,1,6,2,H
1935-09-18,1935,Preston North End,Everton,2-2,2,2,1,1,4,0,D
1935-09-18,1935,West Bromwich Albion,Birmingham City,0-0,0,0,1,1,0,0,D
1935-09-21,1935,Arsenal,Manchester City,2-3,2,3,1,1,5,-1,A
1935-09-21,1935,Birmingham City,Stoke City,0-5,0,5,1,1,5,-5,A
1935-09-21,1935,Brentford,Aston Villa,1-2,1,2,1,1,3,-1,A
1935-09-21,1935,Derby County,Middlesbrough,3-2,3,2,1,1,5,1,H
1935-09-21,1935,Everton,Huddersfield Town,1-3,1,3,1,1,4,-2,A
1935-09-21,1935,Grimsby Town,Bolton Wanderers,3-1,3,1,1,1,4,2,H
1935-09-21,1935,Leeds United,Liverpool,1-0,1,0,1,1,1,1,H
1935-09-21,1935,Portsmouth,Sheffield Wednesday,3-2,3,2,1,1,5,1,H
1935-09-21,1935,Preston North End,Wolverhampton Wanderers,2-0,2,0,1,1,2,2,H
1935-09-21,1935,Sunderland,Blackburn Rovers,7-2,7,2,1,1,9,5,H
1935-09-21,1935,West Bromwich Albion,Chelsea,1-2,1,2,1,1,3,-1,A
1935-09-28,1935,Aston Villa,Derby County,0-2,0,2,1,1,2,-2,A
1935-09-28,1935,Blackburn Rovers,Birmingham City,1-2,1,2,1,1,3,-1,A
1935-09-28,1935,Chelsea,Sunderland,3-1,3,1,1,1,4,2,H
1935-09-28,1935,Grimsby Town,Leeds United,0-1,0,1,1,1,1,-1,A
1935-09-28,1935,Huddersfield Town,Bolton Wanderers,0-0,0,0,1,1,0,0,D
1935-09-28,1935,Liverpool,West Bromwich Albion,5-0,5,0,1,1,5,5,H
1935-09-28,1935,Manchester City,Portsmouth,0-0,0,0,1,1,0,0,D
1935-09-28,1935,Middlesbrough,Everton,6-1,6,1,1,1,7,5,H
1935-09-28,1935,Sheffield Wednesday,Preston North End,1-0,1,0,1,1,1,1,H
1935-09-28,1935,Stoke City,Arsenal,0-3,0,3,1,1,3,-3,A
1935-09-28,1935,Wolverhampton Wanderers,Brentford,3-2,3,2,1,1,5,1,H
1935-10-05,1935,Arsenal,Blackburn Rovers,5-1,5,1,1,1,6,4,H
1935-10-05,1935,Birmingham City,Chelsea,2-1,2,1,1,1,3,1,H
1935-10-05,1935,Bolton Wanderers,Middlesbrough,3-1,3,1,1,1,4,2,H
1935-10-05,1935,Brentford,Sheffield Wednesday,2-2,2,2,1,1,4,0,D
1935-10-05,1935,Derby County,Wolverhampton Wanderers,3-1,3,1,1,1,4,2,H
1935-10-05,1935,Everton,Aston Villa,2-2,2,2,1,1,4,0,D
1935-10-05,1935,Leeds United,Huddersfield Town,2-2,2,2,1,1,4,0,D
1935-10-05,1935,Manchester City,Stoke City,1-2,1,2,1,1,3,-1,A
1935-10-05,1935,Preston North End,Portsmouth,1-1,1,1,1,1,2,0,D
1935-10-05,1935,Sunderland,Liverpool,2-0,2,0,1,1,2,2,H
1935-10-05,1935,West Bromwich Albion,Grimsby Town,4-1,4,1,1,1,5,3,H
1935-10-12,1935,Aston Villa,Bolton Wanderers,1-2,1,2,1,1,3,-1,A
1935-10-12,1935,Blackburn Rovers,Manchester City,4-1,4,1,1,1,5,3,H
1935-10-12,1935,Chelsea,Arsenal,1-1,1,1,1,1,2,0,D
1935-10-12,1935,Grimsby Town,Sunderland,4-0,4,0,1,1,4,4,H
1935-10-12,1935,Leeds United,West Bromwich Albion,1-1,1,1,1,1,2,0,D
1935-10-12,1935,Liverpool,Birmingham City,1-2,1,2,1,1,3,-1,A
1935-10-12,1935,Middlesbrough,Huddersfield Town,4-2,4,2,1,1,6,2,H
1935-10-12,1935,Portsmouth,Brentford,1-3,1,3,1,1,4,-2,A
1935-10-12,1935,Sheffield Wednesday,Derby County,1-0,1,0,1,1,1,1,H
1935-10-12,1935,Stoke City,Preston North End,2-1,2,1,1,1,3,1,H
1935-10-12,1935,Wolverhampton Wanderers,Everton,4-0,4,0,1,1,4,4,H
1935-10-19,1935,Aston Villa,West Bromwich Albion,0-7,0,7,1,1,7,-7,A
1935-10-19,1935,Bolton Wanderers,Liverpool,0-0,0,0,1,1,0,0,D
1935-10-19,1935,Brentford,Stoke City,0-0,0,0,1,1,0,0,D
1935-10-19,1935,Derby County,Blackburn Rovers,1-0,1,0,1,1,1,1,H
1935-10-19,1935,Everton,Chelsea,5-1,5,1,1,1,6,4,H
1935-10-19,1935,Huddersfield Town,Grimsby Town,1-0,1,0,1,1,1,1,H
1935-10-19,1935,Middlesbrough,Leeds United,1-1,1,1,1,1,2,0,D
1935-10-19,1935,Portsmouth,Arsenal,2-1,2,1,1,1,3,1,H
1935-10-19,1935,Preston North End,Manchester City,4-0,4,0,1,1,4,4,H
1935-10-19,1935,Sheffield Wednesday,Birmingham City,3-1,3,1,1,1,4,2,H
1935-10-19,1935,Wolverhampton Wanderers,Sunderland,3-4,3,4,1,1,7,-1,A
1935-10-26,1935,Arsenal,Preston North End,2-1,2,1,1,1,3,1,H
1935-10-26,1935,Birmingham City,Portsmouth,4-0,4,0,1,1,4,4,H
1935-10-26,1935,Blackburn Rovers,Everton,1-1,1,1,1,1,2,0,D
1935-10-26,1935,Chelsea,Bolton Wanderers,2-1,2,1,1,1,3,1,H
1935-10-26,1935,Grimsby Town,Middlesbrough,1-0,1,0,1,1,1,1,H
1935-10-26,1935,Leeds United,Aston Villa,4-2,4,2,1,1,6,2,H
1935-10-26,1935,Liverpool,Huddersfield Town,3-0,3,0,1,1,3,3,H
1935-10-26,1935,Manchester City,Brentford,2-1,2,1,1,1,3,1,H
1935-10-26,1935,Stoke City,Derby County,0-0,0,0,1,1,0,0,D
1935-10-26,1935,Sunderland,Sheffield Wednesday,5-1,5,1,1,1,6,4,H
1935-10-26,1935,West Bromwich Albion,Wolverhampton Wanderers,2-1,2,1,1,1,3,1,H
1935-11-02,1935,Aston Villa,Grimsby Town,2-6,2,6,1,1,8,-4,A
1935-11-02,1935,Bolton Wanderers,Blackburn Rovers,3-1,3,1,1,1,4,2,H
1935-11-02,1935,Brentford,Arsenal,2-1,2,1,1,1,3,1,H
1935-11-02,1935,Derby County,Manchester City,3-0,3,0,1,1,3,3,H
1935-11-02,1935,Everton,Stoke City,5-1,5,1,1,1,6,4,H
1935-11-02,1935,Huddersfield Town,Chelsea,2-0,2,0,1,1,2,2,H
1935-11-02,1935,Middlesbrough,Liverpool,2-2,2,2,1,1,4,0,D
1935-11-02,1935,Portsmouth,Sunderland,2-2,2,2,1,1,4,0,D
1935-11-02,1935,Preston North End,Birmingham City,3-1,3,1,1,1,4,2,H
1935-11-02,1935,Sheffield Wednesday,West Bromwich Albion,2-5,2,5,1,1,7,-3,A
1935-11-02,1935,Wolverhampton Wanderers,Leeds United,3-0,3,0,1,1,3,3,H
1935-11-09,1935,Arsenal,Derby County,1-1,1,1,1,1,2,0,D
1935-11-09,1935,Birmingham City,Brentford,2-1,2,1,1,1,3,1,H
1935-11-09,1935,Blackburn Rovers,Huddersfield Town,2-1,2,1,1,1,3,1,H
1935-11-09,1935,Chelsea,Middlesbrough,2-1,2,1,1,1,3,1,H
1935-11-09,1935,Grimsby Town,Wolverhampton Wanderers,2-1,2,1,1,1,3,1,H
1935-11-09,1935,Leeds United,Sheffield Wednesday,7-2,7,2,1,1,9,5,H
1935-11-09,1935,Liverpool,Aston Villa,3-2,3,2,1,1,5,1,H
1935-11-09,1935,Manchester City,Everton,1-0,1,0,1,1,1,1,H
1935-11-09,1935,Stoke City,Bolton Wanderers,1-2,1,2,1,1,3,-1,A
1935-11-09,1935,Sunderland,Preston North End,4-2,4,2,1,1,6,2,H
1935-11-09,1935,West Bromwich Albion,Portsmouth,2-0,2,0,1,1,2,2,H
1935-11-16,1935,Aston Villa,Chelsea,2-2,2,2,1,1,4,0,D
1935-11-16,1935,Bolton Wanderers,Manchester City,3-3,3,3,1,1,6,0,D
1935-11-16,1935,Brentford,Sunderland,1-5,1,5,1,1,6,-4,A
1935-11-16,1935,Derby County,Birmingham City,2-2,2,2,1,1,4,0,D
1935-11-16,1935,Everton,Arsenal,0-2,0,2,1,1,2,-2,A
1935-11-16,1935,Huddersfield Town,Stoke City,2-1,2,1,1,1,3,1,H
1935-11-16,1935,Middlesbrough,Blackburn Rovers,6-1,6,1,1,1,7,5,H
1935-11-16,1935,Portsmouth,Leeds United,2-2,2,2,1,1,4,0,D
1935-11-16,1935,Preston North End,West Bromwich Albion,3-0,3,0,1,1,3,3,H
1935-11-16,1935,Sheffield Wednesday,Grimsby Town,3-0,3,0,1,1,3,3,H
1935-11-16,1935,Wolverhampton Wanderers,Liverpool,3-1,3,1,1,1,4,2,H
1935-11-23,1935,Arsenal,Wolverhampton Wanderers,4-0,4,0,1,1,4,4,H
1935-11-23,1935,Birmingham City,Aston Villa,2-2,2,2,1,1,4,0,D
1935-11-23,1935,Blackburn Rovers,Preston North End,1-1,1,1,1,1,2,0,D
1935-11-23,1935,Chelsea,Brentford,2-1,2,1,1,1,3,1,H
1935-11-23,1935,Grimsby Town,Everton,0-4,0,4,1,1,4,-4,A
1935-11-23,1935,Leeds United,Bolton Wanderers,5-2,5,2,1,1,7,3,H
1935-11-23,1935,Liverpool,Derby County,0-0,0,0,1,1,0,0,D
1935-11-23,1935,Manchester City,Sheffield Wednesday,3-0,3,0,1,1,3,3,H
1935-11-23,1935,Stoke City,Portsmouth,2-0,2,0,1,1,2,2,H
1935-11-23,1935,Sunderland,Middlesbrough,2-1,2,1,1,1,3,1,H
1935-11-23,1935,West Bromwich Albion,Huddersfield Town,1-2,1,2,1,1,3,-1,A
1935-11-30,1935,Aston Villa,Stoke City,4-0,4,0,1,1,4,4,H
1935-11-30,1935,Bolton Wanderers,Birmingham City,2-0,2,0,1,1,2,2,H
1935-11-30,1935,Brentford,Leeds United,2-2,2,2,1,1,4,0,D
1935-11-30,1935,Derby County,West Bromwich Albion,2-0,2,0,1,1,2,2,H
1935-11-30,1935,Everton,Sunderland,0-3,0,3,1,1,3,-3,A
1935-11-30,1935,Huddersfield Town,Arsenal,0-0,0,0,1,1,0,0,D
1935-11-30,1935,Middlesbrough,Manchester City,2-0,2,0,1,1,2,2,H
1935-11-30,1935,Portsmouth,Liverpool,2-1,2,1,1,1,3,1,H
1935-11-30,1935,Preston North End,Grimsby Town,1-0,1,0,1,1,1,1,H
1935-11-30,1935,Sheffield Wednesday,Chelsea,4-1,4,1,1,1,5,3,H
1935-11-30,1935,Wolverhampton Wanderers,Blackburn Rovers,8-1,8,1,1,1,9,7,H
1935-12-07,1935,Birmingham City,Huddersfield Town,4-1,4,1,1,1,5,3,H
1935-12-07,1935,Blackburn Rovers,Sheffield Wednesday,3-2,3,2,1,1,5,1,H
1935-12-07,1935,Grimsby Town,Brentford,6-1,6,1,1,1,7,5,H
1935-12-07,1935,Leeds United,Derby County,1-0,1,0,1,1,1,1,H
1935-12-07,1935,Liverpool,Preston North End,2-1,2,1,1,1,3,1,H
1935-12-07,1935,Manchester City,Aston Villa,5-0,5,0,1,1,5,5,H
1935-12-07,1935,Stoke City,Wolverhampton Wanderers,4-1,4,1,1,1,5,3,H
1935-12-07,1935,Sunderland,Bolton Wanderers,7-2,7,2,1,1,9,5,H
1935-12-07,1935,West Bromwich Albion,Everton,6-1,6,1,1,1,7,5,H
1935-12-09,1935,Arsenal,Middlesbrough,2-0,2,0,1,1,2,2,H
1935-12-14,1935,Aston Villa,Arsenal,1-7,1,7,1,1,8,-6,A
1935-12-14,1935,Bolton Wanderers,West Bromwich Albion,3-1,3,1,1,1,4,2,H
1935-12-14,1935,Brentford,Liverpool,1-2,1,2,1,1,3,-1,A
1935-12-14,1935,Derby County,Grimsby Town,2-0,2,0,1,1,2,2,H
1935-12-14,1935,Everton,Leeds United,0-0,0,0,1,1,0,0,D
1935-12-14,1935,Huddersfield Town,Sunderland,1-0,1,0,1,1,1,1,H
1935-12-14,1935,Middlesbrough,Birmingham City,0-2,0,2,1,1,2,-2,A
1935-12-14,1935,Portsmouth,Blackburn Rovers,3-1,3,1,1,1,4,2,H
1935-12-14,1935,Preston North End,Chelsea,2-0,2,0,1,1,2,2,H
1935-12-14,1935,Sheffield Wednesday,Stoke City,0-1,0,1,1,1,1,-1,A
1935-12-14,1935,Wolverhampton Wanderers,Manchester City,4-3,4,3,1,1,7,1,H
1935-12-21,1935,Birmingham City,Everton,4-2,4,2,1,1,6,2,H
1935-12-21,1935,Blackburn Rovers,Aston Villa,5-1,5,1,1,1,6,4,H
1935-12-21,1935,Chelsea,Wolverhampton Wanderers,2-2,2,2,1,1,4,0,D
1935-12-21,1935,Grimsby Town,Portsmouth,1-2,1,2,1,1,3,-1,A
1935-12-21,1935,Leeds United,Preston North End,0-1,0,1,1,1,1,-1,A
1935-12-21,1935,Liverpool,Sheffield Wednesday,1-0,1,0,1,1,1,1,H
1935-12-21,1935,Stoke City,Middlesbrough,1-1,1,1,1,1,2,0,D
1935-12-21,1935,Sunderland,Derby County,3-1,3,1,1,1,4,2,H
1935-12-21,1935,West Bromwich Albion,Brentford,1-0,1,0,1,1,1,1,H
1935-12-25,1935,Aston Villa,Huddersfield Town,4-1,4,1,1,1,5,3,H
1935-12-25,1935,Blackburn Rovers,Stoke City,0-1,0,1,1,1,1,-1,A
1935-12-25,1935,Bolton Wanderers,Wolverhampton Wanderers,0-3,0,3,1,1,3,-3,A
1935-12-25,1935,Brentford,Preston North End,5-2,5,2,1,1,7,3,H
1935-12-25,1935,Grimsby Town,Birmingham City,1-0,1,0,1,1,1,1,H
1935-12-25,1935,Liverpool,Arsenal,0-1,0,1,1,1,1,-1,A
1935-12-25,1935,Manchester City,Chelsea,0-0,0,0,1,1,0,0,D
1935-12-25,1935,Portsmouth,Derby County,3-0,3,0,1,1,3,3,H
1935-12-26,1935,Arsenal,Liverpool,1-2,1,2,1,1,3,-1,A
1935-12-26,1935,Birmingham City,Grimsby Town,1-1,1,1,1,1,2,0,D
1935-12-26,1935,Chelsea,Manchester City,2-1,2,1,1,1,3,1,H
1935-12-26,1935,Derby County,Portsmouth,1-1,1,1,1,1,2,0,D
1935-12-26,1935,Everton,Sheffield Wednesday,4-3,4,3,1,1,7,1,H
1935-12-26,1935,Huddersfield Town,Aston Villa,4-1,4,1,1,1,5,3,H
1935-12-26,1935,Preston North End,Brentford,2-4,2,4,1,1,6,-2,A
1935-12-26,1935,Stoke City,Blackburn Rovers,2-0,2,0,1,1,2,2,H
1935-12-26,1935,Sunderland,Leeds United,2-1,2,1,1,1,3,1,H
1935-12-26,1935,West Bromwich Albion,Middlesbrough,5-2,5,2,1,1,7,3,H
1935-12-26,1935,Wolverhampton Wanderers,Bolton Wanderers,3-3,3,3,1,1,6,0,D
1935-12-28,1935,Birmingham City,Wolverhampton Wanderers,0-0,0,0,1,1,0,0,D
1935-12-28,1935,Brentford,Bolton Wanderers,4-0,4,0,1,1,4,4,H
1935-12-28,1935,Derby County,Everton,3-3,3,3,1,1,6,0,D
1935-12-28,1935,Grimsby Town,Blackburn Rovers,1-1,1,1,1,1,2,0,D
1935-12-28,1935,Leeds United,Stoke City,4-1,4,1,1,1,5,3,H
1935-12-28,1935,Liverpool,Chelsea,2-3,2,3,1,1,5,-1,A
1935-12-28,1935,Portsmouth,Middlesbrough,1-0,1,0,1,1,1,1,H
1935-12-28,1935,Preston North End,Huddersfield Town,4-0,4,0,1,1,4,4,H
1935-12-28,1935,Sheffield Wednesday,Aston Villa,5-2,5,2,1,1,7,3,H
1935-12-28,1935,Sunderland,Arsenal,5-4,5,4,1,1,9,1,H
1935-12-28,1935,West Bromwich Albion,Manchester City,5-1,5,1,1,1,6,4,H
1936-01-01,1935,Blackburn Rovers,Brentford,1-0,1,0,1,1,1,1,H
1936-01-01,1935,Bolton Wanderers,Portsmouth,4-0,4,0,1,1,4,4,H
1936-01-01,1935,Manchester City,Grimsby Town,0-3,0,3,1,1,3,-3,A
1936-01-01,1935,Middlesbrough,West Bromwich Albion,3-1,3,1,1,1,4,2,H
1936-01-01,1935,Sunderland,Aston Villa,1-3,1,3,1,1,4,-2,A
1936-01-04,1935,Arsenal,Birmingham City,1-1,1,1,1,1,2,0,D
1936-01-04,1935,Aston Villa,Portsmouth,4-2,4,2,1,1,6,2,H
1936-01-04,1935,Blackburn Rovers,Leeds United,0-3,0,3,1,1,3,-3,A
1936-01-04,1935,Bolton Wanderers,Derby County,0-2,0,2,1,1,2,-2,A
1936-01-04,1935,Chelsea,Grimsby Town,0-2,0,2,1,1,2,-2,A
1936-01-04,1935,Everton,Liverpool,0-0,0,0,1,1,0,0,D
1936-01-04,1935,Huddersfield Town,Brentford,2-2,2,2,1,1,4,0,D
1936-01-04,1935,Manchester City,Sunderland,0-1,0,1,1,1,1,-1,A
1936-01-04,1935,Middlesbrough,Preston North End,2-0,2,0,1,1,2,2,H
1936-01-04,1935,Stoke City,West Bromwich Albion,3-2,3,2,1,1,5,1,H
1936-01-04,1935,Wolverhampton Wanderers,Sheffield Wednesday,2-1,2,1,1,1,3,1,H
1936-01-15,1935,Manchester City,Huddersfield Town,1-2,1,2,1,1,3,-1,A
1936-01-18,1935,Birmingham City,Manchester City,0-1,0,1,1,1,1,-1,A
1936-01-18,1935,Brentford,Middlesbrough,1-0,1,0,1,1,1,1,H
1936-01-18,1935,Derby County,Huddersfield Town,2-0,2,0,1,1,2,2,H
1936-01-18,1935,Grimsby Town,Liverpool,0-0,0,0,1,1,0,0,D
1936-01-18,1935,Leeds United,Chelsea,2-0,2,0,1,1,2,2,H
1936-01-18,1935,Portsmouth,Wolverhampton Wanderers,1-0,1,0,1,1,1,1,H
1936-01-18,1935,Preston North End,Aston Villa,3-0,3,0,1,1,3,3,H
1936-01-18,1935,Sheffield Wednesday,Arsenal,3-2,3,2,1,1,5,1,H
1936-01-18,1935,Sunderland,Stoke City,1-0,1,0,1,1,1,1,H
1936-01-18,1935,West Bromwich Albion,Blackburn Rovers,8-1,8,1,1,1,9,7,H
1936-01-22,1935,Everton,Bolton Wanderers,3-3,3,3,1,1,6,0,D
1936-01-25,1935,Aston Villa,Brentford,2-2,2,2,1,1,4,0,D
1936-01-29,1935,Bolton Wanderers,Grimsby Town,4-0,4,0,1,1,4,4,H
1936-01-29,1935,Huddersfield Town,Everton,2-1,2,1,1,1,3,1,H
1936-01-29,1935,Middlesbrough,Derby County,0-3,0,3,1,1,3,-3,A
1936-02-01,1935,Arsenal,Stoke City,1-0,1,0,1,1,1,1,H
1936-02-01,1935,Birmingham City,Blackburn Rovers,4-2,4,2,1,1,6,2,H
1936-02-01,1935,Bolton Wanderers,Huddersfield Town,1-2,1,2,1,1,3,-1,A
1936-02-01,1935,Brentford,Wolverhampton Wanderers,5-0,5,0,1,1,5,5,H
1936-02-01,1935,Derby County,Aston Villa,1-3,1,3,1,1,4,-2,A
1936-02-01,1935,Everton,Middlesbrough,5-2,5,2,1,1,7,3,H
1936-02-01,1935,Leeds United,Grimsby Town,1-2,1,2,1,1,3,-1,A
1936-02-01,1935,Portsmouth,Manchester City,1-2,1,2,1,1,3,-1,A
1936-02-01,1935,Preston North End,Sheffield Wednesday,0-1,0,1,1,1,1,-1,A
1936-02-01,1935,Sunderland,Chelsea,3-3,3,3,1,1,6,0,D
1936-02-01,1935,West Bromwich Albion,Liverpool,6-1,6,1,1,1,7,5,H
1936-02-03,1935,Sheffield Wednesday,Everton,3-3,3,3,1,1,6,0,D
1936-02-03,1935,Stoke City,Birmingham City,3-1,3,1,1,1,4,2,H
1936-02-08,1935,Aston Villa,Everton,1-1,1,1,1,1,2,0,D
1936-02-08,1935,Blackburn Rovers,Arsenal,0-1,0,1,1,1,1,-1,A
1936-02-08,1935,Chelsea,Birmingham City,0-0,0,0,1,1,0,0,D
1936-02-08,1935,Grimsby Town,West Bromwich Albion,4-2,4,2,1,1,6,2,H
1936-02-08,1935,Huddersfield Town,Leeds United,1-2,1,2,1,1,3,-1,A
1936-02-08,1935,Liverpool,Sunderland,0-3,0,3,1,1,3,-3,A
1936-02-08,1935,Middlesbrough,Bolton Wanderers,0-0,0,0,1,1,0,0,D
1936-02-08,1935,Portsmouth,Preston North End,1-1,1,1,1,1,2,0,D
1936-02-08,1935,Sheffield Wednesday,Brentford,3-3,3,3,1,1,6,0,D
1936-02-08,1935,Stoke City,Manchester City,1-0,1,0,1,1,1,1,H
1936-02-08,1935,Wolverhampton Wanderers,Derby County,0-0,0,0,1,1,0,0,D
1936-02-12,1935,Sheffield Wednesday,Portsmouth,0-1,0,1,1,1,1,-1,A
1936-02-15,1935,Birmingham City,Liverpool,2-0,2,0,1,1,2,2,H
1936-02-15,1935,Blackburn Rovers,Sunderland,1-1,1,1,1,1,2,0,D
1936-02-15,1935,Bolton Wanderers,Aston Villa,4-3,4,3,1,1,7,1,H
1936-02-15,1935,Everton,Wolverhampton Wanderers,4-1,4,1,1,1,5,3,H
1936-02-19,1935,Derby County,Sheffield Wednesday,3-1,3,1,1,1,4,2,H
1936-02-19,1935,Huddersfield Town,Middlesbrough,4-1,4,1,1,1,5,3,H
1936-02-19,1935,Manchester City,Blackburn Rovers,2-0,2,0,1,1,2,2,H
1936-02-19,1935,Preston North End,Stoke City,1-1,1,1,1,1,2,0,D
1936-02-19,1935,Sunderland,Grimsby Town,3-1,3,1,1,1,4,2,H
1936-02-19,1935,West Bromwich Albion,Leeds United,3-2,3,2,1,1,5,1,H
1936-02-22,1935,Arsenal,Portsmouth,2-3,2,3,1,1,5,-1,A
1936-02-22,1935,Blackburn Rovers,Derby County,0-0,0,0,1,1,0,0,D
1936-02-22,1935,Chelsea,Everton,2-2,2,2,1,1,4,0,D
1936-02-22,1935,Grimsby Town,Huddersfield Town,1-1,1,1,1,1,2,0,D
1936-02-22,1935,Leeds United,Middlesbrough,0-1,0,1,1,1,1,-1,A
1936-02-22,1935,Liverpool,Bolton Wanderers,1-1,1,1,1,1,2,0,D
1936-02-22,1935,Manchester City,Preston North End,1-3,1,3,1,1,4,-2,A
1936-02-22,1935,Stoke City,Brentford,2-2,2,2,1,1,4,0,D
1936-02-22,1935,Sunderland,Wolverhampton Wanderers,3-1,3,1,1,1,4,2,H
1936-02-29,1935,Aston Villa,Liverpool,3-0,3,0,1,1,3,3,H
1936-02-29,1935,Bolton Wanderers,Stoke City,1-2,1,2,1,1,3,-1,A
1936-02-29,1935,Brentford,Birmingham City,0-1,0,1,1,1,1,-1,A
1936-02-29,1935,Everton,Manchester City,2-2,2,2,1,1,4,0,D
1936-02-29,1935,Huddersfield Town,Blackburn Rovers,1-1,1,1,1,1,2,0,D
1936-02-29,1935,Portsmouth,West Bromwich Albion,3-1,3,1,1,1,4,2,H
1936-02-29,1935,Preston North End,Sunderland,3-2,3,2,1,1,5,1,H
1936-02-29,1935,Sheffield Wednesday,Leeds United,3-0,3,0,1,1,3,3,H
1936-03-04,1935,Derby County,Arsenal,0-4,0,4,1,1,4,-4,A
1936-03-04,1935,Middlesbrough,Chelsea,4-1,4,1,1,1,5,3,H
1936-03-04,1935,Wolverhampton Wanderers,Grimsby Town,1-0,1,0,1,1,1,1,H
1936-03-07,1935,Arsenal,Huddersfield Town,1-1,1,1,1,1,2,0,D
1936-03-07,1935,Birmingham City,Bolton Wanderers,0-0,0,0,1,1,0,0,D
1936-03-07,1935,Blackburn Rovers,Wolverhampton Wanderers,1-0,1,0,1,1,1,1,H
1936-03-07,1935,Chelsea,Sheffield Wednesday,1-2,1,2,1,1,3,-1,A
1936-03-07,1935,Grimsby Town,Preston North End,0-0,0,0,1,1,0,0,D
1936-03-07,1935,Leeds United,Brentford,1-2,1,2,1,1,3,-1,A
1936-03-07,1935,Liverpool,Portsmouth,2-0,2,0,1,1,2,2,H
1936-03-07,1935,Manchester City,Middlesbrough,6-0,6,0,1,1,6,6,H
1936-03-07,1935,Stoke City,Aston Villa,2-3,2,3,1,1,5,-1,A
1936-03-07,1935,Sunderland,Everton,3-3,3,3,1,1,6,0,D
1936-03-07,1935,West Bromwich Albion,Derby County,0-3,0,3,1,1,3,-3,A
1936-03-11,1935,Chelsea,West Bromwich Albion,2-2,2,2,1,1,4,0,D
1936-03-11,1935,Manchester City,Arsenal,1-0,1,0,1,1,1,1,H
1936-03-14,1935,Aston Villa,Leeds United,3-3,3,3,1,1,6,0,D
1936-03-14,1935,Bolton Wanderers,Chelsea,2-3,2,3,1,1,5,-1,A
1936-03-14,1935,Brentford,Manchester City,0-0,0,0,1,1,0,0,D
1936-03-14,1935,Derby County,Stoke City,0-1,0,1,1,1,1,-1,A
1936-03-14,1935,Everton,Blackburn Rovers,4-0,4,0,1,1,4,4,H
1936-03-14,1935,Huddersfield Town,Liverpool,1-0,1,0,1,1,1,1,H
1936-03-14,1935,Middlesbrough,Grimsby Town,5-1,5,1,1,1,6,4,H
1936-03-14,1935,Portsmouth,Birmingham City,0-3,0,3,1,1,3,-3,A
1936-03-14,1935,Preston North End,Arsenal,1-0,1,0,1,1,1,1,H
1936-03-14,1935,Sheffield Wednesday,Sunderland,0-0,0,0,1,1,0,0,D
1936-03-14,1935,Wolverhampton Wanderers,West Bromwich Albion,2-0,2,0,1,1,2,2,H
1936-03-18,1935,Liverpool,Leeds United,2-1,2,1,1,1,3,1,H
1936-03-21,1935,Birmingham City,Derby County,2-3,2,3,1,1,5,-1,A
1936-03-21,1935,Blackburn Rovers,Middlesbrough,2-2,2,2,1,1,4,0,D
1936-03-21,1935,Chelsea,Aston Villa,1-0,1,0,1,1,1,1,H
1936-03-21,1935,Leeds United,Portsmouth,1-0,1,0,1,1,1,1,H
1936-03-21,1935,Liverpool,Wolverhampton Wanderers,0-2,0,2,1,1,2,-2,A
1936-03-21,1935,Manchester City,Bolton Wanderers,7-0,7,0,1,1,7,7,H
1936-03-21,1935,Stoke City,Huddersfield Town,1-0,1,0,1,1,1,1,H
1936-03-21,1935,Sunderland,Brentford,1-3,1,3,1,1,4,-2,A
1936-03-21,1935,West Bromwich Albion,Preston North End,2-4,2,4,1,1,6,-2,A
1936-03-24,1935,Grimsby Town,Sheffield Wednesday,4-0,4,0,1,1,4,4,H
1936-03-25,1935,Arsenal,Everton,1-1,1,1,1,1,2,0,D
1936-03-25,1935,Brentford,Portsmouth,3-1,3,1,1,1,4,2,H
1936-03-28,1935,Aston Villa,Birmingham City,2-1,2,1,1,1,3,1,H
1936-03-28,1935,Bolton Wanderers,Leeds United,3-0,3,0,1,1,3,3,H
1936-03-28,1935,Brentford,Chelsea,2-1,2,1,1,1,3,1,H
1936-03-28,1935,Derby County,Liverpool,2-2,2,2,1,1,4,0,D
1936-03-28,1935,Everton,Grimsby Town,4-0,4,0,1,1,4,4,H
1936-03-28,1935,Huddersfield Town,West Bromwich Albion,2-3,2,3,1,1,5,-1,A
1936-03-28,1935,Middlesbrough,Sunderland,6-0,6,0,1,1,6,6,H
1936-03-28,1935,Portsmouth,Stoke City,2-0,2,0,1,1,2,2,H
1936-03-28,1935,Preston North End,Blackburn Rovers,2-0,2,0,1,1,2,2,H
1936-03-28,1935,Sheffield Wednesday,Manchester City,1-0,1,0,1,1,1,1,H
1936-03-28,1935,Wolverhampton Wanderers,Arsenal,2-2,2,2,1,1,4,0,D
1936-04-01,1935,Arsenal,Bolton Wanderers,1-1,1,1,1,1,2,0,D
1936-04-01,1935,West Bromwich Albion,Aston Villa,0-3,0,3,1,1,3,-3,A
1936-04-04,1935,Arsenal,Brentford,1-1,1,1,1,1,2,0,D
1936-04-04,1935,Birmingham City,Preston North End,0-0,0,0,1,1,0,0,D
1936-04-04,1935,Blackburn Rovers,Bolton Wanderers,0-3,0,3,1,1,3,-3,A
1936-04-04,1935,Chelsea,Huddersfield Town,1-0,1,0,1,1,1,1,H
1936-04-04,1935,Grimsby Town,Aston Villa,4-1,4,1,1,1,5,3,H
1936-04-04,1935,Leeds United,Wolverhampton Wanderers,2-0,2,0,1,1,2,2,H
1936-04-04,1935,Liverpool,Middlesbrough,2-2,2,2,1,1,4,0,D
1936-04-04,1935,Manchester City,Derby County,1-0,1,0,1,1,1,1,H
1936-04-04,1935,Stoke City,Everton,2-1,2,1,1,1,3,1,H
1936-04-04,1935,Sunderland,Portsmouth,5-0,5,0,1,1,5,5,H
1936-04-04,1935,West Bromwich Albion,Sheffield Wednesday,2-2,2,2,1,1,4,0,D
1936-04-10,1935,Arsenal,West Bromwich Albion,4-0,4,0,1,1,4,4,H
1936-04-10,1935,Aston Villa,Wolverhampton Wanderers,4-2,4,2,1,1,6,2,H
1936-04-10,1935,Blackburn Rovers,Liverpool,2-2,2,2,1,1,4,0,D
1936-04-10,1935,Bolton Wanderers,Preston North End,1-1,1,1,1,1,2,0,D
1936-04-10,1935,Chelsea,Derby County,1-1,1,1,1,1,2,0,D
1936-04-10,1935,Everton,Brentford,1-2,1,2,1,1,3,-1,A
1936-04-10,1935,Grimsby Town,Stoke City,3-0,3,0,1,1,3,3,H
1936-04-10,1935,Manchester City,Leeds United,1-3,1,3,1,1,4,-2,A
1936-04-10,1935,Portsmouth,Huddersfield Town,0-0,0,0,1,1,0,0,D
1936-04-10,1935,Sunderland,Birmingham City,2-1,2,1,1,1,3,1,H
1936-04-11,1935,Aston Villa,Manchester City,2-2,2,2,1,1,4,0,D
1936-04-11,1935,Bolton Wanderers,Sunderland,2-1,2,1,1,1,3,1,H
1936-04-11,1935,Brentford,Grimsby Town,3-0,3,0,1,1,3,3,H
1936-04-11,1935,Derby County,Leeds United,2-1,2,1,1,1,3,1,H
1936-04-11,1935,Everton,West Bromwich Albion,5-3,5,3,1,1,8,2,H
1936-04-11,1935,Huddersfield Town,Birmingham City,1-0,1,0,1,1,1,1,H
1936-04-11,1935,Middlesbrough,Arsenal,2-2,2,2,1,1,4,0,D
1936-04-11,1935,Portsmouth,Chelsea,2-0,2,0,1,1,2,2,H
1936-04-11,1935,Preston North End,Liverpool,3-1,3,1,1,1,4,2,H
1936-04-11,1935,Sheffield Wednesday,Blackburn Rovers,0-0,0,0,1,1,0,0,D
1936-04-11,1935,Wolverhampton Wanderers,Stoke City,1-1,1,1,1,1,2,0,D
1936-04-13,1935,Birmingham City,Sunderland,2-7,2,7,1,1,9,-5,A
1936-04-13,1935,Brentford,Everton,4-1,4,1,1,1,5,3,H
1936-04-13,1935,Derby County,Chelsea,1-1,1,1,1,1,2,0,D
1936-04-13,1935,Leeds United,Manchester City,1-1,1,1,1,1,2,0,D
1936-04-13,1935,Liverpool,Blackburn Rovers,4-1,4,1,1,1,5,3,H
1936-04-13,1935,Middlesbrough,Sheffield Wednesday,5-0,5,0,1,1,5,5,H
1936-04-13,1935,Preston North End,Bolton Wanderers,1-0,1,0,1,1,1,1,H
1936-04-13,1935,Stoke City,Grimsby Town,1-0,1,0,1,1,1,1,H
1936-04-13,1935,West Bromwich Albion,Arsenal,1-0,1,0,1,1,1,1,H
1936-04-13,1935,Wolverhampton Wanderers,Aston Villa,2-2,2,2,1,1,4,0,D
1936-04-14,1935,Huddersfield Town,Portsmouth,1-1,1,1,1,1,2,0,D
1936-04-14,1935,Sheffield Wednesday,Middlesbrough,0-0,0,0,1,1,0,0,D
1936-04-18,1935,Arsenal,Aston Villa,1-0,1,0,1,1,1,1,H
1936-04-18,1935,Birmingham City,Middlesbrough,1-0,1,0,1,1,1,1,H
1936-04-18,1935,Blackburn Rovers,Portsmouth,3-1,3,1,1,1,4,2,H
1936-04-18,1935,Chelsea,Preston North End,5-2,5,2,1,1,7,3,H
1936-04-18,1935,Grimsby Town,Derby County,4-1,4,1,1,1,5,3,H
1936-04-18,1935,Leeds United,Everton,3-1,3,1,1,1,4,2,H
1936-04-18,1935,Liverpool,Brentford,0-0,0,0,1,1,0,0,D
1936-04-18,1935,Manchester City,Wolverhampton Wanderers,2-1,2,1,1,1,3,1,H
1936-04-18,1935,Stoke City,Sheffield Wednesday,0-3,0,3,1,1,3,-3,A
1936-04-18,1935,Sunderland,Huddersfield Town,4-3,4,3,1,1,7,1,H
1936-04-18,1935,West Bromwich Albion,Bolton Wanderers,2-2,2,2,1,1,4,0,D
1936-04-20,1935,Wolverhampton Wanderers,Preston North End,4-2,4,2,1,1,6,2,H
1936-04-22,1935,Birmingham City,Sheffield Wednesday,4-1,4,1,1,1,5,3,H
1936-04-22,1935,Chelsea,Portsmouth,1-0,1,0,1,1,1,1,H
1936-04-22,1935,Leeds United,Sunderland,3-0,3,0,1,1,3,3,H
1936-04-25,1935,Aston Villa,Blackburn Rovers,2-4,2,4,1,1,6,-2,A
1936-04-25,1935,Brentford,West Bromwich Albion,2-2,2,2,1,1,4,0,D
1936-04-25,1935,Derby County,Sunderland,4-0,4,0,1,1,4,4,H
1936-04-25,1935,Everton,Birmingham City,4-3,4,3,1,1,7,1,H
1936-04-25,1935,Huddersfield Town,Manchester City,1-1,1,1,1,1,2,0,D
1936-04-25,1935,Middlesbrough,Stoke City,0-0,0,0,1,1,0,0,D
1936-04-25,1935,Portsmouth,Grimsby Town,3-2,3,2,1,1,5,1,H
1936-04-25,1935,Preston North End,Leeds United,5-0,5,0,1,1,5,5,H
1936-04-25,1935,Sheffield Wednesday,Liverpool,0-0,0,0,1,1,0,0,D
1936-04-25,1935,Wolverhampton Wanderers,Chelsea,3-3,3,3,1,1,6,0,D
1936-04-27,1935,Arsenal,Chelsea,1-1,1,1,1,1,2,0,D
1936-04-29,1935,Bolton Wanderers,Arsenal,2-1,2,1,1,1,3,1,H
1936-05-02,1935,Arsenal,Leeds United,2-2,2,2,1,1,4,0,D
1936-05-02,1935,Birmingham City,West Bromwich Albion,1-3,1,3,1,1,4,-2,A
1936-05-02,1935,Brentford,Derby County,6-0,6,0,1,1,6,6,H
1936-05-02,1935,Chelsea,Blackburn Rovers,5-1,5,1,1,1,6,4,H
1936-05-02,1935,Everton,Preston North End,5-0,5,0,1,1,5,5,H
1936-05-02,1935,Grimsby Town,Manchester City,3-1,3,1,1,1,4,2,H
1936-05-02,1935,Huddersfield Town,Sheffield Wednesday,1-0,1,0,1,1,1,1,H
1936-05-02,1935,Portsmouth,Bolton Wanderers,2-1,2,1,1,1,3,1,H
1936-05-02,1935,Stoke City,Liverpool,2-1,2,1,1,1,3,1,H
1936-05-02,1935,Wolverhampton Wanderers,Middlesbrough,4-0,4,0,1,1,4,4,H
1936-08-29,1936,Arsenal,Everton,3-2,3,2,1,1,5,1,H
1936-08-29,1936,Birmingham City,Portsmouth,2-1,2,1,1,1,3,1,H
1936-08-29,1936,Brentford,Bolton Wanderers,2-2,2,2,1,1,4,0,D
1936-08-29,1936,Grimsby Town,Charlton Athletic,0-1,0,1,1,1,1,-1,A
1936-08-29,1936,Leeds United,Chelsea,2-3,2,3,1,1,5,-1,A
1936-08-29,1936,Liverpool,Stoke City,2-1,2,1,1,1,3,1,H
1936-08-29,1936,Manchester United,Wolverhampton Wanderers,1-1,1,1,1,1,2,0,D
1936-08-29,1936,Middlesbrough,Manchester City,2-0,2,0,1,1,2,2,H
1936-08-29,1936,Preston North End,Huddersfield Town,1-1,1,1,1,1,2,0,D
1936-08-29,1936,Sheffield Wednesday,Sunderland,2-0,2,0,1,1,2,2,H
1936-08-29,1936,West Bromwich Albion,Derby County,1-3,1,3,1,1,4,-2,A
1936-08-31,1936,Preston North End,Bolton Wanderers,1-2,1,2,1,1,3,-1,A
1936-08-31,1936,Stoke City,Charlton Athletic,1-1,1,1,1,1,2,0,D
1936-08-31,1936,Wolverhampton Wanderers,Middlesbrough,0-1,0,1,1,1,1,-1,A
1936-09-02,1936,Chelsea,Grimsby Town,3-2,3,2,1,1,5,1,H
1936-09-02,1936,Everton,Sheffield Wednesday,3-1,3,1,1,1,4,2,H
1936-09-02,1936,Huddersfield Town,Manchester United,3-1,3,1,1,1,4,2,H
1936-09-02,1936,Manchester City,Leeds United,4-0,4,0,1,1,4,4,H
1936-09-02,1936,Portsmouth,Liverpool,6-2,6,2,1,1,8,4,H
1936-09-02,1936,Sunderland,Derby County,3-2,3,2,1,1,5,1,H
1936-09-02,1936,West Bromwich Albion,Birmingham City,3-2,3,2,1,1,5,1,H
1936-09-03,1936,Brentford,Arsenal,2-0,2,0,1,1,2,2,H
1936-09-05,1936,Bolton Wanderers,Grimsby Town,1-2,1,2,1,1,3,-1,A
1936-09-05,1936,Charlton Athletic,Liverpool,1-1,1,1,1,1,2,0,D
1936-09-05,1936,Chelsea,Birmingham City,1-3,1,3,1,1,4,-2,A
1936-09-05,1936,Derby County,Manchester United,5-4,5,4,1,1,9,1,H
1936-09-05,1936,Everton,Brentford,3-0,3,0,1,1,3,3,H
1936-09-05,1936,Huddersfield Town,Arsenal,0-0,0,0,1,1,0,0,D
1936-09-05,1936,Manchester City,West Bromwich Albion,6-2,6,2,1,1,8,4,H
1936-09-05,1936,Portsmouth,Middlesbrough,2-1,2,1,1,1,3,1,H
1936-09-05,1936,Stoke City,Leeds United,2-1,2,1,1,1,3,1,H
1936-09-05,1936,Sunderland,Preston North End,3-0,3,0,1,1,3,3,H
1936-09-05,1936,Wolverhampton Wanderers,Sheffield Wednesday,4-3,4,3,1,1,7,1,H
1936-09-07,1936,Bolton Wanderers,Preston North End,0-0,0,0,1,1,0,0,D
1936-09-07,1936,Charlton Athletic,Stoke City,2-0,2,0,1,1,2,2,H
1936-09-08,1936,Grimsby Town,Chelsea,3-0,3,0,1,1,3,3,H
1936-09-09,1936,Arsenal,Brentford,1-1,1,1,1,1,2,0,D
1936-09-09,1936,Birmingham City,West Bromwich Albion,1-1,1,1,1,1,2,0,D
1936-09-09,1936,Derby County,Sunderland,3-0,3,0,1,1,3,3,H
1936-09-09,1936,Leeds United,Manchester City,1-1,1,1,1,1,2,0,D
1936-09-09,1936,Liverpool,Portsmouth,0-0,0,0,1,1,0,0,D
1936-09-09,1936,Manchester United,Huddersfield Town,3-1,3,1,1,1,4,2,H
1936-09-09,1936,Middlesbrough,Wolverhampton Wanderers,1-0,1,0,1,1,1,1,H
1936-09-10,1936,Sheffield Wednesday,Everton,6-4,6,4,1,1,10,2,H
1936-09-12,1936,Arsenal,Sunderland,4-1,4,1,1,1,5,3,H
1936-09-12,1936,Birmingham City,Stoke City,2-4,2,4,1,1,6,-2,A
1936-09-12,1936,Bolton Wanderers,Everton,1-2,1,2,1,1,3,-1,A
1936-09-12,1936,Brentford,Huddersfield Town,1-1,1,1,1,1,2,0,D
1936-09-12,1936,Leeds United,Charlton Athletic,2-0,2,0,1,1,2,2,H
1936-09-12,1936,Liverpool,Grimsby Town,7-1,7,1,1,1,8,6,H
1936-09-12,1936,Manchester United,Manchester City,3-2,3,2,1,1,5,1,H
1936-09-12,1936,Middlesbrough,Chelsea,2-0,2,0,1,1,2,2,H
1936-09-12,1936,Preston North End,Wolverhampton Wanderers,1-3,1,3,1,1,4,-2,A
1936-09-12,1936,Sheffield Wednesday,Derby County,2-3,2,3,1,1,5,-1,A
1936-09-12,1936,West Bromwich Albion,Portsmouth,3-1,3,1,1,1,4,2,H
1936-09-14,1936,Stoke City,Grimsby Town,2-0,2,0,1,1,2,2,H
1936-09-16,1936,Chelsea,Liverpool,2-0,2,0,1,1,2,2,H
1936-09-16,1936,Manchester City,Birmingham City,1-1,1,1,1,1,2,0,D
1936-09-16,1936,Portsmouth,Leeds United,3-0,3,0,1,1,3,3,H
1936-09-17,1936,Brentford,Charlton Athletic,4-2,4,2,1,1,6,2,H
1936-09-17,1936,Sheffield Wednesday,Huddersfield Town,2-2,2,2,1,1,4,0,D
1936-09-19,1936,Charlton Athletic,Birmingham City,2-2,2,2,1,1,4,0,D
1936-09-19,1936,Chelsea,West Bromwich Albion,3-0,3,0,1,1,3,3,H
1936-09-19,1936,Derby County,Preston North End,1-2,1,2,1,1,3,-1,A
1936-09-19,1936,Everton,Liverpool,2-0,2,0,1,1,2,2,H
1936-09-19,1936,Grimsby Town,Leeds United,4-1,4,1,1,1,5,3,H
1936-09-19,1936,Huddersfield Town,Bolton Wanderers,2-0,2,0,1,1,2,2,H
1936-09-19,1936,Manchester United,Sheffield Wednesday,1-1,1,1,1,1,2,0,D
1936-09-19,1936,Portsmouth,Manchester City,2-1,2,1,1,1,3,1,H
1936-09-19,1936,Stoke City,Middlesbrough,6-2,6,2,1,1,8,4,H
1936-09-19,1936,Sunderland,Brentford,4-1,4,1,1,1,5,3,H
1936-09-19,1936,Wolverhampton Wanderers,Arsenal,2-0,2,0,1,1,2,2,H
1936-09-23,1936,Derby County,Wolverhampton Wanderers,5-1,5,1,1,1,6,4,H
1936-09-26,1936,Arsenal,Derby County,2-2,2,2,1,1,4,0,D
1936-09-26,1936,Birmingham City,Grimsby Town,2-3,2,3,1,1,5,-1,A
1936-09-26,1936,Bolton Wanderers,Sunderland,1-1,1,1,1,1,2,0,D
1936-09-26,1936,Brentford,Wolverhampton Wanderers,3-2,3,2,1,1,5,1,H
1936-09-26,1936,Everton,Huddersfield Town,2-1,2,1,1,1,3,1,H
1936-09-26,1936,Leeds United,Liverpool,2-0,2,0,1,1,2,2,H
1936-09-26,1936,Manchester City,Chelsea,0-0,0,0,1,1,0,0,D
1936-09-26,1936,Middlesbrough,Charlton Athletic,1-1,1,1,1,1,2,0,D
1936-09-26,1936,Preston North End,Manchester United,3-1,3,1,1,1,4,2,H
1936-09-26,1936,Sheffield Wednesday,Portsmouth,0-0,0,0,1,1,0,0,D
1936-09-26,1936,West Bromwich Albion,Stoke City,2-2,2,2,1,1,4,0,D
1936-10-03,1936,Charlton Athletic,West Bromwich Albion,4-2,4,2,1,1,6,2,H
1936-10-03,1936,Chelsea,Portsmouth,1-1,1,1,1,1,2,0,D
1936-10-03,1936,Grimsby Town,Middlesbrough,5-1,5,1,1,1,6,4,H
1936-10-03,1936,Huddersfield Town,Leeds United,3-0,3,0,1,1,3,3,H
1936-10-03,1936,Liverpool,Birmingham City,2-0,2,0,1,1,2,2,H
1936-10-03,1936,Manchester United,Arsenal,2-0,2,0,1,1,2,2,H
1936-10-03,1936,Sheffield Wednesday,Preston North End,0-1,0,1,1,1,1,-1,A
1936-10-03,1936,Stoke City,Manchester City,2-2,2,2,1,1,4,0,D
1936-10-03,1936,Sunderland,Everton,3-1,3,1,1,1,4,2,H
1936-10-03,1936,Wolverhampton Wanderers,Bolton Wanderers,2-3,2,3,1,1,5,-1,A
1936-10-10,1936,Arsenal,Sheffield Wednesday,1-1,1,1,1,1,2,0,D
1936-10-10,1936,Birmingham City,Leeds United,2-1,2,1,1,1,3,1,H
1936-10-10,1936,Bolton Wanderers,Derby County,1-3,1,3,1,1,4,-2,A
1936-10-10,1936,Brentford,Manchester United,4-0,4,0,1,1,4,4,H
1936-10-10,1936,Everton,Wolverhampton Wanderers,1-0,1,0,1,1,1,1,H
1936-10-10,1936,Huddersfield Town,Sunderland,2-1,2,1,1,1,3,1,H
1936-10-10,1936,Manchester City,Charlton Athletic,1-1,1,1,1,1,2,0,D
1936-10-10,1936,Middlesbrough,Liverpool,3-3,3,3,1,1,6,0,D
1936-10-10,1936,Portsmouth,Stoke City,1-0,1,0,1,1,1,1,H
1936-10-10,1936,Preston North End,Chelsea,1-0,1,0,1,1,1,1,H
1936-10-10,1936,West Bromwich Albion,Grimsby Town,4-2,4,2,1,1,6,2,H
1936-10-17,1936,Birmingham City,Huddersfield Town,4-2,4,2,1,1,6,2,H
1936-10-17,1936,Charlton Athletic,Arsenal,0-2,0,2,1,1,2,-2,A
1936-10-17,1936,Chelsea,Sheffield Wednesday,1-1,1,1,1,1,2,0,D
1936-10-17,1936,Grimsby Town,Brentford,2-0,2,0,1,1,2,2,H
1936-10-17,1936,Leeds United,Everton,3-0,3,0,1,1,3,3,H
1936-10-17,1936,Liverpool,Bolton Wanderers,0-0,0,0,1,1,0,0,D
1936-10-17,1936,Manchester City,Derby County,3-2,3,2,1,1,5,1,H
1936-10-17,1936,Middlesbrough,Sunderland,5-5,5,5,1,1,10,0,D
1936-10-17,1936,Portsmouth,Manchester United,2-1,2,1,1,1,3,1,H
1936-10-17,1936,Stoke City,Preston North End,0-2,0,2,1,1,2,-2,A
1936-10-17,1936,West Bromwich Albion,Wolverhampton Wanderers,2-1,2,1,1,1,3,1,H
1936-10-23,1936,Derby County,Brentford,2-3,2,3,1,1,5,-1,A
1936-10-24,1936,Arsenal,Grimsby Town,0-0,0,0,1,1,0,0,D
1936-10-24,1936,Bolton Wanderers,Leeds United,2-1,2,1,1,1,3,1,H
1936-10-24,1936,Brentford,Liverpool,5-2,5,2,1,1,7,3,H
1936-10-24,1936,Derby County,Portsmouth,1-3,1,3,1,1,4,-2,A
1936-10-24,1936,Everton,Birmingham City,3-3,3,3,1,1,6,0,D
1936-10-24,1936,Huddersfield Town,Middlesbrough,2-0,2,0,1,1,2,2,H
1936-10-24,1936,Manchester United,Chelsea,0-0,0,0,1,1,0,0,D
1936-10-24,1936,Preston North End,Charlton Athletic,0-0,0,0,1,1,0,0,D
1936-10-24,1936,Sheffield Wednesday,Stoke City,0-0,0,0,1,1,0,0,D
1936-10-24,1936,Sunderland,West Bromwich Albion,1-0,1,0,1,1,1,1,H
1936-10-24,1936,Wolverhampton Wanderers,Manchester City,2-1,2,1,1,1,3,1,H
1936-10-31,1936,Birmingham City,Bolton Wanderers,1-1,1,1,1,1,2,0,D
1936-10-31,1936,Charlton Athletic,Sheffield Wednesday,1-0,1,0,1,1,1,1,H
1936-10-31,1936,Chelsea,Derby County,1-1,1,1,1,1,2,0,D
1936-10-31,1936,Grimsby Town,Preston North End,6-4,6,4,1,1,10,2,H
1936-10-31,1936,Leeds United,Brentford,3-1,3,1,1,1,4,2,H
1936-10-31,1936,Liverpool,Arsenal,2-1,2,1,1,1,3,1,H
1936-10-31,1936,Manchester City,Sunderland,2-4,2,4,1,1,6,-2,A
1936-10-31,1936,Middlesbrough,Everton,2-0,2,0,1,1,2,2,H
1936-10-31,1936,Portsmouth,Wolverhampton Wanderers,1-1,1,1,1,1,2,0,D
1936-10-31,1936,Stoke City,Manchester United,3-0,3,0,1,1,3,3,H
1936-10-31,1936,West Bromwich Albion,Huddersfield Town,2-1,2,1,1,1,3,1,H
1936-11-03,1936,West Bromwich Albion,Bolton Wanderers,0-2,0,2,1,1,2,-2,A
1936-11-07,1936,Arsenal,Leeds United,4-1,4,1,1,1,5,3,H
1936-11-07,1936,Bolton Wanderers,Middlesbrough,1-3,1,3,1,1,4,-2,A
1936-11-07,1936,Brentford,Birmingham City,2-1,2,1,1,1,3,1,H
1936-11-07,1936,Derby County,Stoke City,2-2,2,2,1,1,4,0,D
1936-11-07,1936,Everton,West Bromwich Albion,4-2,4,2,1,1,6,2,H
1936-11-07,1936,Huddersfield Town,Manchester City,1-1,1,1,1,1,2,0,D
1936-11-07,1936,Manchester United,Charlton Athletic,0-0,0,0,1,1,0,0,D
1936-11-07,1936,Preston North End,Liverpool,3-1,3,1,1,1,4,2,H
1936-11-07,1936,Sheffield Wednesday,Grimsby Town,2-1,2,1,1,1,3,1,H
1936-11-07,1936,Sunderland,Portsmouth,3-2,3,2,1,1,5,1,H
1936-11-07,1936,Wolverhampton Wanderers,Chelsea,1-2,1,2,1,1,3,-1,A
1936-11-14,1936,Birmingham City,Arsenal,1-3,1,3,1,1,4,-2,A
1936-11-14,1936,Charlton Athletic,Derby County,2-0,2,0,1,1,2,2,H
1936-11-14,1936,Chelsea,Sunderland,1-3,1,3,1,1,4,-2,A
1936-11-14,1936,Grimsby Town,Manchester United,6-2,6,2,1,1,8,4,H
1936-11-14,1936,Leeds United,Preston North End,1-0,1,0,1,1,1,1,H
1936-11-14,1936,Liverpool,Sheffield Wednesday,2-2,2,2,1,1,4,0,D
1936-11-14,1936,Manchester City,Everton,4-1,4,1,1,1,5,3,H
1936-11-14,1936,Middlesbrough,Brentford,3-0,3,0,1,1,3,3,H
1936-11-14,1936,Portsmouth,Huddersfield Town,1-0,1,0,1,1,1,1,H
1936-11-14,1936,Stoke City,Wolverhampton Wanderers,2-1,2,1,1,1,3,1,H
1936-11-21,1936,Arsenal,Middlesbrough,5-3,5,3,1,1,8,2,H
1936-11-21,1936,Bolton Wanderers,Manchester City,0-2,0,2,1,1,2,-2,A
1936-11-21,1936,Brentford,West Bromwich Albion,2-1,2,1,1,1,3,1,H
1936-11-21,1936,Derby County,Grimsby Town,3-1,3,1,1,1,4,2,H
1936-11-21,1936,Everton,Portsmouth,4-0,4,0,1,1,4,4,H
1936-11-21,1936,Huddersfield Town,Chelsea,4-2,4,2,1,1,6,2,H
1936-11-21,1936,Manchester United,Liverpool,2-5,2,5,1,1,7,-3,A
1936-11-21,1936,Preston North End,Birmingham City,2-2,2,2,1,1,4,0,D
1936-11-21,1936,Sheffield Wednesday,Leeds United,1-2,1,2,1,1,3,-1,A
1936-11-21,1936,Sunderland,Stoke City,3-0,3,0,1,1,3,3,H
1936-11-21,1936,Wolverhampton Wanderers,Charlton Athletic,6-1,6,1,1,1,7,5,H
1936-11-28,1936,Birmingham City,Sheffield Wednesday,1-1,1,1,1,1,2,0,D
1936-11-28,1936,Charlton Athletic,Sunderland,3-1,3,1,1,1,4,2,H
1936-11-28,1936,Chelsea,Everton,4-0,4,0,1,1,4,4,H
1936-11-28,1936,Grimsby Town,Wolverhampton Wanderers,1-1,1,1,1,1,2,0,D
1936-11-28,1936,Leeds United,Manchester United,2-1,2,1,1,1,3,1,H
1936-11-28,1936,Liverpool,Derby County,3-3,3,3,1,1,6,0,D
1936-11-28,1936,Middlesbrough,Preston North End,2-1,2,1,1,1,3,1,H
1936-11-28,1936,Portsmouth,Bolton Wanderers,1-1,1,1,1,1,2,0,D
1936-11-28,1936,Stoke City,Huddersfield Town,1-1,1,1,1,1,2,0,D
1936-11-28,1936,West Bromwich Albion,Arsenal,2-4,2,4,1,1,6,-2,A
1936-12-05,1936,Arsenal,Manchester City,1-3,1,3,1,1,4,-2,A
1936-12-05,1936,Bolton Wanderers,Chelsea,2-1,2,1,1,1,3,1,H
1936-12-05,1936,Brentford,Portsmouth,4-0,4,0,1,1,4,4,H
1936-12-05,1936,Derby County,Leeds United,5-3,5,3,1,1,8,2,H
1936-12-05,1936,Everton,Stoke City,1-1,1,1,1,1,2,0,D
1936-12-05,1936,Huddersfield Town,Charlton Athletic,1-2,1,2,1,1,3,-1,A
1936-12-05,1936,Manchester United,Birmingham City,1-2,1,2,1,1,3,-1,A
1936-12-05,1936,Preston North End,West Bromwich Albion,3-2,3,2,1,1,5,1,H
1936-12-05,1936,Sheffield Wednesday,Middlesbrough,1-0,1,0,1,1,1,1,H
1936-12-05,1936,Sunderland,Grimsby Town,5-1,5,1,1,1,6,4,H
1936-12-05,1936,Wolverhampton Wanderers,Liverpool,2-0,2,0,1,1,2,2,H
1936-12-12,1936,Birmingham City,Derby County,0-1,0,1,1,1,1,-1,A
1936-12-12,1936,Charlton Athletic,Everton,2-0,2,0,1,1,2,2,H
1936-12-12,1936,Chelsea,Brentford,2-1,2,1,1,1,3,1,H
1936-12-12,1936,Grimsby Town,Huddersfield Town,2-2,2,2,1,1,4,0,D
1936-12-12,1936,Liverpool,Sunderland,4-0,4,0,1,1,4,4,H
1936-12-12,1936,Manchester City,Preston North End,4-1,4,1,1,1,5,3,H
1936-12-12,1936,Middlesbrough,Manchester United,3-2,3,2,1,1,5,1,H
1936-12-12,1936,Portsmouth,Arsenal,1-5,1,5,1,1,6,-4,A
1936-12-12,1936,Stoke City,Bolton Wanderers,2-2,2,2,1,1,4,0,D
1936-12-19,1936,Arsenal,Chelsea,4-1,4,1,1,1,5,3,H
1936-12-19,1936,Bolton Wanderers,Charlton Athletic,2-1,2,1,1,1,3,1,H
1936-12-19,1936,Brentford,Stoke City,2-1,2,1,1,1,3,1,H
1936-12-19,1936,Derby County,Middlesbrough,0-2,0,2,1,1,2,-2,A
1936-12-19,1936,Everton,Grimsby Town,3-0,3,0,1,1,3,3,H
1936-12-19,1936,Huddersfield Town,Liverpool,4-0,4,0,1,1,4,4,H
1936-12-19,1936,Manchester United,West Bromwich Albion,2-2,2,2,1,1,4,0,D
1936-12-19,1936,Preston North End,Portsmouth,1-1,1,1,1,1,2,0,D
1936-12-19,1936,Sheffield Wednesday,Manchester City,5-1,5,1,1,1,6,4,H
1936-12-19,1936,Sunderland,Leeds United,2-1,2,1,1,1,3,1,H
1936-12-19,1936,Wolverhampton Wanderers,Birmingham City,2-1,2,1,1,1,3,1,H
1936-12-25,1936,Arsenal,Preston North End,4-1,4,1,1,1,5,3,H
1936-12-25,1936,Birmingham City,Sunderland,2-0,2,0,1,1,2,2,H
1936-12-25,1936,Brentford,Sheffield Wednesday,2-1,2,1,1,1,3,1,H
1936-12-25,1936,Charlton Athletic,Portsmouth,0-0,0,0,1,1,0,0,D
1936-12-25,1936,Everton,Derby County,7-0,7,0,1,1,7,7,H
1936-12-25,1936,Grimsby Town,Manchester City,5-3,5,3,1,1,8,2,H
1936-12-25,1936,Leeds United,Middlesbrough,5-0,5,0,1,1,5,5,H
1936-12-25,1936,Manchester United,Bolton Wanderers,1-0,1,0,1,1,1,1,H
1936-12-25,1936,Stoke City,Chelsea,2-0,2,0,1,1,2,2,H
1936-12-25,1936,West Bromwich Albion,Liverpool,3-1,3,1,1,1,4,2,H
1936-12-25,1936,Wolverhampton Wanderers,Huddersfield Town,3-1,3,1,1,1,4,2,H
1936-12-26,1936,Bolton Wanderers,Brentford,2-2,2,2,1,1,4,0,D
1936-12-26,1936,Charlton Athletic,Grimsby Town,1-0,1,0,1,1,1,1,H
1936-12-26,1936,Chelsea,Leeds United,2-1,2,1,1,1,3,1,H
1936-12-26,1936,Derby County,West Bromwich Albion,1-0,1,0,1,1,1,1,H
1936-12-26,1936,Everton,Arsenal,1-1,1,1,1,1,2,0,D
1936-12-26,1936,Huddersfield Town,Preston North End,4-2,4,2,1,1,6,2,H
1936-12-26,1936,Manchester City,Middlesbrough,2-1,2,1,1,1,3,1,H
1936-12-26,1936,Portsmouth,Birmingham City,2-1,2,1,1,1,3,1,H
1936-12-26,1936,Stoke City,Liverpool,1-1,1,1,1,1,2,0,D
1936-12-26,1936,Sunderland,Sheffield Wednesday,2-1,2,1,1,1,3,1,H
1936-12-26,1936,Wolverhampton Wanderers,Manchester United,3-1,3,1,1,1,4,2,H
1936-12-28,1936,Bolton Wanderers,Manchester United,0-4,0,4,1,1,4,-4,A
1936-12-28,1936,Chelsea,Stoke City,1-0,1,0,1,1,1,1,H
1936-12-28,1936,Derby County,Everton,3-1,3,1,1,1,4,2,H
1936-12-28,1936,Huddersfield Town,Wolverhampton Wanderers,4-0,4,0,1,1,4,4,H
1936-12-28,1936,Liverpool,West Bromwich Albion,1-2,1,2,1,1,3,-1,A
1936-12-28,1936,Manchester City,Grimsby Town,1-1,1,1,1,1,2,0,D
1936-12-28,1936,Middlesbrough,Leeds United,4-2,4,2,1,1,6,2,H
1936-12-28,1936,Portsmouth,Charlton Athletic,0-1,0,1,1,1,1,-1,A
1936-12-28,1936,Preston North End,Arsenal,1-3,1,3,1,1,4,-2,A
1936-12-28,1936,Sheffield Wednesday,Brentford,0-2,0,2,1,1,2,-2,A
1936-12-28,1936,Sunderland,Birmingham City,4-0,4,0,1,1,4,4,H
1937-01-01,1936,Bolton Wanderers,Arsenal,0-5,0,5,1,1,5,-5,A
1937-01-01,1936,Everton,Preston North End,2-2,2,2,1,1,4,0,D
1937-01-01,1936,Manchester United,Sunderland,2-1,2,1,1,1,3,1,H
1937-01-01,1936,Middlesbrough,West Bromwich Albion,4-1,4,1,1,1,5,3,H
1937-01-02,1936,Arsenal,Huddersfield Town,1-1,1,1,1,1,2,0,D
1937-01-02,1936,Birmingham City,Chelsea,0-0,0,0,1,1,0,0,D
1937-01-02,1936,Brentford,Everton,2-2,2,2,1,1,4,0,D
1937-01-02,1936,Grimsby Town,Bolton Wanderers,3-1,3,1,1,1,4,2,H
1937-01-02,1936,Leeds United,Stoke City,2-1,2,1,1,1,3,1,H
1937-01-02,1936,Liverpool,Charlton Athletic,1-2,1,2,1,1,3,-1,A
1937-01-02,1936,Manchester United,Derby County,2-2,2,2,1,1,4,0,D
1937-01-02,1936,Middlesbrough,Portsmouth,2-2,2,2,1,1,4,0,D
1937-01-02,1936,Preston North End,Sunderland,2-0,2,0,1,1,2,2,H
1937-01-02,1936,Sheffield Wednesday,Wolverhampton Wanderers,1-3,1,3,1,1,4,-2,A
1937-01-02,1936,West Bromwich Albion,Manchester City,2-2,2,2,1,1,4,0,D
1937-01-09,1936,Charlton Athletic,Leeds United,1-0,1,0,1,1,1,1,H
1937-01-09,1936,Chelsea,Middlesbrough,1-0,1,0,1,1,1,1,H
1937-01-09,1936,Derby County,Sheffield Wednesday,3-2,3,2,1,1,5,1,H
1937-01-09,1936,Everton,Bolton Wanderers,3-2,3,2,1,1,5,1,H
1937-01-09,1936,Grimsby Town,Liverpool,2-1,2,1,1,1,3,1,H
1937-01-09,1936,Huddersfield Town,Brentford,1-1,1,1,1,1,2,0,D
1937-01-09,1936,Manchester City,Manchester United,1-0,1,0,1,1,1,1,H
1937-01-09,1936,Portsmouth,West Bromwich Albion,5-3,5,3,1,1,8,2,H
1937-01-09,1936,Stoke City,Birmingham City,2-0,2,0,1,1,2,2,H
1937-01-09,1936,Sunderland,Arsenal,1-1,1,1,1,1,2,0,D
1937-01-09,1936,Wolverhampton Wanderers,Preston North End,5-0,5,0,1,1,5,5,H
1937-01-23,1936,Arsenal,Wolverhampton Wanderers,3-0,3,0,1,1,3,3,H
1937-01-23,1936,Birmingham City,Charlton Athletic,1-2,1,2,1,1,3,-1,A
1937-01-23,1936,Bolton Wanderers,Huddersfield Town,2-2,2,2,1,1,4,0,D
1937-01-23,1936,Brentford,Sunderland,3-3,3,3,1,1,6,0,D
1937-01-23,1936,Leeds United,Grimsby Town,2-0,2,0,1,1,2,2,H
1937-01-23,1936,Liverpool,Everton,3-2,3,2,1,1,5,1,H
1937-01-23,1936,Manchester City,Portsmouth,3-1,3,1,1,1,4,2,H
1937-01-23,1936,Middlesbrough,Stoke City,1-0,1,0,1,1,1,1,H
1937-01-23,1936,Preston North End,Derby County,5-2,5,2,1,1,7,3,H
1937-01-23,1936,Sheffield Wednesday,Manchester United,1-0,1,0,1,1,1,1,H
1937-01-23,1936,West Bromwich Albion,Chelsea,2-0,2,0,1,1,2,2,H
1937-01-30,1936,Charlton Athletic,Middlesbrough,2-2,2,2,1,1,4,0,D
1937-01-30,1936,Liverpool,Leeds United,3-0,3,0,1,1,3,3,H
1937-02-02,1936,Grimsby Town,Birmingham City,1-1,1,1,1,1,2,0,D
1937-02-03,1936,Chelsea,Manchester City,4-4,4,4,1,1,8,0,D
1937-02-03,1936,Derby County,Arsenal,5-4,5,4,1,1,9,1,H
1937-02-03,1936,Huddersfield Town,Everton,0-3,0,3,1,1,3,-3,A
1937-02-03,1936,Manchester United,Preston North End,1-1,1,1,1,1,2,0,D
1937-02-03,1936,Portsmouth,Sheffield Wednesday,1-0,1,0,1,1,1,1,H
1937-02-04,1936,Stoke City,West Bromwich Albion,10-3,10,3,1,1,13,7,H
1937-02-06,1936,Arsenal,Manchester United,1-1,1,1,1,1,2,0,D
1937-02-06,1936,Birmingham City,Liverpool,5-0,5,0,1,1,5,5,H
1937-02-06,1936,Bolton Wanderers,Wolverhampton Wanderers,1-2,1,2,1,1,3,-1,A
1937-02-06,1936,Brentford,Derby County,6-2,6,2,1,1,8,4,H
1937-02-06,1936,Everton,Sunderland,3-0,3,0,1,1,3,3,H
1937-02-06,1936,Leeds United,Huddersfield Town,2-1,2,1,1,1,3,1,H
1937-02-06,1936,Manchester City,Stoke City,2-1,2,1,1,1,3,1,H
1937-02-06,1936,Middlesbrough,Grimsby Town,0-0,0,0,1,1,0,0,D
1937-02-06,1936,Portsmouth,Chelsea,4-1,4,1,1,1,5,3,H
1937-02-06,1936,Preston North End,Sheffield Wednesday,1-1,1,1,1,1,2,0,D
1937-02-06,1936,West Bromwich Albion,Charlton Athletic,1-2,1,2,1,1,3,-1,A
1937-02-10,1936,Sunderland,Bolton Wanderers,3-0,3,0,1,1,3,3,H
1937-02-10,1936,Wolverhampton Wanderers,Brentford,4-0,4,0,1,1,4,4,H
1937-02-13,1936,Charlton Athletic,Manchester City,1-1,1,1,1,1,2,0,D
1937-02-13,1936,Chelsea,Preston North End,0-0,0,0,1,1,0,0,D
1937-02-13,1936,Derby County,Bolton Wanderers,3-0,3,0,1,1,3,3,H
1937-02-13,1936,Grimsby Town,West Bromwich Albion,2-3,2,3,1,1,5,-1,A
1937-02-13,1936,Leeds United,Birmingham City,0-2,0,2,1,1,2,-2,A
1937-02-13,1936,Liverpool,Middlesbrough,0-2,0,2,1,1,2,-2,A
1937-02-13,1936,Manchester United,Brentford,1-3,1,3,1,1,4,-2,A
1937-02-13,1936,Sheffield Wednesday,Arsenal,0-0,0,0,1,1,0,0,D
1937-02-13,1936,Stoke City,Portsmouth,2-4,2,4,1,1,6,-2,A
1937-02-13,1936,Sunderland,Huddersfield Town,3-2,3,2,1,1,5,1,H
1937-02-13,1936,Wolverhampton Wanderers,Everton,7-2,7,2,1,1,9,5,H
1937-02-20,1936,Huddersfield Town,Birmingham City,1-1,1,1,1,1,2,0,D
1937-02-20,1936,Manchester United,Portsmouth,0-1,0,1,1,1,1,-1,A
1937-02-20,1936,Sheffield Wednesday,Chelsea,1-1,1,1,1,1,2,0,D
1937-02-24,1936,Arsenal,Charlton Athletic,1-1,1,1,1,1,2,0,D
1937-02-24,1936,Bolton Wanderers,Liverpool,0-1,0,1,1,1,1,-1,A
1937-02-24,1936,Derby County,Manchester City,0-5,0,5,1,1,5,-5,A
1937-02-24,1936,Preston North End,Stoke City,0-1,0,1,1,1,1,-1,A
1937-02-24,1936,Sunderland,Middlesbrough,4-1,4,1,1,1,5,3,H
1937-02-27,1936,Birmingham City,Everton,2-0,2,0,1,1,2,2,H
1937-02-27,1936,Charlton Athletic,Preston North End,3-1,3,1,1,1,4,2,H
1937-02-27,1936,Chelsea,Manchester United,4-2,4,2,1,1,6,2,H
1937-02-27,1936,Grimsby Town,Arsenal,1-3,1,3,1,1,4,-2,A
1937-02-27,1936,Leeds United,Bolton Wanderers,2-2,2,2,1,1,4,0,D
1937-02-27,1936,Liverpool,Brentford,2-2,2,2,1,1,4,0,D
1937-02-27,1936,Manchester City,Wolverhampton Wanderers,4-1,4,1,1,1,5,3,H
1937-02-27,1936,Middlesbrough,Huddersfield Town,5-0,5,0,1,1,5,5,H
1937-02-27,1936,Portsmouth,Derby County,1-2,1,2,1,1,3,-1,A
1937-02-27,1936,West Bromwich Albion,Sunderland,6-4,6,4,1,1,10,2,H
1937-03-03,1936,Brentford,Grimsby Town,2-3,2,3,1,1,5,-1,A
1937-03-03,1936,Everton,Leeds United,7-1,7,1,1,1,8,6,H
1937-03-06,1936,Bolton Wanderers,Birmingham City,0-0,0,0,1,1,0,0,D
1937-03-06,1936,Brentford,Leeds United,4-1,4,1,1,1,5,3,H
1937-03-06,1936,Derby County,Chelsea,1-1,1,1,1,1,2,0,D
1937-03-06,1936,Everton,Middlesbrough,2-3,2,3,1,1,5,-1,A
1937-03-06,1936,Manchester United,Stoke City,2-1,2,1,1,1,3,1,H
1937-03-06,1936,Sheffield Wednesday,Charlton Athletic,3-1,3,1,1,1,4,2,H
1937-03-10,1936,Arsenal,Liverpool,1-0,1,0,1,1,1,1,H
1937-03-10,1936,Huddersfield Town,West Bromwich Albion,1-1,1,1,1,1,2,0,D
1937-03-10,1936,Preston North End,Grimsby Town,3-2,3,2,1,1,5,1,H
1937-03-13,1936,Birmingham City,Brentford,4-0,4,0,1,1,4,4,H
1937-03-13,1936,Charlton Athletic,Manchester United,3-0,3,0,1,1,3,3,H
1937-03-13,1936,Chelsea,Wolverhampton Wanderers,0-1,0,1,1,1,1,-1,A
1937-03-13,1936,Grimsby Town,Sheffield Wednesday,5-1,5,1,1,1,6,4,H
1937-03-13,1936,Leeds United,Arsenal,3-4,3,4,1,1,7,-1,A
1937-03-13,1936,Liverpool,Preston North End,1-1,1,1,1,1,2,0,D
1937-03-13,1936,Manchester City,Huddersfield Town,3-0,3,0,1,1,3,3,H
1937-03-13,1936,Middlesbrough,Bolton Wanderers,2-0,2,0,1,1,2,2,H
1937-03-13,1936,Portsmouth,Sunderland,3-2,3,2,1,1,5,1,H
1937-03-13,1936,Stoke City,Derby County,1-2,1,2,1,1,3,-1,A
1937-03-13,1936,West Bromwich Albion,Everton,2-1,2,1,1,1,3,1,H
1937-03-17,1936,Wolverhampton Wanderers,Portsmouth,1-1,1,1,1,1,2,0,D
1937-03-20,1936,Arsenal,Birmingham City,1-1,1,1,1,1,2,0,D
1937-03-20,1936,Bolton Wanderers,West Bromwich Albion,4-1,4,1,1,1,5,3,H
1937-03-20,1936,Brentford,Middlesbrough,4-1,4,1,1,1,5,3,H
1937-03-20,1936,Derby County,Charlton Athletic,5-0,5,0,1,1,5,5,H
1937-03-20,1936,Everton,Manchester City,1-1,1,1,1,1,2,0,D
1937-03-20,1936,Huddersfield Town,Portsmouth,1-2,1,2,1,1,3,-1,A
1937-03-20,1936,Manchester United,Grimsby Town,1-1,1,1,1,1,2,0,D
1937-03-20,1936,Preston North End,Leeds United,1-0,1,0,1,1,1,1,H
1937-03-20,1936,Sheffield Wednesday,Liverpool,1-2,1,2,1,1,3,-1,A
1937-03-20,1936,Sunderland,Chelsea,2-3,2,3,1,1,5,-1,A
1937-03-20,1936,Wolverhampton Wanderers,Stoke City,2-1,2,1,1,1,3,1,H
1937-03-22,1936,West Bromwich Albion,Preston North End,0-0,0,0,1,1,0,0,D
1937-03-26,1936,Arsenal,Stoke City,0-0,0,0,1,1,0,0,D
1937-03-26,1936,Bolton Wanderers,Sheffield Wednesday,1-0,1,0,1,1,1,1,H
1937-03-26,1936,Brentford,Preston North End,1-1,1,1,1,1,2,0,D
1937-03-26,1936,Chelsea,Charlton Athletic,3-0,3,0,1,1,3,3,H
1937-03-26,1936,Grimsby Town,Portsmouth,1-0,1,0,1,1,1,1,H
1937-03-26,1936,Liverpool,Manchester City,0-5,0,5,1,1,5,-5,A
1937-03-26,1936,Manchester United,Everton,2-1,2,1,1,1,3,1,H
1937-03-26,1936,Middlesbrough,Birmingham City,3-1,3,1,1,1,4,2,H
1937-03-26,1936,Sunderland,Wolverhampton Wanderers,6-2,6,2,1,1,8,4,H
1937-03-27,1936,Birmingham City,Preston North End,1-0,1,0,1,1,1,1,H
1937-03-27,1936,Charlton Athletic,Wolverhampton Wanderers,4-0,4,0,1,1,4,4,H
1937-03-27,1936,Chelsea,Huddersfield Town,0-0,0,0,1,1,0,0,D
1937-03-27,1936,Grimsby Town,Derby County,3-4,3,4,1,1,7,-1,A
1937-03-27,1936,Leeds United,Sheffield Wednesday,1-1,1,1,1,1,2,0,D
1937-03-27,1936,Liverpool,Manchester United,2-0,2,0,1,1,2,2,H
1937-03-27,1936,Manchester City,Bolton Wanderers,2-2,2,2,1,1,4,0,D
1937-03-27,1936,Middlesbrough,Arsenal,1-1,1,1,1,1,2,0,D
1937-03-27,1936,Portsmouth,Everton,2-2,2,2,1,1,4,0,D
1937-03-27,1936,Stoke City,Sunderland,5-3,5,3,1,1,8,2,H
1937-03-27,1936,West Bromwich Albion,Brentford,1-0,1,0,1,1,1,1,H
1937-03-29,1936,Birmingham City,Middlesbrough,0-0,0,0,1,1,0,0,D
1937-03-29,1936,Charlton Athletic,Chelsea,1-0,1,0,1,1,1,1,H
1937-03-29,1936,Derby County,Huddersfield Town,3-3,3,3,1,1,6,0,D
1937-03-29,1936,Everton,Manchester United,2-3,2,3,1,1,5,-1,A
1937-03-29,1936,Manchester City,Liverpool,5-1,5,1,1,1,6,4,H
1937-03-29,1936,Portsmouth,Grimsby Town,2-1,2,1,1,1,3,1,H
1937-03-29,1936,Preston North End,Brentford,1-1,1,1,1,1,2,0,D
1937-03-29,1936,Sheffield Wednesday,Bolton Wanderers,2-0,2,0,1,1,2,2,H
1937-03-29,1936,Stoke City,Arsenal,0-0,0,0,1,1,0,0,D
1937-03-29,1936,West Bromwich Albion,Leeds United,3-0,3,0,1,1,3,3,H
1937-03-29,1936,Wolverhampton Wanderers,Sunderland,1-1,1,1,1,1,2,0,D
1937-03-30,1936,Huddersfield Town,Derby County,2-0,2,0,1,1,2,2,H
1937-03-30,1936,Leeds United,West Bromwich Albion,3-1,3,1,1,1,4,2,H
1937-04-03,1936,Arsenal,West Bromwich Albion,2-0,2,0,1,1,2,2,H
1937-04-03,1936,Bolton Wanderers,Portsmouth,1-0,1,0,1,1,1,1,H
1937-04-03,1936,Brentford,Manchester City,2-6,2,6,1,1,8,-4,A
1937-04-03,1936,Derby County,Liverpool,4-1,4,1,1,1,5,3,H
1937-04-03,1936,Everton,Chelsea,0-0,0,0,1,1,0,0,D
1937-04-03,1936,Huddersfield Town,Stoke City,2-1,2,1,1,1,3,1,H
1937-04-03,1936,Manchester United,Leeds United,0-0,0,0,1,1,0,0,D
1937-04-03,1936,Preston North End,Middlesbrough,2-0,2,0,1,1,2,2,H
1937-04-03,1936,Sheffield Wednesday,Birmingham City,0-3,0,3,1,1,3,-3,A
1937-04-03,1936,Sunderland,Charlton Athletic,1-0,1,0,1,1,1,1,H
1937-04-03,1936,Wolverhampton Wanderers,Grimsby Town,5-2,5,2,1,1,7,3,H
1937-04-05,1936,Stoke City,Sheffield Wednesday,1-0,1,0,1,1,1,1,H
1937-04-07,1936,Manchester City,Brentford,2-1,2,1,1,1,3,1,H
1937-04-10,1936,Birmingham City,Manchester United,2-2,2,2,1,1,4,0,D
1937-04-10,1936,Charlton Athletic,Huddersfield Town,1-0,1,0,1,1,1,1,H
1937-04-10,1936,Chelsea,Bolton Wanderers,0-1,0,1,1,1,1,-1,A
1937-04-10,1936,Leeds United,Derby County,2-0,2,0,1,1,2,2,H
1937-04-10,1936,Liverpool,Wolverhampton Wanderers,1-0,1,0,1,1,1,1,H
1937-04-10,1936,Manchester City,Arsenal,2-0,2,0,1,1,2,2,H
1937-04-10,1936,Middlesbrough,Sheffield Wednesday,2-0,2,0,1,1,2,2,H
1937-04-10,1936,Portsmouth,Brentford,1-3,1,3,1,1,4,-2,A
1937-04-10,1936,Stoke City,Everton,2-1,2,1,1,1,3,1,H
1937-04-12,1936,Grimsby Town,Sunderland,6-0,6,0,1,1,6,6,H
1937-04-14,1936,Preston North End,Everton,1-0,1,0,1,1,1,1,H
1937-04-14,1936,Sunderland,Manchester City,1-3,1,3,1,1,4,-2,A
1937-04-14,1936,Wolverhampton Wanderers,West Bromwich Albion,5-2,5,2,1,1,7,3,H
1937-04-17,1936,Arsenal,Portsmouth,4-0,4,0,1,1,4,4,H
1937-04-17,1936,Bolton Wanderers,Stoke City,0-0,0,0,1,1,0,0,D
1937-04-17,1936,Brentford,Chelsea,1-0,1,0,1,1,1,1,H
1937-04-17,1936,Derby County,Birmingham City,3-1,3,1,1,1,4,2,H
1937-04-17,1936,Everton,Charlton Athletic,2-2,2,2,1,1,4,0,D
1937-04-17,1936,Huddersfield Town,Grimsby Town,0-3,0,3,1,1,3,-3,A
1937-04-17,1936,Manchester United,Middlesbrough,2-1,2,1,1,1,3,1,H
1937-04-17,1936,Preston North End,Manchester City,2-5,2,5,1,1,7,-3,A
1937-04-17,1936,Sheffield Wednesday,West Bromwich Albion,2-3,2,3,1,1,5,-1,A
1937-04-17,1936,Sunderland,Liverpool,4-2,4,2,1,1,6,2,H
1937-04-17,1936,Wolverhampton Wanderers,Leeds United,3-0,3,0,1,1,3,3,H
1937-04-21,1936,Leeds United,Wolverhampton Wanderers,0-1,0,1,1,1,1,-1,A
1937-04-21,1936,Sunderland,Manchester United,1-1,1,1,1,1,2,0,D
1937-04-21,1936,West Bromwich Albion,Sheffield Wednesday,2-3,2,3,1,1,5,-1,A
1937-04-24,1936,Birmingham City,Wolverhampton Wanderers,1-0,1,0,1,1,1,1,H
1937-04-24,1936,Charlton Athletic,Bolton Wanderers,1-0,1,0,1,1,1,1,H
1937-04-24,1936,Chelsea,Arsenal,2-0,2,0,1,1,2,2,H
1937-04-24,1936,Grimsby Town,Everton,1-0,1,0,1,1,1,1,H
1937-04-24,1936,Leeds United,Sunderland,3-0,3,0,1,1,3,3,H
1937-04-24,1936,Liverpool,Huddersfield Town,1-1,1,1,1,1,2,0,D
1937-04-24,1936,Manchester City,Sheffield Wednesday,4-1,4,1,1,1,5,3,H
1937-04-24,1936,Middlesbrough,Derby County,1-3,1,3,1,1,4,-2,A
1937-04-24,1936,Portsmouth,Preston North End,0-1,0,1,1,1,1,-1,A
1937-04-24,1936,Stoke City,Brentford,5-1,5,1,1,1,6,4,H
1937-04-24,1936,West Bromwich Albion,Manchester United,1-0,1,0,1,1,1,1,H
1937-05-01,1936,Arsenal,Bolton Wanderers,0-0,0,0,1,1,0,0,D
1937-05-01,1936,Birmingham City,Manchester City,2-2,2,2,1,1,4,0,D
1937-05-01,1936,Charlton Athletic,Brentford,2-1,2,1,1,1,3,1,H
1937-05-01,1936,Grimsby Town,Stoke City,1-3,1,3,1,1,4,-2,A
1937-05-01,1936,Huddersfield Town,Sheffield Wednesday,1-0,1,0,1,1,1,1,H
1937-05-01,1936,Leeds United,Portsmouth,3-1,3,1,1,1,4,2,H
1937-05-01,1936,Liverpool,Chelsea,1-1,1,1,1,1,2,0,D
1937-05-01,1936,West Bromwich Albion,Middlesbrough,3-1,3,1,1,1,4,2,H
1937-05-01,1936,Wolverhampton Wanderers,Derby County,3-1,3,1,1,1,4,2,H
1937-08-28,1937,Bolton Wanderers,Brentford,2-0,2,0,1,1,2,2,H
1937-08-28,1937,Charlton Athletic,Leeds United,1-1,1,1,1,1,2,0,D
1937-08-28,1937,Chelsea,Liverpool,6-1,6,1,1,1,7,5,H
1937-08-28,1937,Everton,Arsenal,1-4,1,4,1,1,5,-3,A
1937-08-28,1937,Huddersfield Town,Blackpool,3-1,3,1,1,1,4,2,H
1937-08-28,1937,Leicester City,Derby County,0-0,0,0,1,1,0,0,D
1937-08-28,1937,Portsmouth,West Bromwich Albion,2-3,2,3,1,1,5,-1,A
1937-08-28,1937,Preston North End,Grimsby Town,4-1,4,1,1,1,5,3,H
1937-08-28,1937,Stoke City,Birmingham City,2-2,2,2,1,1,4,0,D
1937-08-28,1937,Sunderland,Middlesbrough,3-1,3,1,1,1,4,2,H
1937-08-28,1937,Wolverhampton Wanderers,Manchester City,3-1,3,1,1,1,4,2,H
1937-08-30,1937,Blackpool,Bolton Wanderers,2-2,2,2,1,1,4,0,D
1937-08-30,1937,Leicester City,Sunderland,4-0,4,0,1,1,4,4,H
1937-08-30,1937,West Bromwich Albion,Stoke City,0-1,0,1,1,1,1,-1,A
1937-08-31,1937,Grimsby Town,Charlton Athletic,1-1,1,1,1,1,2,0,D
1937-09-01,1937,Arsenal,Huddersfield Town,3-1,3,1,1,1,4,2,H
1937-09-01,1937,Birmingham City,Middlesbrough,3-1,3,1,1,1,4,2,H
1937-09-01,1937,Brentford,Preston North End,2-1,2,1,1,1,3,1,H
1937-09-01,1937,Derby County,Wolverhampton Wanderers,1-2,1,2,1,1,3,-1,A
1937-09-01,1937,Leeds United,Chelsea,2-0,2,0,1,1,2,2,H
1937-09-01,1937,Liverpool,Portsmouth,3-2,3,2,1,1,5,1,H
1937-09-01,1937,Manchester City,Everton,2-0,2,0,1,1,2,2,H
1937-09-04,1937,Arsenal,Wolverhampton Wanderers,5-0,5,0,1,1,5,5,H
1937-09-04,1937,Birmingham City,Portsmouth,2-2,2,2,1,1,4,0,D
1937-09-04,1937,Blackpool,Everton,1-0,1,0,1,1,1,1,H
1937-09-04,1937,Brentford,Huddersfield Town,2-0,2,0,1,1,2,2,H
1937-09-04,1937,Derby County,Sunderland,2-2,2,2,1,1,4,0,D
1937-09-04,1937,Grimsby Town,Bolton Wanderers,0-1,0,1,1,1,1,-1,A
1937-09-04,1937,Leeds United,Preston North End,0-0,0,0,1,1,0,0,D
1937-09-04,1937,Liverpool,Charlton Athletic,1-2,1,2,1,1,3,-1,A
1937-09-04,1937,Manchester City,Leicester City,3-0,3,0,1,1,3,3,H
1937-09-04,1937,Middlesbrough,Stoke City,2-1,2,1,1,1,3,1,H
1937-09-04,1937,West Bromwich Albion,Chelsea,4-0,4,0,1,1,4,4,H
1937-09-06,1937,Bolton Wanderers,Blackpool,3-0,3,0,1,1,3,3,H
1937-09-06,1937,Charlton Athletic,Grimsby Town,0-0,0,0,1,1,0,0,D
1937-09-06,1937,Preston North End,Brentford,1-1,1,1,1,1,2,0,D
1937-09-06,1937,Stoke City,West Bromwich Albion,4-0,4,0,1,1,4,4,H
1937-09-06,1937,Wolverhampton Wanderers,Derby County,2-2,2,2,1,1,4,0,D
1937-09-08,1937,Chelsea,Leeds United,4-1,4,1,1,1,5,3,H
1937-09-08,1937,Everton,Manchester City,4-1,4,1,1,1,5,3,H
1937-09-08,1937,Huddersfield Town,Arsenal,2-1,2,1,1,1,3,1,H
1937-09-08,1937,Middlesbrough,Birmingham City,1-1,1,1,1,1,2,0,D
1937-09-08,1937,Portsmouth,Liverpool,1-1,1,1,1,1,2,0,D
1937-09-08,1937,Sunderland,Leicester City,1-0,1,0,1,1,1,1,H
1937-09-11,1937,Charlton Athletic,West Bromwich Albion,3-1,3,1,1,1,4,2,H
1937-09-11,1937,Chelsea,Birmingham City,2-0,2,0,1,1,2,2,H
1937-09-11,1937,Everton,Brentford,3-0,3,0,1,1,3,3,H
1937-09-11,1937,Grimsby Town,Leeds United,1-1,1,1,1,1,2,0,D
1937-09-11,1937,Huddersfield Town,Bolton Wanderers,1-0,1,0,1,1,1,1,H
1937-09-11,1937,Leicester City,Arsenal,1-1,1,1,1,1,2,0,D
1937-09-11,1937,Portsmouth,Middlesbrough,0-2,0,2,1,1,2,-2,A
1937-09-11,1937,Preston North End,Liverpool,4-1,4,1,1,1,5,3,H
1937-09-11,1937,Stoke City,Derby County,8-1,8,1,1,1,9,7,H
1937-09-11,1937,Sunderland,Manchester City,3-1,3,1,1,1,4,2,H
1937-09-11,1937,Wolverhampton Wanderers,Blackpool,1-0,1,0,1,1,1,1,H
1937-09-13,1937,Preston North End,Charlton Athletic,0-1,0,1,1,1,1,-1,A
1937-09-13,1937,West Bromwich Albion,Middlesbrough,3-1,3,1,1,1,4,2,H
1937-09-15,1937,Birmingham City,Leicester City,4-1,4,1,1,1,5,3,H
1937-09-15,1937,Bolton Wanderers,Arsenal,1-0,1,0,1,1,1,1,H
1937-09-15,1937,Chelsea,Grimsby Town,1-0,1,0,1,1,1,1,H
1937-09-15,1937,Derby County,Everton,2-1,2,1,1,1,3,1,H
1937-09-15,1937,Leeds United,Portsmouth,3-1,3,1,1,1,4,2,H
1937-09-15,1937,Liverpool,Stoke City,3-0,3,0,1,1,3,3,H
1937-09-15,1937,Manchester City,Huddersfield Town,3-2,3,2,1,1,5,1,H
1937-09-15,1937,Wolverhampton Wanderers,Sunderland,4-0,4,0,1,1,4,4,H
1937-09-16,1937,Brentford,Blackpool,2-4,2,4,1,1,6,-2,A
1937-09-18,1937,Arsenal,Sunderland,4-1,4,1,1,1,5,3,H
1937-09-18,1937,Birmingham City,Charlton Athletic,1-1,1,1,1,1,2,0,D
1937-09-18,1937,Blackpool,Leicester City,2-4,2,4,1,1,6,-2,A
1937-09-18,1937,Bolton Wanderers,Everton,1-2,1,2,1,1,3,-1,A
1937-09-18,1937,Brentford,Wolverhampton Wanderers,2-1,2,1,1,1,3,1,H
1937-09-18,1937,Leeds United,Huddersfield Town,2-1,2,1,1,1,3,1,H
1937-09-18,1937,Liverpool,Grimsby Town,2-1,2,1,1,1,3,1,H
1937-09-18,1937,Manchester City,Derby County,6-1,6,1,1,1,7,5,H
1937-09-18,1937,Middlesbrough,Chelsea,4-3,4,3,1,1,7,1,H
1937-09-18,1937,Stoke City,Portsmouth,3-1,3,1,1,1,4,2,H
1937-09-18,1937,West Bromwich Albion,Preston North End,1-1,1,1,1,1,2,0,D
1937-09-20,1937,Blackpool,Brentford,1-1,1,1,1,1,2,0,D
1937-09-25,1937,Charlton Athletic,Middlesbrough,1-0,1,0,1,1,1,1,H
1937-09-25,1937,Chelsea,Stoke City,2-1,2,1,1,1,3,1,H
1937-09-25,1937,Derby County,Arsenal,2-0,2,0,1,1,2,2,H
1937-09-25,1937,Everton,Huddersfield Town,1-2,1,2,1,1,3,-1,A
1937-09-25,1937,Grimsby Town,West Bromwich Albion,1-4,1,4,1,1,5,-3,A
1937-09-25,1937,Leeds United,Liverpool,2-0,2,0,1,1,2,2,H
1937-09-25,1937,Leicester City,Brentford,0-1,0,1,1,1,1,-1,A
1937-09-25,1937,Portsmouth,Manchester City,2-2,2,2,1,1,4,0,D
1937-09-25,1937,Preston North End,Birmingham City,2-1,2,1,1,1,3,1,H
1937-09-25,1937,Sunderland,Blackpool,2-1,2,1,1,1,3,1,H
1937-09-25,1937,Wolverhampton Wanderers,Bolton Wanderers,1-1,1,1,1,1,2,0,D
1937-10-02,1937,Arsenal,Manchester City,2-1,2,1,1,1,3,1,H
1937-10-02,1937,Birmingham City,Grimsby Town,2-2,2,2,1,1,4,0,D
1937-10-02,1937,Blackpool,Derby County,1-1,1,1,1,1,2,0,D
1937-10-02,1937,Bolton Wanderers,Leicester City,6-1,6,1,1,1,7,5,H
1937-10-02,1937,Brentford,Sunderland,4-0,4,0,1,1,4,4,H
1937-10-02,1937,Huddersfield Town,Wolverhampton Wanderers,1-0,1,0,1,1,1,1,H
1937-10-02,1937,Liverpool,Everton,1-2,1,2,1,1,3,-1,A
1937-10-02,1937,Middlesbrough,Preston North End,2-1,2,1,1,1,3,1,H
1937-10-02,1937,Portsmouth,Chelsea,2-4,2,4,1,1,6,-2,A
1937-10-02,1937,Stoke City,Charlton Athletic,2-0,2,0,1,1,2,2,H
1937-10-02,1937,West Bromwich Albion,Leeds United,2-1,2,1,1,1,3,1,H
1937-10-09,1937,Charlton Athletic,Portsmouth,5-1,5,1,1,1,6,4,H
1937-10-09,1937,Chelsea,Arsenal,2-2,2,2,1,1,4,0,D
1937-10-09,1937,Derby County,Brentford,1-3,1,3,1,1,4,-2,A
1937-10-09,1937,Grimsby Town,Middlesbrough,2-1,2,1,1,1,3,1,H
1937-10-09,1937,Leeds United,Birmingham City,1-0,1,0,1,1,1,1,H
1937-10-09,1937,Leicester City,Huddersfield Town,2-1,2,1,1,1,3,1,H
1937-10-09,1937,Liverpool,West Bromwich Albion,0-1,0,1,1,1,1,-1,A
1937-10-09,1937,Manchester City,Blackpool,2-1,2,1,1,1,3,1,H
1937-10-09,1937,Preston North End,Stoke City,2-1,2,1,1,1,3,1,H
1937-10-09,1937,Sunderland,Bolton Wanderers,3-1,3,1,1,1,4,2,H
1937-10-09,1937,Wolverhampton Wanderers,Everton,2-0,2,0,1,1,2,2,H
1937-10-16,1937,Arsenal,Portsmouth,1-1,1,1,1,1,2,0,D
1937-10-16,1937,Blackpool,Chelsea,0-2,0,2,1,1,2,-2,A
1937-10-16,1937,Bolton Wanderers,Preston North End,1-4,1,4,1,1,5,-3,A
1937-10-16,1937,Brentford,Charlton Athletic,5-2,5,2,1,1,7,3,H
1937-10-16,1937,Derby County,Middlesbrough,1-1,1,1,1,1,2,0,D
1937-10-16,1937,Everton,Leeds United,1-1,1,1,1,1,2,0,D
1937-10-16,1937,Huddersfield Town,Grimsby Town,1-2,1,2,1,1,3,-1,A
1937-10-16,1937,Leicester City,West Bromwich Albion,4-1,4,1,1,1,5,3,H
1937-10-16,1937,Manchester City,Stoke City,0-0,0,0,1,1,0,0,D
1937-10-16,1937,Sunderland,Birmingham City,1-0,1,0,1,1,1,1,H
1937-10-16,1937,Wolverhampton Wanderers,Liverpool,2-0,2,0,1,1,2,2,H
1937-10-23,1937,Birmingham City,Derby County,1-0,1,0,1,1,1,1,H
1937-10-23,1937,Charlton Athletic,Bolton Wanderers,1-1,1,1,1,1,2,0,D
1937-10-23,1937,Chelsea,Brentford,2-1,2,1,1,1,3,1,H
1937-10-23,1937,Grimsby Town,Everton,2-1,2,1,1,1,3,1,H
1937-10-23,1937,Leeds United,Wolverhampton Wanderers,1-2,1,2,1,1,3,-1,A
1937-10-23,1937,Liverpool,Leicester City,1-1,1,1,1,1,2,0,D
1937-10-23,1937,Middlesbrough,Manchester City,4-0,4,0,1,1,4,4,H
1937-10-23,1937,Portsmouth,Blackpool,1-2,1,2,1,1,3,-1,A
1937-10-23,1937,Preston North End,Huddersfield Town,1-1,1,1,1,1,2,0,D
1937-10-23,1937,Stoke City,Arsenal,1-1,1,1,1,1,2,0,D
1937-10-23,1937,West Bromwich Albion,Sunderland,1-6,1,6,1,1,7,-5,A
1937-10-30,1937,Arsenal,Middlesbrough,1-2,1,2,1,1,3,-1,A
1937-10-30,1937,Blackpool,Stoke City,0-1,0,1,1,1,1,-1,A
1937-10-30,1937,Bolton Wanderers,Chelsea,5-5,5,5,1,1,10,0,D
1937-10-30,1937,Brentford,Portsmouth,2-0,2,0,1,1,2,2,H
1937-10-30,1937,Derby County,West Bromwich Albion,5-3,5,3,1,1,8,2,H
1937-10-30,1937,Everton,Preston North End,3-5,3,5,1,1,8,-2,A
1937-10-30,1937,Huddersfield Town,Charlton Athletic,1-1,1,1,1,1,2,0,D
1937-10-30,1937,Leicester City,Leeds United,2-4,2,4,1,1,6,-2,A
1937-10-30,1937,Manchester City,Birmingham City,2-0,2,0,1,1,2,2,H
1937-10-30,1937,Sunderland,Liverpool,2-3,2,3,1,1,5,-1,A
1937-10-30,1937,Wolverhampton Wanderers,Grimsby Town,1-1,1,1,1,1,2,0,D
1937-11-06,1937,Birmingham City,Huddersfield Town,2-2,2,2,1,1,4,0,D
1937-11-06,1937,Charlton Athletic,Derby County,1-2,1,2,1,1,3,-1,A
1937-11-06,1937,Chelsea,Sunderland,0-0,0,0,1,1,0,0,D
1937-11-06,1937,Grimsby Town,Arsenal,2-1,2,1,1,1,3,1,H
1937-11-06,1937,Leeds United,Blackpool,1-1,1,1,1,1,2,0,D
1937-11-06,1937,Liverpool,Brentford,3-4,3,4,1,1,7,-1,A
1937-11-06,1937,Middlesbrough,Everton,1-2,1,2,1,1,3,-1,A
1937-11-06,1937,Portsmouth,Leicester City,1-1,1,1,1,1,2,0,D
1937-11-06,1937,Preston North End,Manchester City,2-2,2,2,1,1,4,0,D
1937-11-06,1937,Stoke City,Wolverhampton Wanderers,1-1,1,1,1,1,2,0,D
1937-11-06,1937,West Bromwich Albion,Bolton Wanderers,2-4,2,4,1,1,6,-2,A
1937-11-13,1937,Arsenal,West Bromwich Albion,1-1,1,1,1,1,2,0,D
1937-11-13,1937,Blackpool,Birmingham City,0-3,0,3,1,1,3,-3,A
1937-11-13,1937,Bolton Wanderers,Stoke City,1-0,1,0,1,1,1,1,H
1937-11-13,1937,Brentford,Middlesbrough,3-3,3,3,1,1,6,0,D
1937-11-13,1937,Derby County,Leeds United,2-2,2,2,1,1,4,0,D
1937-11-13,1937,Everton,Chelsea,4-1,4,1,1,1,5,3,H
1937-11-13,1937,Huddersfield Town,Portsmouth,2-0,2,0,1,1,2,2,H
1937-11-13,1937,Leicester City,Preston North End,1-0,1,0,1,1,1,1,H
1937-11-13,1937,Manchester City,Liverpool,1-3,1,3,1,1,4,-2,A
1937-11-13,1937,Sunderland,Grimsby Town,2-2,2,2,1,1,4,0,D
1937-11-13,1937,Wolverhampton Wanderers,Charlton Athletic,1-1,1,1,1,1,2,0,D
1937-11-20,1937,Birmingham City,Wolverhampton Wanderers,2-0,2,0,1,1,2,2,H
1937-11-20,1937,Charlton Athletic,Arsenal,0-3,0,3,1,1,3,-3,A
1937-11-20,1937,Chelsea,Manchester City,2-2,2,2,1,1,4,0,D
1937-11-20,1937,Grimsby Town,Brentford,0-1,0,1,1,1,1,-1,A
1937-11-20,1937,Leeds United,Bolton Wanderers,1-1,1,1,1,1,2,0,D
1937-11-20,1937,Liverpool,Huddersfield Town,0-1,0,1,1,1,1,-1,A
1937-11-20,1937,Middlesbrough,Leicester City,4-2,4,2,1,1,6,2,H
1937-11-20,1937,Portsmouth,Derby County,4-0,4,0,1,1,4,4,H
1937-11-20,1937,Preston North End,Blackpool,2-0,2,0,1,1,2,2,H
1937-11-20,1937,Stoke City,Sunderland,0-0,0,0,1,1,0,0,D
1937-11-20,1937,West Bromwich Albion,Everton,3-1,3,1,1,1,4,2,H
1937-11-27,1937,Arsenal,Leeds United,4-1,4,1,1,1,5,3,H
1937-11-27,1937,Blackpool,Liverpool,0-1,0,1,1,1,1,-1,A
1937-11-27,1937,Bolton Wanderers,Birmingham City,1-1,1,1,1,1,2,0,D
1937-11-27,1937,Brentford,West Bromwich Albion,0-2,0,2,1,1,2,-2,A
1937-11-27,1937,Derby County,Preston North End,1-1,1,1,1,1,2,0,D
1937-11-27,1937,Everton,Stoke City,3-0,3,0,1,1,3,3,H
1937-11-27,1937,Huddersfield Town,Middlesbrough,3-0,3,0,1,1,3,3,H
1937-11-27,1937,Leicester City,Chelsea,1-0,1,0,1,1,1,1,H
1937-11-27,1937,Manchester City,Grimsby Town,3-1,3,1,1,1,4,2,H
1937-11-27,1937,Sunderland,Charlton Athletic,1-1,1,1,1,1,2,0,D
1937-11-27,1937,Wolverhampton Wanderers,Portsmouth,5-0,5,0,1,1,5,5,H
1937-12-04,1937,Birmingham City,Arsenal,1-2,1,2,1,1,3,-1,A
1937-12-04,1937,Charlton Athletic,Everton,3-1,3,1,1,1,4,2,H
1937-12-04,1937,Chelsea,Huddersfield Town,3-1,3,1,1,1,4,2,H
1937-12-04,1937,Grimsby Town,Leicester City,2-1,2,1,1,1,3,1,H
1937-12-04,1937,Leeds United,Sunderland,4-3,4,3,1,1,7,1,H
1937-12-04,1937,Liverpool,Derby County,3-4,3,4,1,1,7,-1,A
1937-12-04,1937,Middlesbrough,Blackpool,2-2,2,2,1,1,4,0,D
1937-12-04,1937,Portsmouth,Bolton Wanderers,1-1,1,1,1,1,2,0,D
1937-12-04,1937,Preston North End,Wolverhampton Wanderers,2-0,2,0,1,1,2,2,H
1937-12-04,1937,Stoke City,Brentford,3-0,3,0,1,1,3,3,H
1937-12-11,1937,Arsenal,Preston North End,2-0,2,0,1,1,2,2,H
1937-12-11,1937,Blackpool,Grimsby Town,2-2,2,2,1,1,4,0,D
1937-12-11,1937,Bolton Wanderers,Liverpool,0-0,0,0,1,1,0,0,D
1937-12-11,1937,Brentford,Leeds United,1-1,1,1,1,1,2,0,D
1937-12-11,1937,Derby County,Chelsea,4-0,4,0,1,1,4,4,H
1937-12-11,1937,Everton,Birmingham City,1-1,1,1,1,1,2,0,D
1937-12-11,1937,Huddersfield Town,West Bromwich Albion,2-1,2,1,1,1,3,1,H
1937-12-11,1937,Leicester City,Stoke City,2-0,2,0,1,1,2,2,H
1937-12-11,1937,Sunderland,Portsmouth,0-2,0,2,1,1,2,-2,A
1937-12-18,1937,Birmingham City,Brentford,0-0,0,0,1,1,0,0,D
1937-12-18,1937,Charlton Athletic,Leicester City,2-0,2,0,1,1,2,2,H
1937-12-18,1937,Chelsea,Wolverhampton Wanderers,0-2,0,2,1,1,2,-2,A
1937-12-18,1937,Grimsby Town,Derby County,0-0,0,0,1,1,0,0,D
1937-12-18,1937,Leeds United,Manchester City,2-1,2,1,1,1,3,1,H
1937-12-18,1937,Liverpool,Arsenal,2-0,2,0,1,1,2,2,H
1937-12-18,1937,Middlesbrough,Bolton Wanderers,1-2,1,2,1,1,3,-1,A
1937-12-18,1937,Portsmouth,Everton,3-1,3,1,1,1,4,2,H
1937-12-18,1937,Preston North End,Sunderland,0-0,0,0,1,1,0,0,D
1937-12-18,1937,Stoke City,Huddersfield Town,0-1,0,1,1,1,1,-1,A
1937-12-18,1937,West Bromwich Albion,Blackpool,1-2,1,2,1,1,3,-1,A
1937-12-25,1937,Blackpool,Arsenal,2-1,2,1,1,1,3,1,H
1937-12-25,1937,Grimsby Town,Stoke City,1-5,1,5,1,1,6,-4,A
1937-12-25,1937,Leeds United,Middlesbrough,5-3,5,3,1,1,8,2,H
1937-12-25,1937,Leicester City,Everton,3-1,3,1,1,1,4,2,H
1937-12-25,1937,Manchester City,Brentford,0-2,0,2,1,1,2,-2,A
1937-12-25,1937,Portsmouth,Preston North End,3-2,3,2,1,1,5,1,H
1937-12-25,1937,Sunderland,Huddersfield Town,2-1,2,1,1,1,3,1,H
1937-12-27,1937,Arsenal,Blackpool,2-1,2,1,1,1,3,1,H
1937-12-27,1937,Birmingham City,Liverpool,2-2,2,2,1,1,4,0,D
1937-12-27,1937,Brentford,Manchester City,2-1,2,1,1,1,3,1,H
1937-12-27,1937,Charlton Athletic,Chelsea,3-1,3,1,1,1,4,2,H
1937-12-27,1937,Derby County,Bolton Wanderers,4-2,4,2,1,1,6,2,H
1937-12-27,1937,Everton,Leicester City,3-0,3,0,1,1,3,3,H
1937-12-27,1937,Huddersfield Town,Sunderland,1-1,1,1,1,1,2,0,D
1937-12-27,1937,Middlesbrough,Leeds United,2-0,2,0,1,1,2,2,H
1937-12-27,1937,Preston North End,Portsmouth,1-1,1,1,1,1,2,0,D
1937-12-27,1937,Stoke City,Grimsby Town,1-1,1,1,1,1,2,0,D
1937-12-27,1937,West Bromwich Albion,Wolverhampton Wanderers,2-2,2,2,1,1,4,0,D
1938-01-01,1937,Arsenal,Everton,2-1,2,1,1,1,3,1,H
1938-01-01,1937,Birmingham City,Stoke City,1-1,1,1,1,1,2,0,D
1938-01-01,1937,Blackpool,Huddersfield Town,4-0,4,0,1,1,4,4,H
1938-01-01,1937,Brentford,Bolton Wanderers,1-1,1,1,1,1,2,0,D
1938-01-01,1937,Derby County,Leicester City,0-1,0,1,1,1,1,-1,A
1938-01-01,1937,Grimsby Town,Preston North End,1-1,1,1,1,1,2,0,D
1938-01-01,1937,Leeds United,Charlton Athletic,2-2,2,2,1,1,4,0,D
1938-01-01,1937,Liverpool,Chelsea,2-2,2,2,1,1,4,0,D
1938-01-01,1937,Manchester City,Wolverhampton Wanderers,2-4,2,4,1,1,6,-2,A
1938-01-01,1937,Middlesbrough,Sunderland,2-1,2,1,1,1,3,1,H
1938-01-01,1937,West Bromwich Albion,Portsmouth,1-2,1,2,1,1,3,-1,A
1938-01-15,1937,Bolton Wanderers,Grimsby Town,3-1,3,1,1,1,4,2,H
1938-01-15,1937,Charlton Athletic,Liverpool,3-0,3,0,1,1,3,3,H
1938-01-15,1937,Chelsea,West Bromwich Albion,2-2,2,2,1,1,4,0,D
1938-01-15,1937,Everton,Blackpool,3-1,3,1,1,1,4,2,H
1938-01-15,1937,Huddersfield Town,Brentford,0-3,0,3,1,1,3,-3,A
1938-01-15,1937,Leicester City,Manchester City,1-4,1,4,1,1,5,-3,A
1938-01-15,1937,Portsmouth,Birmingham City,1-1,1,1,1,1,2,0,D
1938-01-15,1937,Preston North End,Leeds United,3-1,3,1,1,1,4,2,H
1938-01-15,1937,Stoke City,Middlesbrough,3-0,3,0,1,1,3,3,H
1938-01-15,1937,Sunderland,Derby County,2-0,2,0,1,1,2,2,H
1938-01-15,1937,Wolverhampton Wanderers,Arsenal,3-1,3,1,1,1,4,2,H
1938-01-22,1937,Birmingham City,Chelsea,1-1,1,1,1,1,2,0,D
1938-01-22,1937,Bolton Wanderers,Derby County,0-2,0,2,1,1,2,-2,A
1938-01-26,1937,Blackpool,Wolverhampton Wanderers,0-2,0,2,1,1,2,-2,A
1938-01-26,1937,Bolton Wanderers,Huddersfield Town,2-0,2,0,1,1,2,2,H
1938-01-26,1937,Brentford,Everton,3-0,3,0,1,1,3,3,H
1938-01-26,1937,Leeds United,Grimsby Town,1-1,1,1,1,1,2,0,D
1938-01-26,1937,Middlesbrough,Portsmouth,0-0,0,0,1,1,0,0,D
1938-01-26,1937,West Bromwich Albion,Charlton Athletic,0-0,0,0,1,1,0,0,D
1938-01-29,1937,Charlton Athletic,Birmingham City,2-0,2,0,1,1,2,2,H
1938-01-29,1937,Chelsea,Middlesbrough,0-1,0,1,1,1,1,-1,A
1938-01-29,1937,Derby County,Manchester City,1-7,1,7,1,1,8,-6,A
1938-01-29,1937,Everton,Bolton Wanderers,4-1,4,1,1,1,5,3,H
1938-01-29,1937,Grimsby Town,Liverpool,0-0,0,0,1,1,0,0,D
1938-01-29,1937,Huddersfield Town,Leeds United,0-3,0,3,1,1,3,-3,A
1938-01-29,1937,Leicester City,Blackpool,0-1,0,1,1,1,1,-1,A
1938-01-29,1937,Portsmouth,Stoke City,2-0,2,0,1,1,2,2,H
1938-01-29,1937,Preston North End,West Bromwich Albion,1-1,1,1,1,1,2,0,D
1938-01-29,1937,Sunderland,Arsenal,1-1,1,1,1,1,2,0,D
1938-01-29,1937,Wolverhampton Wanderers,Brentford,2-1,2,1,1,1,3,1,H
1938-02-02,1937,Arsenal,Leicester City,3-1,3,1,1,1,4,2,H
1938-02-02,1937,Derby County,Stoke City,4-1,4,1,1,1,5,3,H
1938-02-02,1937,Liverpool,Preston North End,2-2,2,2,1,1,4,0,D
1938-02-02,1937,Manchester City,Sunderland,0-0,0,0,1,1,0,0,D
1938-02-05,1937,Arsenal,Derby County,3-0,3,0,1,1,3,3,H
1938-02-05,1937,Birmingham City,Preston North End,0-2,0,2,1,1,2,-2,A
1938-02-05,1937,Blackpool,Sunderland,0-0,0,0,1,1,0,0,D
1938-02-05,1937,Bolton Wanderers,Wolverhampton Wanderers,1-2,1,2,1,1,3,-1,A
1938-02-05,1937,Brentford,Leicester City,1-1,1,1,1,1,2,0,D
1938-02-05,1937,Huddersfield Town,Everton,1-3,1,3,1,1,4,-2,A
1938-02-05,1937,Liverpool,Leeds United,1-1,1,1,1,1,2,0,D
1938-02-05,1937,Manchester City,Portsmouth,2-1,2,1,1,1,3,1,H
1938-02-05,1937,Middlesbrough,Charlton Athletic,3-1,3,1,1,1,4,2,H
1938-02-05,1937,Stoke City,Chelsea,2-1,2,1,1,1,3,1,H
1938-02-05,1937,West Bromwich Albion,Grimsby Town,2-1,2,1,1,1,3,1,H
1938-02-12,1937,Chelsea,Portsmouth,3-1,3,1,1,1,4,2,H
1938-02-12,1937,Derby County,Blackpool,3-1,3,1,1,1,4,2,H
1938-02-12,1937,Grimsby Town,Birmingham City,4-0,4,0,1,1,4,4,H
1938-02-12,1937,Leeds United,West Bromwich Albion,1-0,1,0,1,1,1,1,H
1938-02-12,1937,Leicester City,Bolton Wanderers,1-1,1,1,1,1,2,0,D
1938-02-16,1937,Everton,Liverpool,1-3,1,3,1,1,4,-2,A
1938-02-16,1937,Manchester City,Arsenal,1-2,1,2,1,1,3,-1,A
1938-02-16,1937,Preston North End,Middlesbrough,0-2,0,2,1,1,2,-2,A
1938-02-16,1937,Sunderland,Brentford,1-0,1,0,1,1,1,1,H
1938-02-16,1937,Wolverhampton Wanderers,Huddersfield Town,1-4,1,4,1,1,5,-3,A
1938-02-19,1937,Arsenal,Chelsea,2-0,2,0,1,1,2,2,H
1938-02-19,1937,Birmingham City,Leeds United,3-2,3,2,1,1,5,1,H
1938-02-19,1937,Blackpool,Manchester City,2-1,2,1,1,1,3,1,H
1938-02-19,1937,Bolton Wanderers,Sunderland,1-1,1,1,1,1,2,0,D
1938-02-19,1937,Brentford,Derby County,2-3,2,3,1,1,5,-1,A
1938-02-19,1937,Everton,Wolverhampton Wanderers,0-1,0,1,1,1,1,-1,A
1938-02-19,1937,Huddersfield Town,Leicester City,0-0,0,0,1,1,0,0,D
1938-02-19,1937,Middlesbrough,Grimsby Town,1-0,1,0,1,1,1,1,H
1938-02-19,1937,Portsmouth,Charlton Athletic,2-1,2,1,1,1,3,1,H
1938-02-19,1937,Stoke City,Preston North End,1-1,1,1,1,1,2,0,D
1938-02-19,1937,West Bromwich Albion,Liverpool,5-1,5,1,1,1,6,4,H
1938-02-26,1937,Birmingham City,Sunderland,2-2,2,2,1,1,4,0,D
1938-02-26,1937,Charlton Athletic,Brentford,1-0,1,0,1,1,1,1,H
1938-02-26,1937,Chelsea,Blackpool,1-3,1,3,1,1,4,-2,A
1938-02-26,1937,Grimsby Town,Huddersfield Town,4-2,4,2,1,1,6,2,H
1938-02-26,1937,Leeds United,Everton,4-4,4,4,1,1,8,0,D
1938-02-26,1937,Liverpool,Wolverhampton Wanderers,0-1,0,1,1,1,1,-1,A
1938-02-26,1937,Middlesbrough,Derby County,4-2,4,2,1,1,6,2,H
1938-02-26,1937,Portsmouth,Arsenal,0-0,0,0,1,1,0,0,D
1938-02-26,1937,Preston North End,Bolton Wanderers,2-2,2,2,1,1,4,0,D
1938-02-26,1937,Stoke City,Manchester City,3-2,3,2,1,1,5,1,H
1938-02-26,1937,West Bromwich Albion,Leicester City,1-3,1,3,1,1,4,-2,A
1938-03-02,1937,Charlton Athletic,Stoke City,3-0,3,0,1,1,3,3,H
1938-03-05,1937,Arsenal,Stoke City,4-0,4,0,1,1,4,4,H
1938-03-05,1937,Blackpool,Portsmouth,2-0,2,0,1,1,2,2,H
1938-03-05,1937,Bolton Wanderers,Charlton Athletic,1-0,1,0,1,1,1,1,H
1938-03-05,1937,Derby County,Birmingham City,0-0,0,0,1,1,0,0,D
1938-03-05,1937,Everton,Grimsby Town,3-2,3,2,1,1,5,1,H
1938-03-05,1937,Leicester City,Liverpool,2-2,2,2,1,1,4,0,D
1938-03-05,1937,Wolverhampton Wanderers,Leeds United,1-1,1,1,1,1,2,0,D
1938-03-09,1937,Brentford,Chelsea,1-1,1,1,1,1,2,0,D
1938-03-09,1937,Manchester City,Middlesbrough,1-6,1,6,1,1,7,-5,A
1938-03-09,1937,Preston North End,Leicester City,0-0,0,0,1,1,0,0,D
1938-03-09,1937,Sunderland,West Bromwich Albion,3-0,3,0,1,1,3,3,H
1938-03-12,1937,Birmingham City,Manchester City,2-2,2,2,1,1,4,0,D
1938-03-12,1937,Charlton Athletic,Huddersfield Town,4-0,4,0,1,1,4,4,H
1938-03-12,1937,Chelsea,Bolton Wanderers,0-0,0,0,1,1,0,0,D
1938-03-12,1937,Grimsby Town,Wolverhampton Wanderers,1-0,1,0,1,1,1,1,H
1938-03-12,1937,Leeds United,Leicester City,0-2,0,2,1,1,2,-2,A
1938-03-12,1937,Liverpool,Sunderland,4-0,4,0,1,1,4,4,H
1938-03-12,1937,Middlesbrough,Arsenal,2-1,2,1,1,1,3,1,H
1938-03-12,1937,Portsmouth,Brentford,4-1,4,1,1,1,5,3,H
1938-03-12,1937,Preston North End,Everton,2-1,2,1,1,1,3,1,H
1938-03-12,1937,Stoke City,Blackpool,1-3,1,3,1,1,4,-2,A
1938-03-12,1937,West Bromwich Albion,Derby County,4-2,4,2,1,1,6,2,H
1938-03-16,1937,Huddersfield Town,Preston North End,1-3,1,3,1,1,4,-2,A
1938-03-16,1937,West Bromwich Albion,Manchester City,1-1,1,1,1,1,2,0,D
1938-03-19,1937,Arsenal,Grimsby Town,5-1,5,1,1,1,6,4,H
1938-03-19,1937,Blackpool,Leeds United,5-2,5,2,1,1,7,3,H
1938-03-19,1937,Bolton Wanderers,West Bromwich Albion,3-0,3,0,1,1,3,3,H
1938-03-19,1937,Brentford,Liverpool,1-3,1,3,1,1,4,-2,A
1938-03-19,1937,Derby County,Charlton Athletic,3-2,3,2,1,1,5,1,H
1938-03-19,1937,Everton,Middlesbrough,2-2,2,2,1,1,4,0,D
1938-03-19,1937,Huddersfield Town,Birmingham City,2-1,2,1,1,1,3,1,H
1938-03-19,1937,Leicester City,Portsmouth,3-3,3,3,1,1,6,0,D
1938-03-19,1937,Manchester City,Preston North End,1-2,1,2,1,1,3,-1,A
1938-03-19,1937,Sunderland,Chelsea,1-1,1,1,1,1,2,0,D
1938-03-19,1937,Wolverhampton Wanderers,Stoke City,2-2,2,2,1,1,4,0,D
1938-03-23,1937,Wolverhampton Wanderers,Middlesbrough,0-1,0,1,1,1,1,-1,A
1938-03-26,1937,Birmingham City,Blackpool,1-1,1,1,1,1,2,0,D
1938-03-26,1937,Charlton Athletic,Wolverhampton Wanderers,4-1,4,1,1,1,5,3,H
1938-03-26,1937,Chelsea,Everton,2-0,2,0,1,1,2,2,H
1938-03-26,1937,Leeds United,Derby County,0-2,0,2,1,1,2,-2,A
1938-03-26,1937,Liverpool,Manchester City,2-0,2,0,1,1,2,2,H
1938-03-26,1937,Middlesbrough,Brentford,0-1,0,1,1,1,1,-1,A
1938-03-26,1937,Stoke City,Bolton Wanderers,3-2,3,2,1,1,5,1,H
1938-03-26,1937,West Bromwich Albion,Arsenal,0-0,0,0,1,1,0,0,D
1938-03-29,1937,Grimsby Town,Sunderland,0-2,0,2,1,1,2,-2,A
1938-03-30,1937,Portsmouth,Huddersfield Town,3-0,3,0,1,1,3,3,H
1938-04-02,1937,Arsenal,Charlton Athletic,2-2,2,2,1,1,4,0,D
1938-04-02,1937,Blackpool,Preston North End,1-0,1,0,1,1,1,1,H
1938-04-02,1937,Bolton Wanderers,Leeds United,0-0,0,0,1,1,0,0,D
1938-04-02,1937,Brentford,Grimsby Town,6-1,6,1,1,1,7,5,H
1938-04-02,1937,Derby County,Portsmouth,1-0,1,0,1,1,1,1,H
1938-04-02,1937,Everton,West Bromwich Albion,5-3,5,3,1,1,8,2,H
1938-04-02,1937,Huddersfield Town,Liverpool,1-2,1,2,1,1,3,-1,A
1938-04-02,1937,Leicester City,Middlesbrough,0-1,0,1,1,1,1,-1,A
1938-04-02,1937,Manchester City,Chelsea,1-0,1,0,1,1,1,1,H
1938-04-02,1937,Sunderland,Stoke City,1-1,1,1,1,1,2,0,D
1938-04-02,1937,Wolverhampton Wanderers,Birmingham City,3-2,3,2,1,1,5,1,H
1938-04-06,1937,Liverpool,Birmingham City,3-2,3,2,1,1,5,1,H
1938-04-06,1937,Manchester City,Charlton Athletic,5-3,5,3,1,1,8,2,H
1938-04-09,1937,Birmingham City,Bolton Wanderers,2-0,2,0,1,1,2,2,H
1938-04-09,1937,Charlton Athletic,Sunderland,2-1,2,1,1,1,3,1,H
1938-04-09,1937,Chelsea,Leicester City,4-1,4,1,1,1,5,3,H
1938-04-09,1937,Grimsby Town,Manchester City,3-1,3,1,1,1,4,2,H
1938-04-09,1937,Leeds United,Arsenal,0-1,0,1,1,1,1,-1,A
1938-04-09,1937,Liverpool,Blackpool,4-2,4,2,1,1,6,2,H
1938-04-09,1937,Middlesbrough,Huddersfield Town,0-1,0,1,1,1,1,-1,A
1938-04-09,1937,Portsmouth,Wolverhampton Wanderers,1-0,1,0,1,1,1,1,H
1938-04-09,1937,Preston North End,Derby County,4-1,4,1,1,1,5,3,H
1938-04-09,1937,Stoke City,Everton,1-1,1,1,1,1,2,0,D
1938-04-09,1937,West Bromwich Albion,Brentford,4-3,4,3,1,1,7,1,H
1938-04-15,1937,Arsenal,Brentford,0-2,0,2,1,1,2,-2,A
1938-04-15,1937,Birmingham City,West Bromwich Albion,2-1,2,1,1,1,3,1,H
1938-04-15,1937,Blackpool,Charlton Athletic,1-0,1,0,1,1,1,1,H
1938-04-15,1937,Chelsea,Preston North End,0-2,0,2,1,1,2,-2,A
1938-04-15,1937,Everton,Sunderland,3-3,3,3,1,1,6,0,D
1938-04-15,1937,Grimsby Town,Portsmouth,1-0,1,0,1,1,1,1,H
1938-04-15,1937,Manchester City,Bolton Wanderers,1-2,1,2,1,1,3,-1,A
1938-04-15,1937,Middlesbrough,Liverpool,1-1,1,1,1,1,2,0,D
1938-04-15,1937,Wolverhampton Wanderers,Leicester City,10-1,10,1,1,1,11,9,H
1938-04-16,1937,Arsenal,Birmingham City,0-0,0,0,1,1,0,0,D
1938-04-16,1937,Blackpool,Middlesbrough,4-2,4,2,1,1,6,2,H
1938-04-16,1937,Bolton Wanderers,Portsmouth,1-1,1,1,1,1,2,0,D
1938-04-16,1937,Brentford,Stoke City,0-0,0,0,1,1,0,0,D
1938-04-16,1937,Derby County,Liverpool,4-1,4,1,1,1,5,3,H
1938-04-16,1937,Everton,Charlton Athletic,3-0,3,0,1,1,3,3,H
1938-04-16,1937,Huddersfield Town,Chelsea,1-2,1,2,1,1,3,-1,A
1938-04-16,1937,Leicester City,Grimsby Town,1-0,1,0,1,1,1,1,H
1938-04-16,1937,Manchester City,West Bromwich Albion,7-1,7,1,1,1,8,6,H
1938-04-16,1937,Sunderland,Leeds United,0-0,0,0,1,1,0,0,D
1938-04-16,1937,Wolverhampton Wanderers,Preston North End,0-0,0,0,1,1,0,0,D
1938-04-18,1937,Bolton Wanderers,Manchester City,2-1,2,1,1,1,3,1,H
1938-04-18,1937,Brentford,Arsenal,3-0,3,0,1,1,3,3,H
1938-04-18,1937,Charlton Athletic,Blackpool,4-1,4,1,1,1,5,3,H
1938-04-18,1937,Derby County,Huddersfield Town,0-4,0,4,1,1,4,-4,A
1938-04-18,1937,Leicester City,Wolverhampton Wanderers,1-1,1,1,1,1,2,0,D
1938-04-18,1937,Liverpool,Middlesbrough,1-1,1,1,1,1,2,0,D
1938-04-18,1937,Portsmouth,Grimsby Town,3-0,3,0,1,1,3,3,H
1938-04-18,1937,Preston North End,Chelsea,0-0,0,0,1,1,0,0,D
1938-04-18,1937,Stoke City,Leeds United,0-1,0,1,1,1,1,-1,A
1938-04-18,1937,Sunderland,Everton,2-0,2,0,1,1,2,2,H
1938-04-18,1937,West Bromwich Albion,Birmingham City,4-3,4,3,1,1,7,1,H
1938-04-19,1937,Huddersfield Town,Derby County,2-0,2,0,1,1,2,2,H
1938-04-19,1937,Leeds United,Stoke City,2-1,2,1,1,1,3,1,H
1938-04-23,1937,Birmingham City,Everton,0-3,0,3,1,1,3,-3,A
1938-04-23,1937,Charlton Athletic,Manchester City,0-0,0,0,1,1,0,0,D
1938-04-23,1937,Chelsea,Derby County,3-0,3,0,1,1,3,3,H
1938-04-23,1937,Grimsby Town,Blackpool,1-0,1,0,1,1,1,1,H
1938-04-23,1937,Leeds United,Brentford,4-0,4,0,1,1,4,4,H
1938-04-23,1937,Liverpool,Bolton Wanderers,2-1,2,1,1,1,3,1,H
1938-04-23,1937,Middlesbrough,Wolverhampton Wanderers,0-3,0,3,1,1,3,-3,A
1938-04-23,1937,Portsmouth,Sunderland,1-0,1,0,1,1,1,1,H
1938-04-23,1937,Preston North End,Arsenal,1-3,1,3,1,1,4,-2,A
1938-04-23,1937,Stoke City,Leicester City,1-2,1,2,1,1,3,-1,A
1938-04-23,1937,West Bromwich Albion,Huddersfield Town,5-1,5,1,1,1,6,4,H
1938-04-27,1937,Chelsea,Charlton Athletic,1-1,1,1,1,1,2,0,D
1938-04-30,1937,Arsenal,Liverpool,1-0,1,0,1,1,1,1,H
1938-04-30,1937,Blackpool,West Bromwich Albion,3-1,3,1,1,1,4,2,H
1938-04-30,1937,Bolton Wanderers,Middlesbrough,3-1,3,1,1,1,4,2,H
1938-04-30,1937,Brentford,Birmingham City,1-2,1,2,1,1,3,-1,A
1938-04-30,1937,Derby County,Grimsby Town,1-2,1,2,1,1,3,-1,A
1938-04-30,1937,Everton,Portsmouth,5-2,5,2,1,1,7,3,H
1938-04-30,1937,Leicester City,Charlton Athletic,1-0,1,0,1,1,1,1,H
1938-04-30,1937,Manchester City,Leeds United,6-2,6,2,1,1,8,4,H
1938-04-30,1937,Wolverhampton Wanderers,Chelsea,1-1,1,1,1,1,2,0,D
1938-05-02,1937,Huddersfield Town,Stoke City,3-0,3,0,1,1,3,3,H
1938-05-02,1937,Wolverhampton Wanderers,West Bromwich Albion,2-1,2,1,1,1,3,1,H
1938-05-04,1937,Sunderland,Preston North End,0-2,0,2,1,1,2,-2,A
1938-05-07,1937,Arsenal,Bolton Wanderers,5-0,5,0,1,1,5,5,H
1938-05-07,1937,Charlton Athletic,Preston North End,0-0,0,0,1,1,0,0,D
1938-05-07,1937,Everton,Derby County,1-1,1,1,1,1,2,0,D
1938-05-07,1937,Grimsby Town,Chelsea,2-0,2,0,1,1,2,2,H
1938-05-07,1937,Huddersfield Town,Manchester City,1-0,1,0,1,1,1,1,H
1938-05-07,1937,Leicester City,Birmingham City,1-4,1,4,1,1,5,-3,A
1938-05-07,1937,Middlesbrough,West Bromwich Albion,4-1,4,1,1,1,5,3,H
1938-05-07,1937,Portsmouth,Leeds United,4-0,4,0,1,1,4,4,H
1938-05-07,1937,Stoke City,Liverpool,2-0,2,0,1,1,2,2,H
1938-05-07,1937,Sunderland,Wolverhampton Wanderers,1-0,1,0,1,1,1,1,H
1938-08-27,1938,Arsenal,Portsmouth,2-0,2,0,1,1,2,2,H
1938-08-27,1938,Birmingham City,Sunderland,1-2,1,2,1,1,3,-1,A
1938-08-27,1938,Blackpool,Everton,0-2,0,2,1,1,2,-2,A
1938-08-27,1938,Bolton Wanderers,Charlton Athletic,2-1,2,1,1,1,3,1,H
1938-08-27,1938,Brentford,Huddersfield Town,2-1,2,1,1,1,3,1,H
1938-08-27,1938,Derby County,Wolverhampton Wanderers,2-2,2,2,1,1,4,0,D
1938-08-27,1938,Grimsby Town,Aston Villa,1-2,1,2,1,1,3,-1,A
1938-08-27,1938,Leeds United,Preston North End,2-1,2,1,1,1,3,1,H
1938-08-27,1938,Leicester City,Stoke City,2-2,2,2,1,1,4,0,D
1938-08-27,1938,Liverpool,Chelsea,2-1,2,1,1,1,3,1,H
1938-08-27,1938,Middlesbrough,Manchester United,3-1,3,1,1,1,4,2,H
1938-08-29,1938,Charlton Athletic,Stoke City,4-2,4,2,1,1,6,2,H
1938-08-29,1938,Wolverhampton Wanderers,Leicester City,0-0,0,0,1,1,0,0,D
1938-08-31,1938,Chelsea,Preston North End,3-1,3,1,1,1,4,2,H
1938-08-31,1938,Derby County,Huddersfield Town,1-0,1,0,1,1,1,1,H
1938-08-31,1938,Everton,Grimsby Town,3-0,3,0,1,1,3,3,H
1938-08-31,1938,Leeds United,Birmingham City,2-0,2,0,1,1,2,2,H
1938-08-31,1938,Manchester United,Bolton Wanderers,2-2,2,2,1,1,4,0,D
1938-08-31,1938,Middlesbrough,Aston Villa,1-1,1,1,1,1,2,0,D
1938-08-31,1938,Portsmouth,Blackpool,1-0,1,0,1,1,1,1,H
1938-09-03,1938,Aston Villa,Derby County,0-1,0,1,1,1,1,-1,A
1938-09-03,1938,Charlton Athletic,Leeds United,2-0,2,0,1,1,2,2,H
1938-09-03,1938,Chelsea,Leicester City,3-0,3,0,1,1,3,3,H
1938-09-03,1938,Everton,Brentford,2-1,2,1,1,1,3,1,H
1938-09-03,1938,Huddersfield Town,Arsenal,1-1,1,1,1,1,2,0,D
1938-09-03,1938,Manchester United,Birmingham City,4-1,4,1,1,1,5,3,H
1938-09-03,1938,Portsmouth,Bolton Wanderers,2-1,2,1,1,1,3,1,H
1938-09-03,1938,Preston North End,Liverpool,1-0,1,0,1,1,1,1,H
1938-09-03,1938,Stoke City,Middlesbrough,1-3,1,3,1,1,4,-2,A
1938-09-03,1938,Sunderland,Grimsby Town,1-1,1,1,1,1,2,0,D
1938-09-03,1938,Wolverhampton Wanderers,Blackpool,1-1,1,1,1,1,2,0,D
1938-09-05,1938,Aston Villa,Everton,0-3,0,3,1,1,3,-3,A
1938-09-05,1938,Bolton Wanderers,Chelsea,0-2,0,2,1,1,2,-2,A
1938-09-05,1938,Preston North End,Charlton Athletic,2-0,2,0,1,1,2,2,H
1938-09-05,1938,Stoke City,Leeds United,1-1,1,1,1,1,2,0,D
1938-09-06,1938,Grimsby Town,Portsmouth,2-1,2,1,1,1,3,1,H
1938-09-07,1938,Birmingham City,Leicester City,2-1,2,1,1,1,3,1,H
1938-09-07,1938,Huddersfield Town,Derby County,3-0,3,0,1,1,3,3,H
1938-09-07,1938,Liverpool,Manchester United,1-0,1,0,1,1,1,1,H
1938-09-07,1938,Sunderland,Wolverhampton Wanderers,1-1,1,1,1,1,2,0,D
1938-09-08,1938,Brentford,Arsenal,1-0,1,0,1,1,1,1,H
1938-09-10,1938,Arsenal,Everton,1-2,1,2,1,1,3,-1,A
1938-09-10,1938,Birmingham City,Stoke City,1-2,1,2,1,1,3,-1,A
1938-09-10,1938,Blackpool,Aston Villa,2-4,2,4,1,1,6,-2,A
1938-09-10,1938,Brentford,Wolverhampton Wanderers,0-1,0,1,1,1,1,-1,A
1938-09-10,1938,Derby County,Sunderland,1-0,1,0,1,1,1,1,H
1938-09-10,1938,Grimsby Town,Manchester United,1-0,1,0,1,1,1,1,H
1938-09-10,1938,Leeds United,Bolton Wanderers,1-2,1,2,1,1,3,-1,A
1938-09-10,1938,Leicester City,Preston North End,2-1,2,1,1,1,3,1,H
1938-09-10,1938,Liverpool,Charlton Athletic,1-0,1,0,1,1,1,1,H
1938-09-10,1938,Middlesbrough,Chelsea,1-1,1,1,1,1,2,0,D
1938-09-10,1938,Portsmouth,Huddersfield Town,4-0,4,0,1,1,4,4,H
1938-09-12,1938,Leicester City,Birmingham City,2-1,2,1,1,1,3,1,H
1938-09-14,1938,Arsenal,Derby County,1-2,1,2,1,1,3,-1,A
1938-09-14,1938,Huddersfield Town,Sunderland,0-1,0,1,1,1,1,-1,A
1938-09-14,1938,Liverpool,Middlesbrough,3-1,3,1,1,1,4,2,H
1938-09-17,1938,Aston Villa,Brentford,5-0,5,0,1,1,5,5,H
1938-09-17,1938,Bolton Wanderers,Liverpool,3-1,3,1,1,1,4,2,H
1938-09-17,1938,Charlton Athletic,Leicester City,1-0,1,0,1,1,1,1,H
1938-09-17,1938,Chelsea,Birmingham City,2-2,2,2,1,1,4,0,D
1938-09-17,1938,Everton,Portsmouth,5-1,5,1,1,1,6,4,H
1938-09-17,1938,Grimsby Town,Derby County,1-1,1,1,1,1,2,0,D
1938-09-17,1938,Huddersfield Town,Leeds United,0-1,0,1,1,1,1,-1,A
1938-09-17,1938,Preston North End,Middlesbrough,3-1,3,1,1,1,4,2,H
1938-09-17,1938,Stoke City,Manchester United,1-1,1,1,1,1,2,0,D
1938-09-17,1938,Sunderland,Blackpool,1-2,1,2,1,1,3,-1,A
1938-09-17,1938,Wolverhampton Wanderers,Arsenal,0-1,0,1,1,1,1,-1,A
1938-09-19,1938,Blackpool,Brentford,4-1,4,1,1,1,5,3,H
1938-09-24,1938,Arsenal,Aston Villa,0-0,0,0,1,1,0,0,D
1938-09-24,1938,Birmingham City,Preston North End,1-3,1,3,1,1,4,-2,A
1938-09-24,1938,Blackpool,Grimsby Town,3-1,3,1,1,1,4,2,H
1938-09-24,1938,Brentford,Sunderland,2-3,2,3,1,1,5,-1,A
1938-09-24,1938,Derby County,Stoke City,5-0,5,0,1,1,5,5,H
1938-09-24,1938,Huddersfield Town,Everton,3-0,3,0,1,1,3,3,H
1938-09-24,1938,Leicester City,Bolton Wanderers,0-0,0,0,1,1,0,0,D
1938-09-24,1938,Liverpool,Leeds United,3-0,3,0,1,1,3,3,H
1938-09-24,1938,Manchester United,Chelsea,5-1,5,1,1,1,6,4,H
1938-09-24,1938,Middlesbrough,Charlton Athletic,4-0,4,0,1,1,4,4,H
1938-09-24,1938,Portsmouth,Wolverhampton Wanderers,1-0,1,0,1,1,1,1,H
1938-10-01,1938,Aston Villa,Portsmouth,2-0,2,0,1,1,2,2,H
1938-10-01,1938,Bolton Wanderers,Middlesbrough,4-1,4,1,1,1,5,3,H
1938-10-01,1938,Charlton Athletic,Birmingham City,4-4,4,4,1,1,8,0,D
1938-10-01,1938,Chelsea,Stoke City,1-1,1,1,1,1,2,0,D
1938-10-01,1938,Derby County,Blackpool,2-1,2,1,1,1,3,1,H
1938-10-01,1938,Everton,Liverpool,2-1,2,1,1,1,3,1,H
1938-10-01,1938,Grimsby Town,Brentford,0-0,0,0,1,1,0,0,D
1938-10-01,1938,Leeds United,Leicester City,8-2,8,2,1,1,10,6,H
1938-10-01,1938,Preston North End,Manchester United,1-1,1,1,1,1,2,0,D
1938-10-01,1938,Sunderland,Arsenal,0-0,0,0,1,1,0,0,D
1938-10-01,1938,Wolverhampton Wanderers,Huddersfield Town,3-0,3,0,1,1,3,3,H
1938-10-08,1938,Arsenal,Grimsby Town,2-0,2,0,1,1,2,2,H
1938-10-08,1938,Birmingham City,Bolton Wanderers,0-2,0,2,1,1,2,-2,A
1938-10-08,1938,Blackpool,Chelsea,5-1,5,1,1,1,6,4,H
1938-10-08,1938,Brentford,Derby County,1-3,1,3,1,1,4,-2,A
1938-10-08,1938,Everton,Wolverhampton Wanderers,1-0,1,0,1,1,1,1,H
1938-10-08,1938,Huddersfield Town,Aston Villa,1-1,1,1,1,1,2,0,D
1938-10-08,1938,Leicester City,Liverpool,2-2,2,2,1,1,4,0,D
1938-10-08,1938,Manchester United,Charlton Athletic,0-2,0,2,1,1,2,-2,A
1938-10-08,1938,Middlesbrough,Leeds United,1-2,1,2,1,1,3,-1,A
1938-10-08,1938,Portsmouth,Sunderland,2-1,2,1,1,1,3,1,H
1938-10-08,1938,Stoke City,Preston North End,3-1,3,1,1,1,4,2,H
1938-10-15,1938,Birmingham City,Derby County,3-0,3,0,1,1,3,3,H
1938-10-15,1938,Bolton Wanderers,Everton,4-2,4,2,1,1,6,2,H
1938-10-15,1938,Charlton Athletic,Huddersfield Town,2-1,2,1,1,1,3,1,H
1938-10-15,1938,Chelsea,Arsenal,4-2,4,2,1,1,6,2,H
1938-10-15,1938,Leeds United,Wolverhampton Wanderers,1-0,1,0,1,1,1,1,H
1938-10-15,1938,Leicester City,Sunderland,0-2,0,2,1,1,2,-2,A
1938-10-15,1938,Liverpool,Aston Villa,3-0,3,0,1,1,3,3,H
1938-10-15,1938,Manchester United,Blackpool,0-0,0,0,1,1,0,0,D
1938-10-15,1938,Middlesbrough,Grimsby Town,3-2,3,2,1,1,5,1,H
1938-10-15,1938,Preston North End,Portsmouth,2-2,2,2,1,1,4,0,D
1938-10-15,1938,Stoke City,Brentford,3-2,3,2,1,1,5,1,H
1938-10-22,1938,Arsenal,Preston North End,1-0,1,0,1,1,1,1,H
1938-10-22,1938,Aston Villa,Leicester City,1-2,1,2,1,1,3,-1,A
1938-10-22,1938,Blackpool,Stoke City,1-1,1,1,1,1,2,0,D
1938-10-22,1938,Brentford,Chelsea,1-0,1,0,1,1,1,1,H
1938-10-22,1938,Derby County,Manchester United,5-1,5,1,1,1,6,4,H
1938-10-22,1938,Everton,Leeds United,4-0,4,0,1,1,4,4,H
1938-10-22,1938,Grimsby Town,Birmingham City,1-0,1,0,1,1,1,1,H
1938-10-22,1938,Huddersfield Town,Bolton Wanderers,2-1,2,1,1,1,3,1,H
1938-10-22,1938,Portsmouth,Charlton Athletic,0-2,0,2,1,1,2,-2,A
1938-10-22,1938,Sunderland,Middlesbrough,1-2,1,2,1,1,3,-1,A
1938-10-22,1938,Wolverhampton Wanderers,Liverpool,2-2,2,2,1,1,4,0,D
1938-10-29,1938,Birmingham City,Aston Villa,3-0,3,0,1,1,3,3,H
1938-10-29,1938,Bolton Wanderers,Arsenal,1-1,1,1,1,1,2,0,D
1938-10-29,1938,Charlton Athletic,Brentford,1-1,1,1,1,1,2,0,D
1938-10-29,1938,Chelsea,Derby County,0-2,0,2,1,1,2,-2,A
1938-10-29,1938,Leeds United,Portsmouth,2-2,2,2,1,1,4,0,D
1938-10-29,1938,Leicester City,Everton,3-0,3,0,1,1,3,3,H
1938-10-29,1938,Liverpool,Huddersfield Town,3-3,3,3,1,1,6,0,D
1938-10-29,1938,Manchester United,Sunderland,0-1,0,1,1,1,1,-1,A
1938-10-29,1938,Middlesbrough,Wolverhampton Wanderers,1-0,1,0,1,1,1,1,H
1938-10-29,1938,Preston North End,Blackpool,1-1,1,1,1,1,2,0,D
1938-10-29,1938,Stoke City,Grimsby Town,1-2,1,2,1,1,3,-1,A
1938-11-05,1938,Arsenal,Leeds United,2-3,2,3,1,1,5,-1,A
1938-11-05,1938,Aston Villa,Manchester United,0-2,0,2,1,1,2,-2,A
1938-11-05,1938,Blackpool,Charlton Athletic,0-0,0,0,1,1,0,0,D
1938-11-05,1938,Brentford,Bolton Wanderers,2-2,2,2,1,1,4,0,D
1938-11-05,1938,Derby County,Preston North End,2-0,2,0,1,1,2,2,H
1938-11-05,1938,Everton,Middlesbrough,4-0,4,0,1,1,4,4,H
1938-11-05,1938,Grimsby Town,Chelsea,2-1,2,1,1,1,3,1,H
1938-11-05,1938,Huddersfield Town,Leicester City,2-0,2,0,1,1,2,2,H
1938-11-05,1938,Portsmouth,Liverpool,1-1,1,1,1,1,2,0,D
1938-11-05,1938,Sunderland,Stoke City,3-0,3,0,1,1,3,3,H
1938-11-05,1938,Wolverhampton Wanderers,Birmingham City,2-1,2,1,1,1,3,1,H
1938-11-12,1938,Birmingham City,Everton,1-0,1,0,1,1,1,1,H
1938-11-12,1938,Bolton Wanderers,Blackpool,0-1,0,1,1,1,1,-1,A
1938-11-12,1938,Charlton Athletic,Derby County,1-0,1,0,1,1,1,1,H
1938-11-12,1938,Chelsea,Sunderland,4-0,4,0,1,1,4,4,H
1938-11-12,1938,Leeds United,Brentford,3-2,3,2,1,1,5,1,H
1938-11-12,1938,Liverpool,Arsenal,2-2,2,2,1,1,4,0,D
1938-11-12,1938,Manchester United,Wolverhampton Wanderers,1-3,1,3,1,1,4,-2,A
1938-11-12,1938,Middlesbrough,Huddersfield Town,4-1,4,1,1,1,5,3,H
1938-11-12,1938,Preston North End,Grimsby Town,1-1,1,1,1,1,2,0,D
1938-11-12,1938,Stoke City,Aston Villa,3-1,3,1,1,1,4,2,H
1938-11-19,1938,Arsenal,Leicester City,0-0,0,0,1,1,0,0,D
1938-11-19,1938,Aston Villa,Chelsea,6-2,6,2,1,1,8,4,H
1938-11-19,1938,Blackpool,Leeds United,1-2,1,2,1,1,3,-1,A
1938-11-19,1938,Brentford,Liverpool,2-1,2,1,1,1,3,1,H
1938-11-19,1938,Derby County,Bolton Wanderers,3-0,3,0,1,1,3,3,H
1938-11-19,1938,Everton,Manchester United,3-0,3,0,1,1,3,3,H
1938-11-19,1938,Grimsby Town,Charlton Athletic,1-1,1,1,1,1,2,0,D
1938-11-19,1938,Huddersfield Town,Birmingham City,3-1,3,1,1,1,4,2,H
1938-11-19,1938,Portsmouth,Middlesbrough,1-1,1,1,1,1,2,0,D
1938-11-19,1938,Sunderland,Preston North End,1-2,1,2,1,1,3,-1,A
1938-11-19,1938,Wolverhampton Wanderers,Stoke City,3-0,3,0,1,1,3,3,H
1938-11-21,1938,Leicester City,Portsmouth,5-0,5,0,1,1,5,5,H
1938-11-26,1938,Birmingham City,Portsmouth,2-0,2,0,1,1,2,2,H
1938-11-26,1938,Bolton Wanderers,Grimsby Town,1-1,1,1,1,1,2,0,D
1938-11-26,1938,Charlton Athletic,Sunderland,3-0,3,0,1,1,3,3,H
1938-11-26,1938,Chelsea,Wolverhampton Wanderers,1-3,1,3,1,1,4,-2,A
1938-11-26,1938,Leeds United,Derby County,1-4,1,4,1,1,5,-3,A
1938-11-26,1938,Leicester City,Brentford,1-1,1,1,1,1,2,0,D
1938-11-26,1938,Liverpool,Blackpool,1-0,1,0,1,1,1,1,H
1938-11-26,1938,Manchester United,Huddersfield Town,1-1,1,1,1,1,2,0,D
1938-11-26,1938,Middlesbrough,Arsenal,1-1,1,1,1,1,2,0,D
1938-11-26,1938,Preston North End,Aston Villa,3-2,3,2,1,1,5,1,H
1938-11-26,1938,Stoke City,Everton,0-0,0,0,1,1,0,0,D
1938-12-03,1938,Arsenal,Birmingham City,3-1,3,1,1,1,4,2,H
1938-12-03,1938,Aston Villa,Charlton Athletic,2-0,2,0,1,1,2,2,H
1938-12-03,1938,Blackpool,Leicester City,1-1,1,1,1,1,2,0,D
1938-12-03,1938,Brentford,Middlesbrough,2-1,2,1,1,1,3,1,H
1938-12-03,1938,Derby County,Liverpool,2-2,2,2,1,1,4,0,D
1938-12-03,1938,Everton,Chelsea,4-1,4,1,1,1,5,3,H
1938-12-03,1938,Grimsby Town,Leeds United,3-2,3,2,1,1,5,1,H
1938-12-03,1938,Huddersfield Town,Stoke City,1-4,1,4,1,1,5,-3,A
1938-12-03,1938,Portsmouth,Manchester United,0-0,0,0,1,1,0,0,D
1938-12-03,1938,Sunderland,Bolton Wanderers,2-2,2,2,1,1,4,0,D
1938-12-03,1938,Wolverhampton Wanderers,Preston North End,3-0,3,0,1,1,3,3,H
1938-12-10,1938,Birmingham City,Brentford,5-1,5,1,1,1,6,4,H
1938-12-10,1938,Bolton Wanderers,Aston Villa,1-2,1,2,1,1,3,-1,A
1938-12-10,1938,Charlton Athletic,Wolverhampton Wanderers,0-4,0,4,1,1,4,-4,A
1938-12-10,1938,Chelsea,Huddersfield Town,3-0,3,0,1,1,3,3,H
1938-12-10,1938,Leeds United,Sunderland,3-3,3,3,1,1,6,0,D
1938-12-10,1938,Leicester City,Derby County,2-3,2,3,1,1,5,-1,A
1938-12-10,1938,Liverpool,Grimsby Town,2-2,2,2,1,1,4,0,D
1938-12-10,1938,Manchester United,Arsenal,1-0,1,0,1,1,1,1,H
1938-12-10,1938,Middlesbrough,Blackpool,9-2,9,2,1,1,11,7,H
1938-12-10,1938,Preston North End,Everton,0-1,0,1,1,1,1,-1,A
1938-12-10,1938,Stoke City,Portsmouth,1-1,1,1,1,1,2,0,D
1938-12-17,1938,Arsenal,Stoke City,4-1,4,1,1,1,5,3,H
1938-12-17,1938,Aston Villa,Leeds United,2-1,2,1,1,1,3,1,H
1938-12-17,1938,Blackpool,Birmingham City,2-1,2,1,1,1,3,1,H
1938-12-17,1938,Brentford,Manchester United,2-5,2,5,1,1,7,-3,A
1938-12-17,1938,Derby County,Middlesbrough,1-4,1,4,1,1,5,-3,A
1938-12-17,1938,Everton,Charlton Athletic,1-4,1,4,1,1,5,-3,A
1938-12-17,1938,Grimsby Town,Leicester City,6-1,6,1,1,1,7,5,H
1938-12-17,1938,Huddersfield Town,Preston North End,3-0,3,0,1,1,3,3,H
1938-12-17,1938,Portsmouth,Chelsea,2-1,2,1,1,1,3,1,H
1938-12-17,1938,Sunderland,Liverpool,2-3,2,3,1,1,5,-1,A
1938-12-17,1938,Wolverhampton Wanderers,Bolton Wanderers,1-1,1,1,1,1,2,0,D
1938-12-24,1938,Aston Villa,Grimsby Town,0-2,0,2,1,1,2,-2,A
1938-12-24,1938,Charlton Athletic,Bolton Wanderers,2-1,2,1,1,1,3,1,H
1938-12-24,1938,Chelsea,Liverpool,4-1,4,1,1,1,5,3,H
1938-12-24,1938,Everton,Blackpool,4-0,4,0,1,1,4,4,H
1938-12-24,1938,Huddersfield Town,Brentford,1-2,1,2,1,1,3,-1,A
1938-12-24,1938,Manchester United,Middlesbrough,1-1,1,1,1,1,2,0,D
1938-12-24,1938,Portsmouth,Arsenal,0-0,0,0,1,1,0,0,D
1938-12-24,1938,Preston North End,Leeds United,2-0,2,0,1,1,2,2,H
1938-12-24,1938,Stoke City,Leicester City,1-0,1,0,1,1,1,1,H
1938-12-24,1938,Sunderland,Birmingham City,1-0,1,0,1,1,1,1,H
1938-12-24,1938,Wolverhampton Wanderers,Derby County,0-0,0,0,1,1,0,0,D
1938-12-26,1938,Birmingham City,Middlesbrough,2-1,2,1,1,1,3,1,H
1938-12-26,1938,Blackpool,Huddersfield Town,1-1,1,1,1,1,2,0,D
1938-12-26,1938,Charlton Athletic,Arsenal,1-0,1,0,1,1,1,1,H
1938-12-26,1938,Everton,Derby County,2-2,2,2,1,1,4,0,D
1938-12-26,1938,Grimsby Town,Wolverhampton Wanderers,2-4,2,4,1,1,6,-2,A
1938-12-26,1938,Leeds United,Chelsea,1-1,1,1,1,1,2,0,D
1938-12-26,1938,Manchester United,Leicester City,3-0,3,0,1,1,3,3,H
1938-12-26,1938,Stoke City,Liverpool,3-1,3,1,1,1,4,2,H
1938-12-26,1938,Sunderland,Aston Villa,1-5,1,5,1,1,6,-4,A
1938-12-27,1938,Aston Villa,Sunderland,1-1,1,1,1,1,2,0,D
1938-12-27,1938,Chelsea,Leeds United,2-2,2,2,1,1,4,0,D
1938-12-27,1938,Derby County,Everton,2-1,2,1,1,1,3,1,H
1938-12-27,1938,Huddersfield Town,Blackpool,3-0,3,0,1,1,3,3,H
1938-12-27,1938,Leicester City,Manchester United,1-1,1,1,1,1,2,0,D
1938-12-27,1938,Liverpool,Stoke City,1-0,1,0,1,1,1,1,H
1938-12-27,1938,Middlesbrough,Birmingham City,2-2,2,2,1,1,4,0,D
1938-12-27,1938,Portsmouth,Brentford,2-2,2,2,1,1,4,0,D
1938-12-27,1938,Preston North End,Bolton Wanderers,2-2,2,2,1,1,4,0,D
1938-12-27,1938,Wolverhampton Wanderers,Grimsby Town,5-0,5,0,1,1,5,5,H
1938-12-31,1938,Arsenal,Huddersfield Town,1-0,1,0,1,1,1,1,H
1938-12-31,1938,Birmingham City,Manchester United,3-3,3,3,1,1,6,0,D
1938-12-31,1938,Blackpool,Wolverhampton Wanderers,1-0,1,0,1,1,1,1,H
1938-12-31,1938,Bolton Wanderers,Portsmouth,5-1,5,1,1,1,6,4,H
1938-12-31,1938,Brentford,Everton,2-0,2,0,1,1,2,2,H
1938-12-31,1938,Derby County,Aston Villa,2-1,2,1,1,1,3,1,H
1938-12-31,1938,Grimsby Town,Sunderland,1-3,1,3,1,1,4,-2,A
1938-12-31,1938,Leeds United,Charlton Athletic,2-1,2,1,1,1,3,1,H
1938-12-31,1938,Leicester City,Chelsea,3-2,3,2,1,1,5,1,H
1938-12-31,1938,Liverpool,Preston North End,4-1,4,1,1,1,5,3,H
1938-12-31,1938,Middlesbrough,Stoke City,5-1,5,1,1,1,6,4,H
1939-01-02,1938,Bolton Wanderers,Stoke City,1-3,1,3,1,1,4,-2,A
1939-01-02,1938,Middlesbrough,Liverpool,3-0,3,0,1,1,3,3,H
1939-01-14,1938,Aston Villa,Blackpool,3-1,3,1,1,1,4,2,H
1939-01-14,1938,Bolton Wanderers,Leeds United,2-2,2,2,1,1,4,0,D
1939-01-14,1938,Charlton Athletic,Liverpool,1-3,1,3,1,1,4,-2,A
1939-01-14,1938,Chelsea,Middlesbrough,4-2,4,2,1,1,6,2,H
1939-01-14,1938,Everton,Arsenal,2-0,2,0,1,1,2,2,H
1939-01-14,1938,Huddersfield Town,Portsmouth,3-0,3,0,1,1,3,3,H
1939-01-14,1938,Manchester United,Grimsby Town,3-1,3,1,1,1,4,2,H
1939-01-14,1938,Preston North End,Leicester City,2-1,2,1,1,1,3,1,H
1939-01-14,1938,Stoke City,Birmingham City,6-3,6,3,1,1,9,3,H
1939-01-14,1938,Sunderland,Derby County,1-0,1,0,1,1,1,1,H
1939-01-14,1938,Wolverhampton Wanderers,Brentford,5-2,5,2,1,1,7,3,H
1939-01-21,1938,Arsenal,Charlton Athletic,2-0,2,0,1,1,2,2,H
1939-01-21,1938,Manchester United,Stoke City,0-1,0,1,1,1,1,-1,A
1939-01-25,1938,Blackpool,Sunderland,1-1,1,1,1,1,2,0,D
1939-01-25,1938,Liverpool,Bolton Wanderers,1-2,1,2,1,1,3,-1,A
1939-01-25,1938,Middlesbrough,Preston North End,2-2,2,2,1,1,4,0,D
1939-01-28,1938,Aston Villa,Arsenal,1-3,1,3,1,1,4,-2,A
1939-01-28,1938,Bolton Wanderers,Leicester City,4-0,4,0,1,1,4,4,H
1939-01-28,1938,Charlton Athletic,Middlesbrough,3-0,3,0,1,1,3,3,H
1939-01-28,1938,Chelsea,Manchester United,0-1,0,1,1,1,1,-1,A
1939-01-28,1938,Everton,Huddersfield Town,3-2,3,2,1,1,5,1,H
1939-01-28,1938,Grimsby Town,Blackpool,2-0,2,0,1,1,2,2,H
1939-01-28,1938,Leeds United,Liverpool,1-1,1,1,1,1,2,0,D
1939-01-28,1938,Preston North End,Birmingham City,5-0,5,0,1,1,5,5,H
1939-01-28,1938,Stoke City,Derby County,3-0,3,0,1,1,3,3,H
1939-01-28,1938,Sunderland,Brentford,1-1,1,1,1,1,2,0,D
1939-01-28,1938,Wolverhampton Wanderers,Portsmouth,3-0,3,0,1,1,3,3,H
1939-02-01,1938,Arsenal,Wolverhampton Wanderers,0-0,0,0,1,1,0,0,D
1939-02-01,1938,Derby County,Grimsby Town,4-1,4,1,1,1,5,3,H
1939-02-01,1938,Portsmouth,Everton,0-1,0,1,1,1,1,-1,A
1939-02-04,1938,Arsenal,Sunderland,2-0,2,0,1,1,2,2,H
1939-02-04,1938,Birmingham City,Charlton Athletic,3-4,3,4,1,1,7,-1,A
1939-02-04,1938,Blackpool,Derby County,2-2,2,2,1,1,4,0,D
1939-02-04,1938,Brentford,Grimsby Town,1-2,1,2,1,1,3,-1,A
1939-02-04,1938,Huddersfield Town,Wolverhampton Wanderers,1-2,1,2,1,1,3,-1,A
1939-02-04,1938,Leicester City,Leeds United,2-0,2,0,1,1,2,2,H
1939-02-04,1938,Liverpool,Everton,0-3,0,3,1,1,3,-3,A
1939-02-04,1938,Manchester United,Preston North End,1-1,1,1,1,1,2,0,D
1939-02-04,1938,Middlesbrough,Bolton Wanderers,1-2,1,2,1,1,3,-1,A
1939-02-04,1938,Portsmouth,Aston Villa,0-0,0,0,1,1,0,0,D
1939-02-04,1938,Stoke City,Chelsea,6-1,6,1,1,1,7,5,H
1939-02-08,1938,Brentford,Aston Villa,2-4,2,4,1,1,6,-2,A
1939-02-09,1938,Leicester City,Charlton Athletic,1-5,1,5,1,1,6,-4,A
1939-02-11,1938,Charlton Athletic,Manchester United,7-1,7,1,1,1,8,6,H
1939-02-11,1938,Derby County,Brentford,1-2,1,2,1,1,3,-1,A
1939-02-11,1938,Leeds United,Middlesbrough,0-1,0,1,1,1,1,-1,A
1939-02-15,1938,Aston Villa,Huddersfield Town,4-0,4,0,1,1,4,4,H
1939-02-15,1938,Preston North End,Stoke City,1-1,1,1,1,1,2,0,D
1939-02-18,1938,Arsenal,Chelsea,1-0,1,0,1,1,1,1,H
1939-02-18,1938,Aston Villa,Liverpool,2-0,2,0,1,1,2,2,H
1939-02-18,1938,Blackpool,Manchester United,3-5,3,5,1,1,8,-2,A
1939-02-18,1938,Brentford,Stoke City,1-0,1,0,1,1,1,1,H
1939-02-18,1938,Derby County,Birmingham City,0-1,0,1,1,1,1,-1,A
1939-02-18,1938,Everton,Bolton Wanderers,2-1,2,1,1,1,3,1,H
1939-02-18,1938,Grimsby Town,Middlesbrough,0-2,0,2,1,1,2,-2,A
1939-02-18,1938,Huddersfield Town,Charlton Athletic,4-0,4,0,1,1,4,4,H
1939-02-18,1938,Portsmouth,Preston North End,0-0,0,0,1,1,0,0,D
1939-02-18,1938,Sunderland,Leicester City,2-0,2,0,1,1,2,2,H
1939-02-18,1938,Wolverhampton Wanderers,Leeds United,4-1,4,1,1,1,5,3,H
1939-02-21,1938,Grimsby Town,Arsenal,2-1,2,1,1,1,3,1,H
1939-02-22,1938,Bolton Wanderers,Birmingham City,3-0,3,0,1,1,3,3,H
1939-02-22,1938,Brentford,Portsmouth,2-0,2,0,1,1,2,2,H
1939-02-22,1938,Wolverhampton Wanderers,Everton,7-0,7,0,1,1,7,7,H
1939-02-25,1938,Birmingham City,Grimsby Town,1-1,1,1,1,1,2,0,D
1939-02-25,1938,Bolton Wanderers,Huddersfield Town,3-2,3,2,1,1,5,1,H
1939-02-25,1938,Charlton Athletic,Portsmouth,3-3,3,3,1,1,6,0,D
1939-02-25,1938,Chelsea,Brentford,1-3,1,3,1,1,4,-2,A
1939-02-25,1938,Leeds United,Everton,1-2,1,2,1,1,3,-1,A
1939-02-25,1938,Leicester City,Aston Villa,1-1,1,1,1,1,2,0,D
1939-02-25,1938,Liverpool,Wolverhampton Wanderers,0-2,0,2,1,1,2,-2,A
1939-02-25,1938,Manchester United,Derby County,1-1,1,1,1,1,2,0,D
1939-02-25,1938,Middlesbrough,Sunderland,3-0,3,0,1,1,3,3,H
1939-02-25,1938,Preston North End,Arsenal,2-1,2,1,1,1,3,1,H
1939-02-25,1938,Stoke City,Blackpool,1-1,1,1,1,1,2,0,D
1939-03-04,1938,Arsenal,Bolton Wanderers,3-1,3,1,1,1,4,2,H
1939-03-04,1938,Aston Villa,Birmingham City,5-1,5,1,1,1,6,4,H
1939-03-04,1938,Brentford,Charlton Athletic,1-0,1,0,1,1,1,1,H
1939-03-04,1938,Liverpool,Leicester City,1-1,1,1,1,1,2,0,D
1939-03-04,1938,Sunderland,Manchester United,5-2,5,2,1,1,7,3,H
1939-03-07,1938,Grimsby Town,Stoke City,3-1,3,1,1,1,4,2,H
1939-03-08,1938,Blackpool,Preston North End,2-1,2,1,1,1,3,1,H
1939-03-08,1938,Derby County,Chelsea,0-1,0,1,1,1,1,-1,A
1939-03-08,1938,Everton,Leicester City,4-0,4,0,1,1,4,4,H
1939-03-08,1938,Portsmouth,Leeds United,2-0,2,0,1,1,2,2,H
1939-03-08,1938,Wolverhampton Wanderers,Middlesbrough,6-1,6,1,1,1,7,5,H
1939-03-11,1938,Birmingham City,Wolverhampton Wanderers,3-2,3,2,1,1,5,1,H
1939-03-11,1938,Bolton Wanderers,Brentford,1-1,1,1,1,1,2,0,D
1939-03-11,1938,Charlton Athletic,Blackpool,3-1,3,1,1,1,4,2,H
1939-03-11,1938,Chelsea,Grimsby Town,5-1,5,1,1,1,6,4,H
1939-03-11,1938,Leeds United,Arsenal,4-2,4,2,1,1,6,2,H
1939-03-11,1938,Leicester City,Huddersfield Town,0-1,0,1,1,1,1,-1,A
1939-03-11,1938,Liverpool,Portsmouth,4-4,4,4,1,1,8,0,D
1939-03-11,1938,Manchester United,Aston Villa,1-1,1,1,1,1,2,0,D
1939-03-11,1938,Middlesbrough,Everton,4-4,4,4,1,1,8,0,D
1939-03-11,1938,Preston North End,Derby County,4-1,4,1,1,1,5,3,H
1939-03-11,1938,Stoke City,Sunderland,3-1,3,1,1,1,4,2,H
1939-03-15,1938,Chelsea,Blackpool,1-1,1,1,1,1,2,0,D
1939-03-15,1938,Huddersfield Town,Liverpool,1-1,1,1,1,1,2,0,D
1939-03-15,1938,Sunderland,Portsmouth,0-2,0,2,1,1,2,-2,A
1939-03-18,1938,Arsenal,Liverpool,2-0,2,0,1,1,2,2,H
1939-03-18,1938,Aston Villa,Stoke City,3-0,3,0,1,1,3,3,H
1939-03-18,1938,Blackpool,Bolton Wanderers,0-0,0,0,1,1,0,0,D
1939-03-18,1938,Brentford,Leeds United,0-1,0,1,1,1,1,-1,A
1939-03-18,1938,Derby County,Charlton Athletic,3-1,3,1,1,1,4,2,H
1939-03-18,1938,Everton,Birmingham City,4-2,4,2,1,1,6,2,H
1939-03-18,1938,Grimsby Town,Preston North End,1-1,1,1,1,1,2,0,D
1939-03-18,1938,Huddersfield Town,Middlesbrough,0-1,0,1,1,1,1,-1,A
1939-03-18,1938,Portsmouth,Leicester City,0-1,0,1,1,1,1,-1,A
1939-03-18,1938,Sunderland,Chelsea,3-2,3,2,1,1,5,1,H
1939-03-18,1938,Wolverhampton Wanderers,Manchester United,3-0,3,0,1,1,3,3,H
1939-03-25,1938,Bolton Wanderers,Derby County,2-1,2,1,1,1,3,1,H
1939-03-25,1938,Chelsea,Aston Villa,2-1,2,1,1,1,3,1,H
1939-03-25,1938,Leeds United,Blackpool,1-0,1,0,1,1,1,1,H
1939-03-25,1938,Leicester City,Arsenal,0-2,0,2,1,1,2,-2,A
1939-03-25,1938,Liverpool,Brentford,1-0,1,0,1,1,1,1,H
1939-03-25,1938,Preston North End,Sunderland,2-1,2,1,1,1,3,1,H
1939-03-29,1938,Birmingham City,Huddersfield Town,1-1,1,1,1,1,2,0,D
1939-03-29,1938,Charlton Athletic,Grimsby Town,3-1,3,1,1,1,4,2,H
1939-03-29,1938,Manchester United,Everton,0-2,0,2,1,1,2,-2,A
1939-03-29,1938,Middlesbrough,Portsmouth,8-2,8,2,1,1,10,6,H
1939-03-29,1938,Stoke City,Wolverhampton Wanderers,5-3,5,3,1,1,8,2,H
1939-04-01,1938,Arsenal,Middlesbrough,1-2,1,2,1,1,3,-1,A
1939-04-01,1938,Aston Villa,Preston North End,3-0,3,0,1,1,3,3,H
1939-04-01,1938,Blackpool,Liverpool,1-1,1,1,1,1,2,0,D
1939-04-01,1938,Brentford,Leicester City,2-0,2,0,1,1,2,2,H
1939-04-01,1938,Derby County,Leeds United,1-0,1,0,1,1,1,1,H
1939-04-01,1938,Everton,Stoke City,1-1,1,1,1,1,2,0,D
1939-04-01,1938,Grimsby Town,Bolton Wanderers,1-1,1,1,1,1,2,0,D
1939-04-01,1938,Huddersfield Town,Manchester United,1-1,1,1,1,1,2,0,D
1939-04-01,1938,Portsmouth,Birmingham City,2-0,2,0,1,1,2,2,H
1939-04-01,1938,Sunderland,Charlton Athletic,1-1,1,1,1,1,2,0,D
1939-04-01,1938,Wolverhampton Wanderers,Chelsea,2-0,2,0,1,1,2,2,H
1939-04-07,1938,Blackpool,Arsenal,1-0,1,0,1,1,1,1,H
1939-04-07,1938,Brentford,Preston North End,3-1,3,1,1,1,4,2,H
1939-04-07,1938,Charlton Athletic,Chelsea,2-0,2,0,1,1,2,2,H
1939-04-07,1938,Grimsby Town,Huddersfield Town,3-3,3,3,1,1,6,0,D
1939-04-07,1938,Liverpool,Birmingham City,4-0,4,0,1,1,4,4,H
1939-04-07,1938,Manchester United,Leeds United,0-0,0,0,1,1,0,0,D
1939-04-07,1938,Portsmouth,Derby County,1-3,1,3,1,1,4,-2,A
1939-04-07,1938,Sunderland,Everton,1-2,1,2,1,1,3,-1,A
1939-04-08,1938,Birmingham City,Arsenal,1-2,1,2,1,1,3,-1,A
1939-04-08,1938,Bolton Wanderers,Sunderland,2-1,2,1,1,1,3,1,H
1939-04-08,1938,Charlton Athletic,Aston Villa,1-0,1,0,1,1,1,1,H
1939-04-08,1938,Chelsea,Everton,0-2,0,2,1,1,2,-2,A
1939-04-08,1938,Leeds United,Grimsby Town,0-1,0,1,1,1,1,-1,A
1939-04-08,1938,Leicester City,Blackpool,3-4,3,4,1,1,7,-1,A
1939-04-08,1938,Liverpool,Derby County,2-1,2,1,1,1,3,1,H
1939-04-08,1938,Manchester United,Portsmouth,1-1,1,1,1,1,2,0,D
1939-04-08,1938,Middlesbrough,Brentford,3-1,3,1,1,1,4,2,H
1939-04-08,1938,Preston North End,Wolverhampton Wanderers,4-2,4,2,1,1,6,2,H
1939-04-08,1938,Stoke City,Huddersfield Town,2-2,2,2,1,1,4,0,D
1939-04-10,1938,Arsenal,Blackpool,2-1,2,1,1,1,3,1,H
1939-04-10,1938,Birmingham City,Liverpool,0-0,0,0,1,1,0,0,D
1939-04-10,1938,Chelsea,Charlton Athletic,1-3,1,3,1,1,4,-2,A
1939-04-10,1938,Derby County,Portsmouth,0-1,0,1,1,1,1,-1,A
1939-04-10,1938,Everton,Sunderland,6-2,6,2,1,1,8,4,H
1939-04-10,1938,Leeds United,Manchester United,3-1,3,1,1,1,4,2,H
1939-04-10,1938,Middlesbrough,Leicester City,3-2,3,2,1,1,5,1,H
1939-04-10,1938,Preston North End,Brentford,2-0,2,0,1,1,2,2,H
1939-04-10,1938,Stoke City,Bolton Wanderers,4-1,4,1,1,1,5,3,H
1939-04-10,1938,Wolverhampton Wanderers,Aston Villa,2-1,2,1,1,1,3,1,H
1939-04-11,1938,Aston Villa,Wolverhampton Wanderers,2-2,2,2,1,1,4,0,D
1939-04-11,1938,Huddersfield Town,Grimsby Town,2-0,2,0,1,1,2,2,H
1939-04-11,1938,Leicester City,Middlesbrough,5-3,5,3,1,1,8,2,H
1939-04-15,1938,Arsenal,Manchester United,2-1,2,1,1,1,3,1,H
1939-04-15,1938,Aston Villa,Bolton Wanderers,1-3,1,3,1,1,4,-2,A
1939-04-15,1938,Blackpool,Middlesbrough,4-0,4,0,1,1,4,4,H
1939-04-15,1938,Brentford,Birmingham City,0-1,0,1,1,1,1,-1,A
1939-04-15,1938,Derby County,Leicester City,1-1,1,1,1,1,2,0,D
1939-04-15,1938,Everton,Preston North End,0-0,0,0,1,1,0,0,D
1939-04-15,1938,Grimsby Town,Liverpool,2-1,2,1,1,1,3,1,H
1939-04-15,1938,Huddersfield Town,Chelsea,3-1,3,1,1,1,4,2,H
1939-04-15,1938,Portsmouth,Stoke City,2-0,2,0,1,1,2,2,H
1939-04-15,1938,Sunderland,Leeds United,2-1,2,1,1,1,3,1,H
1939-04-15,1938,Wolverhampton Wanderers,Charlton Athletic,3-1,3,1,1,1,4,2,H
1939-04-19,1938,Leeds United,Huddersfield Town,2-1,2,1,1,1,3,1,H
1939-04-19,1938,Portsmouth,Grimsby Town,2-1,2,1,1,1,3,1,H
1939-04-22,1938,Birmingham City,Blackpool,2-1,2,1,1,1,3,1,H
1939-04-22,1938,Bolton Wanderers,Wolverhampton Wanderers,0-0,0,0,1,1,0,0,D
1939-04-22,1938,Charlton Athletic,Everton,2-1,2,1,1,1,3,1,H
1939-04-22,1938,Chelsea,Portsmouth,1-0,1,0,1,1,1,1,H
1939-04-22,1938,Leeds United,Aston Villa,2-0,2,0,1,1,2,2,H
1939-04-22,1938,Leicester City,Grimsby Town,0-2,0,2,1,1,2,-2,A
1939-04-22,1938,Liverpool,Sunderland,1-1,1,1,1,1,2,0,D
1939-04-22,1938,Manchester United,Brentford,3-0,3,0,1,1,3,3,H
1939-04-22,1938,Middlesbrough,Derby County,2-0,2,0,1,1,2,2,H
1939-04-22,1938,Preston North End,Huddersfield Town,3-0,3,0,1,1,3,3,H
1939-04-22,1938,Stoke City,Arsenal,1-0,1,0,1,1,1,1,H
1939-04-26,1938,Birmingham City,Chelsea,1-1,1,1,1,1,2,0,D
1939-04-26,1938,Bolton Wanderers,Preston North End,0-2,0,2,1,1,2,-2,A
1939-04-29,1938,Birmingham City,Leeds United,4-0,4,0,1,1,4,4,H
1939-04-29,1938,Bolton Wanderers,Manchester United,0-0,0,0,1,1,0,0,D
1939-04-29,1938,Brentford,Blackpool,1-1,1,1,1,1,2,0,D
1939-04-29,1938,Derby County,Arsenal,1-2,1,2,1,1,3,-1,A
1939-04-29,1938,Everton,Aston Villa,3-0,3,0,1,1,3,3,H
1939-04-29,1938,Preston North End,Chelsea,1-1,1,1,1,1,2,0,D
1939-04-29,1938,Stoke City,Charlton Athletic,1-0,1,0,1,1,1,1,H
1939-04-29,1938,Sunderland,Huddersfield Town,0-0,0,0,1,1,0,0,D
1939-05-04,1938,Leicester City,Wolverhampton Wanderers,0-2,0,2,1,1,2,-2,A
1939-05-06,1938,Arsenal,Brentford,2-0,2,0,1,1,2,2,H
1939-05-06,1938,Aston Villa,Middlesbrough,1-1,1,1,1,1,2,0,D
1939-05-06,1938,Blackpool,Portsmouth,2-1,2,1,1,1,3,1,H
1939-05-06,1938,Charlton Athletic,Preston North End,3-1,3,1,1,1,4,2,H
1939-05-06,1938,Chelsea,Bolton Wanderers,1-1,1,1,1,1,2,0,D
1939-05-06,1938,Grimsby Town,Everton,3-0,3,0,1,1,3,3,H
1939-05-06,1938,Leeds United,Stoke City,0-0,0,0,1,1,0,0,D
1939-05-06,1938,Manchester United,Liverpool,2-0,2,0,1,1,2,2,H
1939-05-06,1938,Wolverhampton Wanderers,Sunderland,0-0,0,0,1,1,0,0,D
1946-08-31,1946,Aston Villa,Middlesbrough,0-1,0,1,1,1,1,-1,A
1946-08-31,1946,Chelsea,Bolton Wanderers,4-3,4,3,1,1,7,1,H
1946-08-31,1946,Everton,Brentford,0-2,0,2,1,1,2,-2,A
1946-08-31,1946,Huddersfield Town,Blackpool,1-3,1,3,1,1,4,-2,A
1946-08-31,1946,Manchester United,Grimsby Town,2-1,2,1,1,1,3,1,H
1946-08-31,1946,Portsmouth,Blackburn Rovers,3-1,3,1,1,1,4,2,H
1946-08-31,1946,Preston North End,Leeds United,3-2,3,2,1,1,5,1,H
1946-08-31,1946,Sheffield United,Liverpool,0-1,0,1,1,1,1,-1,A
1946-08-31,1946,Stoke City,Charlton Athletic,2-2,2,2,1,1,4,0,D
1946-08-31,1946,Sunderland,Derby County,3-2,3,2,1,1,5,1,H
1946-08-31,1946,Wolverhampton Wanderers,Arsenal,6-1,6,1,1,1,7,5,H
1946-09-02,1946,Aston Villa,Everton,0-1,0,1,1,1,1,-1,A
1946-09-02,1946,Blackpool,Brentford,4-2,4,2,1,1,6,2,H
1946-09-02,1946,Stoke City,Bolton Wanderers,1-2,1,2,1,1,3,-1,A
1946-09-03,1946,Grimsby Town,Wolverhampton Wanderers,0-0,0,0,1,1,0,0,D
1946-09-04,1946,Arsenal,Blackburn Rovers,1-3,1,3,1,1,4,-2,A
1946-09-04,1946,Chelsea,Manchester United,0-3,0,3,1,1,3,-3,A
1946-09-04,1946,Derby County,Portsmouth,2-0,2,0,1,1,2,2,H
1946-09-04,1946,Leeds United,Charlton Athletic,0-2,0,2,1,1,2,-2,A
1946-09-04,1946,Liverpool,Middlesbrough,0-1,0,1,1,1,1,-1,A
1946-09-04,1946,Preston North End,Sheffield United,1-2,1,2,1,1,3,-1,A
1946-09-04,1946,Sunderland,Huddersfield Town,3-0,3,0,1,1,3,3,H
1946-09-07,1946,Arsenal,Sunderland,2-2,2,2,1,1,4,0,D
1946-09-07,1946,Blackburn Rovers,Everton,4-1,4,1,1,1,5,3,H
1946-09-07,1946,Blackpool,Wolverhampton Wanderers,2-0,2,0,1,1,2,2,H
1946-09-07,1946,Bolton Wanderers,Portsmouth,1-0,1,0,1,1,1,1,H
1946-09-07,1946,Brentford,Huddersfield Town,2-0,2,0,1,1,2,2,H
1946-09-07,1946,Charlton Athletic,Manchester United,1-3,1,3,1,1,4,-2,A
1946-09-07,1946,Derby County,Aston Villa,1-2,1,2,1,1,3,-1,A
1946-09-07,1946,Grimsby Town,Preston North End,2-3,2,3,1,1,5,-1,A
1946-09-07,1946,Leeds United,Sheffield United,2-2,2,2,1,1,4,0,D
1946-09-07,1946,Liverpool,Chelsea,7-4,7,4,1,1,11,3,H
1946-09-07,1946,Middlesbrough,Stoke City,5-4,5,4,1,1,9,1,H
1946-09-09,1946,Sheffield United,Chelsea,2-2,2,2,1,1,4,0,D
1946-09-11,1946,Bolton Wanderers,Stoke City,3-2,3,2,1,1,5,1,H
1946-09-11,1946,Charlton Athletic,Sunderland,5-0,5,0,1,1,5,5,H
1946-09-11,1946,Everton,Arsenal,3-2,3,2,1,1,5,1,H
1946-09-11,1946,Huddersfield Town,Derby County,5-2,5,2,1,1,7,3,H
1946-09-11,1946,Manchester United,Liverpool,5-0,5,0,1,1,5,5,H
1946-09-11,1946,Portsmouth,Blackpool,0-1,0,1,1,1,1,-1,A
1946-09-11,1946,Wolverhampton Wanderers,Aston Villa,1-2,1,2,1,1,3,-1,A
1946-09-14,1946,Aston Villa,Arsenal,0-2,0,2,1,1,2,-2,A
1946-09-14,1946,Bolton Wanderers,Liverpool,1-3,1,3,1,1,4,-2,A
1946-09-14,1946,Chelsea,Leeds United,3-0,3,0,1,1,3,3,H
1946-09-14,1946,Everton,Portsmouth,1-0,1,0,1,1,1,1,H
1946-09-14,1946,Huddersfield Town,Blackburn Rovers,0-1,0,1,1,1,1,-1,A
1946-09-14,1946,Manchester United,Middlesbrough,1-0,1,0,1,1,1,1,H
1946-09-14,1946,Preston North End,Charlton Athletic,5-1,5,1,1,1,6,4,H
1946-09-14,1946,Sheffield United,Grimsby Town,1-1,1,1,1,1,2,0,D
1946-09-14,1946,Stoke City,Derby County,3-2,3,2,1,1,5,1,H
1946-09-14,1946,Sunderland,Blackpool,3-2,3,2,1,1,5,1,H
1946-09-14,1946,Wolverhampton Wanderers,Brentford,1-2,1,2,1,1,3,-1,A
1946-09-16,1946,Aston Villa,Wolverhampton Wanderers,3-0,3,0,1,1,3,3,H
1946-09-16,1946,Preston North End,Bolton Wanderers,0-4,0,4,1,1,4,-4,A
1946-09-16,1946,Stoke City,Leeds United,5-2,5,2,1,1,7,3,H
1946-09-17,1946,Blackburn Rovers,Arsenal,1-2,1,2,1,1,3,-1,A
1946-09-18,1946,Brentford,Blackpool,2-1,2,1,1,1,3,1,H
1946-09-18,1946,Manchester United,Chelsea,1-1,1,1,1,1,2,0,D
1946-09-21,1946,Arsenal,Derby County,0-1,0,1,1,1,1,-1,A
1946-09-21,1946,Blackburn Rovers,Wolverhampton Wanderers,1-2,1,2,1,1,3,-1,A
1946-09-21,1946,Blackpool,Aston Villa,1-0,1,0,1,1,1,1,H
1946-09-21,1946,Brentford,Sunderland,0-3,0,3,1,1,3,-3,A
1946-09-21,1946,Charlton Athletic,Sheffield United,1-2,1,2,1,1,3,-1,A
1946-09-21,1946,Grimsby Town,Chelsea,2-1,2,1,1,1,3,1,H
1946-09-21,1946,Leeds United,Bolton Wanderers,4-0,4,0,1,1,4,4,H
1946-09-21,1946,Liverpool,Everton,0-0,0,0,1,1,0,0,D
1946-09-21,1946,Middlesbrough,Preston North End,2-0,2,0,1,1,2,2,H
1946-09-21,1946,Portsmouth,Huddersfield Town,3-1,3,1,1,1,4,2,H
1946-09-21,1946,Stoke City,Manchester United,3-2,3,2,1,1,5,1,H
1946-09-23,1946,Blackpool,Portsmouth,4-3,4,3,1,1,7,1,H
1946-09-23,1946,Wolverhampton Wanderers,Grimsby Town,2-0,2,0,1,1,2,2,H
1946-09-25,1946,Charlton Athletic,Leeds United,5-0,5,0,1,1,5,5,H
1946-09-25,1946,Huddersfield Town,Sunderland,0-0,0,0,1,1,0,0,D
1946-09-28,1946,Aston Villa,Brentford,5-2,5,2,1,1,7,3,H
1946-09-28,1946,Bolton Wanderers,Grimsby Town,1-2,1,2,1,1,3,-1,A
1946-09-28,1946,Chelsea,Charlton Athletic,2-2,2,2,1,1,4,0,D
1946-09-28,1946,Derby County,Blackpool,1-2,1,2,1,1,3,-1,A
1946-09-28,1946,Huddersfield Town,Everton,1-0,1,0,1,1,1,1,H
1946-09-28,1946,Liverpool,Leeds United,2-0,2,0,1,1,2,2,H
1946-09-28,1946,Manchester United,Arsenal,5-2,5,2,1,1,7,3,H
1946-09-28,1946,Preston North End,Stoke City,1-3,1,3,1,1,4,-2,A
1946-09-28,1946,Sheffield United,Middlesbrough,2-1,2,1,1,1,3,1,H
1946-09-28,1946,Sunderland,Blackburn Rovers,1-0,1,0,1,1,1,1,H
1946-09-28,1946,Wolverhampton Wanderers,Portsmouth,3-1,3,1,1,1,4,2,H
1946-10-05,1946,Blackburn Rovers,Aston Villa,0-1,0,1,1,1,1,-1,A
1946-10-05,1946,Blackpool,Arsenal,2-1,2,1,1,1,3,1,H
1946-10-05,1946,Brentford,Derby County,0-3,0,3,1,1,3,-3,A
1946-10-05,1946,Charlton Athletic,Bolton Wanderers,2-0,2,0,1,1,2,2,H
1946-10-05,1946,Everton,Wolverhampton Wanderers,0-2,0,2,1,1,2,-2,A
1946-10-05,1946,Grimsby Town,Liverpool,1-6,1,6,1,1,7,-5,A
1946-10-05,1946,Leeds United,Huddersfield Town,5-0,5,0,1,1,5,5,H
1946-10-05,1946,Manchester United,Preston North End,1-1,1,1,1,1,2,0,D
1946-10-05,1946,Middlesbrough,Chelsea,3-2,3,2,1,1,5,1,H
1946-10-05,1946,Portsmouth,Sunderland,4-1,4,1,1,1,5,3,H
1946-10-05,1946,Stoke City,Sheffield United,3-0,3,0,1,1,3,3,H
1946-10-09,1946,Middlesbrough,Liverpool,2-2,2,2,1,1,4,0,D
1946-10-12,1946,Arsenal,Brentford,2-2,2,2,1,1,4,0,D
1946-10-12,1946,Aston Villa,Portsmouth,1-1,1,1,1,1,2,0,D
1946-10-12,1946,Bolton Wanderers,Middlesbrough,1-1,1,1,1,1,2,0,D
1946-10-12,1946,Chelsea,Stoke City,2-5,2,5,1,1,7,-3,A
1946-10-12,1946,Derby County,Blackburn Rovers,2-1,2,1,1,1,3,1,H
1946-10-12,1946,Leeds United,Grimsby Town,1-0,1,0,1,1,1,1,H
1946-10-12,1946,Liverpool,Charlton Athletic,1-1,1,1,1,1,2,0,D
1946-10-12,1946,Preston North End,Blackpool,2-0,2,0,1,1,2,2,H
1946-10-12,1946,Sheffield United,Manchester United,2-2,2,2,1,1,4,0,D
1946-10-12,1946,Sunderland,Everton,4-1,4,1,1,1,5,3,H
1946-10-12,1946,Wolverhampton Wanderers,Huddersfield Town,6-1,6,1,1,1,7,5,H
1946-10-19,1946,Arsenal,Stoke City,1-0,1,0,1,1,1,1,H
1946-10-19,1946,Aston Villa,Charlton Athletic,4-0,4,0,1,1,4,4,H
1946-10-19,1946,Blackburn Rovers,Sheffield United,2-0,2,0,1,1,2,2,H
1946-10-19,1946,Blackpool,Manchester United,3-1,3,1,1,1,4,2,H
1946-10-19,1946,Brentford,Preston North End,2-3,2,3,1,1,5,-1,A
1946-10-19,1946,Derby County,Middlesbrough,1-1,1,1,1,1,2,0,D
1946-10-19,1946,Everton,Bolton Wanderers,2-1,2,1,1,1,3,1,H
1946-10-19,1946,Huddersfield Town,Liverpool,1-4,1,4,1,1,5,-3,A
1946-10-19,1946,Portsmouth,Chelsea,0-2,0,2,1,1,2,-2,A
1946-10-19,1946,Sunderland,Grimsby Town,1-2,1,2,1,1,3,-1,A
1946-10-19,1946,Wolverhampton Wanderers,Leeds United,1-0,1,0,1,1,1,1,H
1946-10-26,1946,Bolton Wanderers,Blackpool,1-1,1,1,1,1,2,0,D
1946-10-26,1946,Charlton Athletic,Everton,4-1,4,1,1,1,5,3,H
1946-10-26,1946,Chelsea,Arsenal,2-1,2,1,1,1,3,1,H
1946-10-26,1946,Grimsby Town,Portsmouth,3-2,3,2,1,1,5,1,H
1946-10-26,1946,Leeds United,Blackburn Rovers,0-1,0,1,1,1,1,-1,A
1946-10-26,1946,Liverpool,Brentford,1-0,1,0,1,1,1,1,H
1946-10-26,1946,Manchester United,Sunderland,0-3,0,3,1,1,3,-3,A
1946-10-26,1946,Middlesbrough,Huddersfield Town,4-1,4,1,1,1,5,3,H
1946-10-26,1946,Preston North End,Aston Villa,3-1,3,1,1,1,4,2,H
1946-10-26,1946,Sheffield United,Derby County,3-2,3,2,1,1,5,1,H
1946-10-26,1946,Stoke City,Wolverhampton Wanderers,0-3,0,3,1,1,3,-3,A
1946-11-02,1946,Arsenal,Sheffield United,2-3,2,3,1,1,5,-1,A
1946-11-02,1946,Aston Villa,Manchester United,0-0,0,0,1,1,0,0,D
1946-11-02,1946,Blackburn Rovers,Liverpool,0-0,0,0,1,1,0,0,D
1946-11-02,1946,Blackpool,Chelsea,1-0,1,0,1,1,1,1,H
1946-11-02,1946,Brentford,Bolton Wanderers,1-0,1,0,1,1,1,1,H
1946-11-02,1946,Derby County,Preston North End,2-2,2,2,1,1,4,0,D
1946-11-02,1946,Everton,Grimsby Town,3-3,3,3,1,1,6,0,D
1946-11-02,1946,Huddersfield Town,Charlton Athletic,5-1,5,1,1,1,6,4,H
1946-11-02,1946,Portsmouth,Leeds United,4-1,4,1,1,1,5,3,H
1946-11-02,1946,Sunderland,Stoke City,0-1,0,1,1,1,1,-1,A
1946-11-02,1946,Wolverhampton Wanderers,Middlesbrough,2-4,2,4,1,1,6,-2,A
1946-11-09,1946,Bolton Wanderers,Blackburn Rovers,0-0,0,0,1,1,0,0,D
1946-11-09,1946,Charlton Athletic,Wolverhampton Wanderers,1-4,1,4,1,1,5,-3,A
1946-11-09,1946,Chelsea,Brentford,3-2,3,2,1,1,5,1,H
1946-11-09,1946,Grimsby Town,Huddersfield Town,1-0,1,0,1,1,1,1,H
1946-11-09,1946,Leeds United,Everton,2-1,2,1,1,1,3,1,H
1946-11-09,1946,Liverpool,Portsmouth,3-0,3,0,1,1,3,3,H
1946-11-09,1946,Manchester United,Derby County,4-1,4,1,1,1,5,3,H
1946-11-09,1946,Middlesbrough,Sunderland,1-3,1,3,1,1,4,-2,A
1946-11-09,1946,Preston North End,Arsenal,2-0,2,0,1,1,2,2,H
1946-11-09,1946,Sheffield United,Blackpool,4-2,4,2,1,1,6,2,H
1946-11-09,1946,Stoke City,Aston Villa,0-0,0,0,1,1,0,0,D
1946-11-16,1946,Arsenal,Leeds United,4-2,4,2,1,1,6,2,H
1946-11-16,1946,Aston Villa,Bolton Wanderers,1-1,1,1,1,1,2,0,D
1946-11-16,1946,Blackburn Rovers,Middlesbrough,1-2,1,2,1,1,3,-1,A
1946-11-16,1946,Blackpool,Grimsby Town,2-3,2,3,1,1,5,-1,A
1946-11-16,1946,Brentford,Charlton Athletic,1-4,1,4,1,1,5,-3,A
1946-11-16,1946,Derby County,Liverpool,1-4,1,4,1,1,5,-3,A
1946-11-16,1946,Everton,Manchester United,2-2,2,2,1,1,4,0,D
1946-11-16,1946,Huddersfield Town,Preston North End,3-0,3,0,1,1,3,3,H
1946-11-16,1946,Portsmouth,Stoke City,1-3,1,3,1,1,4,-2,A
1946-11-16,1946,Sunderland,Chelsea,1-2,1,2,1,1,3,-1,A
1946-11-16,1946,Wolverhampton Wanderers,Sheffield United,3-1,3,1,1,1,4,2,H
1946-11-23,1946,Bolton Wanderers,Derby County,5-1,5,1,1,1,6,4,H
1946-11-23,1946,Charlton Athletic,Blackburn Rovers,0-2,0,2,1,1,2,-2,A
1946-11-23,1946,Chelsea,Aston Villa,1-3,1,3,1,1,4,-2,A
1946-11-23,1946,Grimsby Town,Brentford,2-2,2,2,1,1,4,0,D
1946-11-23,1946,Leeds United,Blackpool,4-2,4,2,1,1,6,2,H
1946-11-23,1946,Liverpool,Arsenal,4-2,4,2,1,1,6,2,H
1946-11-23,1946,Manchester United,Huddersfield Town,5-2,5,2,1,1,7,3,H
1946-11-23,1946,Middlesbrough,Portsmouth,3-3,3,3,1,1,6,0,D
1946-11-23,1946,Preston North End,Wolverhampton Wanderers,2-2,2,2,1,1,4,0,D
1946-11-23,1946,Sheffield United,Sunderland,4-2,4,2,1,1,6,2,H
1946-11-23,1946,Stoke City,Everton,2-1,2,1,1,1,3,1,H
1946-11-30,1946,Arsenal,Bolton Wanderers,2-2,2,2,1,1,4,0,D
1946-11-30,1946,Aston Villa,Sheffield United,2-3,2,3,1,1,5,-1,A
1946-11-30,1946,Blackburn Rovers,Grimsby Town,1-1,1,1,1,1,2,0,D
1946-11-30,1946,Blackpool,Liverpool,3-2,3,2,1,1,5,1,H
1946-11-30,1946,Brentford,Leeds United,1-1,1,1,1,1,2,0,D
1946-11-30,1946,Derby County,Chelsea,3-1,3,1,1,1,4,2,H
1946-11-30,1946,Everton,Middlesbrough,2-1,2,1,1,1,3,1,H
1946-11-30,1946,Huddersfield Town,Stoke City,1-0,1,0,1,1,1,1,H
1946-11-30,1946,Portsmouth,Charlton Athletic,3-0,3,0,1,1,3,3,H
1946-11-30,1946,Sunderland,Preston North End,0-2,0,2,1,1,2,-2,A
1946-11-30,1946,Wolverhampton Wanderers,Manchester United,3-2,3,2,1,1,5,1,H
1946-12-07,1946,Bolton Wanderers,Huddersfield Town,4-0,4,0,1,1,4,4,H
1946-12-07,1946,Charlton Athletic,Derby County,2-4,2,4,1,1,6,-2,A
1946-12-07,1946,Chelsea,Everton,1-1,1,1,1,1,2,0,D
1946-12-07,1946,Grimsby Town,Aston Villa,0-3,0,3,1,1,3,-3,A
1946-12-07,1946,Leeds United,Sunderland,1-1,1,1,1,1,2,0,D
1946-12-07,1946,Liverpool,Wolverhampton Wanderers,1-5,1,5,1,1,6,-4,A
1946-12-07,1946,Manchester United,Brentford,4-1,4,1,1,1,5,3,H
1946-12-07,1946,Middlesbrough,Arsenal,2-0,2,0,1,1,2,2,H
1946-12-07,1946,Preston North End,Blackburn Rovers,4-0,4,0,1,1,4,4,H
1946-12-07,1946,Stoke City,Blackpool,4-1,4,1,1,1,5,3,H
1946-12-14,1946,Arsenal,Charlton Athletic,1-0,1,0,1,1,1,1,H
1946-12-14,1946,Aston Villa,Leeds United,2-1,2,1,1,1,3,1,H
1946-12-14,1946,Blackburn Rovers,Manchester United,2-1,2,1,1,1,3,1,H
1946-12-14,1946,Blackpool,Middlesbrough,0-5,0,5,1,1,5,-5,A
1946-12-14,1946,Brentford,Stoke City,1-4,1,4,1,1,5,-3,A
1946-12-14,1946,Derby County,Grimsby Town,4-1,4,1,1,1,5,3,H
1946-12-14,1946,Everton,Sheffield United,2-3,2,3,1,1,5,-1,A
1946-12-14,1946,Huddersfield Town,Chelsea,1-4,1,4,1,1,5,-3,A
1946-12-14,1946,Portsmouth,Preston North End,4-4,4,4,1,1,8,0,D
1946-12-14,1946,Sunderland,Liverpool,1-4,1,4,1,1,5,-3,A
1946-12-14,1946,Wolverhampton Wanderers,Bolton Wanderers,5-0,5,0,1,1,5,5,H
1946-12-21,1946,Bolton Wanderers,Sunderland,0-1,0,1,1,1,1,-1,A
1946-12-21,1946,Charlton Athletic,Blackpool,0-1,0,1,1,1,1,-1,A
1946-12-21,1946,Chelsea,Wolverhampton Wanderers,1-2,1,2,1,1,3,-1,A
1946-12-21,1946,Grimsby Town,Arsenal,0-0,0,0,1,1,0,0,D
1946-12-21,1946,Leeds United,Derby County,1-2,1,2,1,1,3,-1,A
1946-12-21,1946,Liverpool,Aston Villa,4-1,4,1,1,1,5,3,H
1946-12-21,1946,Middlesbrough,Brentford,2-0,2,0,1,1,2,2,H
1946-12-21,1946,Preston North End,Everton,2-1,2,1,1,1,3,1,H
1946-12-21,1946,Sheffield United,Huddersfield Town,2-2,2,2,1,1,4,0,D
1946-12-21,1946,Stoke City,Blackburn Rovers,0-0,0,0,1,1,0,0,D
1946-12-25,1946,Arsenal,Portsmouth,2-1,2,1,1,1,3,1,H
1946-12-25,1946,Aston Villa,Huddersfield Town,2-2,2,2,1,1,4,0,D
1946-12-25,1946,Blackburn Rovers,Blackpool,1-1,1,1,1,1,2,0,D
1946-12-25,1946,Bolton Wanderers,Manchester United,2-2,2,2,1,1,4,0,D
1946-12-25,1946,Chelsea,Preston North End,1-2,1,2,1,1,3,-1,A
1946-12-25,1946,Everton,Derby County,4-1,4,1,1,1,5,3,H
1946-12-25,1946,Grimsby Town,Charlton Athletic,3-1,3,1,1,1,4,2,H
1946-12-25,1946,Leeds United,Middlesbrough,3-3,3,3,1,1,6,0,D
1946-12-25,1946,Sheffield United,Brentford,6-1,6,1,1,1,7,5,H
1946-12-25,1946,Stoke City,Liverpool,2-1,2,1,1,1,3,1,H
1946-12-25,1946,Sunderland,Wolverhampton Wanderers,0-1,0,1,1,1,1,-1,A
1946-12-26,1946,Blackpool,Blackburn Rovers,1-0,1,0,1,1,1,1,H
1946-12-26,1946,Brentford,Sheffield United,2-1,2,1,1,1,3,1,H
1946-12-26,1946,Charlton Athletic,Grimsby Town,0-0,0,0,1,1,0,0,D
1946-12-26,1946,Derby County,Everton,5-1,5,1,1,1,6,4,H
1946-12-26,1946,Huddersfield Town,Aston Villa,1-0,1,0,1,1,1,1,H
1946-12-26,1946,Liverpool,Stoke City,2-0,2,0,1,1,2,2,H
1946-12-26,1946,Manchester United,Bolton Wanderers,1-0,1,0,1,1,1,1,H
1946-12-26,1946,Middlesbrough,Leeds United,3-0,3,0,1,1,3,3,H
1946-12-26,1946,Portsmouth,Arsenal,0-2,0,2,1,1,2,-2,A
1946-12-26,1946,Preston North End,Chelsea,1-1,1,1,1,1,2,0,D
1946-12-26,1946,Wolverhampton Wanderers,Sunderland,2-1,2,1,1,1,3,1,H
1946-12-28,1946,Arsenal,Wolverhampton Wanderers,1-1,1,1,1,1,2,0,D
1946-12-28,1946,Blackburn Rovers,Portsmouth,0-1,0,1,1,1,1,-1,A
1946-12-28,1946,Blackpool,Huddersfield Town,2-1,2,1,1,1,3,1,H
1946-12-28,1946,Bolton Wanderers,Chelsea,1-1,1,1,1,1,2,0,D
1946-12-28,1946,Brentford,Everton,1-1,1,1,1,1,2,0,D
1946-12-28,1946,Charlton Athletic,Stoke City,1-0,1,0,1,1,1,1,H
1946-12-28,1946,Derby County,Sunderland,5-1,5,1,1,1,6,4,H
1946-12-28,1946,Grimsby Town,Manchester United,0-0,0,0,1,1,0,0,D
1946-12-28,1946,Leeds United,Preston North End,0-3,0,3,1,1,3,-3,A
1946-12-28,1946,Liverpool,Sheffield United,1-2,1,2,1,1,3,-1,A
1946-12-28,1946,Middlesbrough,Aston Villa,1-2,1,2,1,1,3,-1,A
1947-01-01,1946,Blackburn Rovers,Brentford,0-3,0,3,1,1,3,-3,A
1947-01-01,1946,Bolton Wanderers,Preston North End,1-2,1,2,1,1,3,-1,A
1947-01-01,1946,Everton,Aston Villa,2-0,2,0,1,1,2,2,H
1947-01-01,1946,Middlesbrough,Grimsby Town,3-0,3,0,1,1,3,3,H
1947-01-04,1946,Aston Villa,Derby County,2-0,2,0,1,1,2,2,H
1947-01-04,1946,Chelsea,Liverpool,3-1,3,1,1,1,4,2,H
1947-01-04,1946,Everton,Blackburn Rovers,1-0,1,0,1,1,1,1,H
1947-01-04,1946,Huddersfield Town,Brentford,3-0,3,0,1,1,3,3,H
1947-01-04,1946,Manchester United,Charlton Athletic,4-1,4,1,1,1,5,3,H
1947-01-04,1946,Portsmouth,Bolton Wanderers,2-0,2,0,1,1,2,2,H
1947-01-04,1946,Preston North End,Grimsby Town,3-0,3,0,1,1,3,3,H
1947-01-04,1946,Sheffield United,Leeds United,6-2,6,2,1,1,8,4,H
1947-01-04,1946,Stoke City,Middlesbrough,3-1,3,1,1,1,4,2,H
1947-01-04,1946,Sunderland,Arsenal,1-4,1,4,1,1,5,-3,A
1947-01-04,1946,Wolverhampton Wanderers,Blackpool,3-1,3,1,1,1,4,2,H
1947-01-18,1946,Arsenal,Aston Villa,0-2,0,2,1,1,2,-2,A
1947-01-18,1946,Blackburn Rovers,Huddersfield Town,2-2,2,2,1,1,4,0,D
1947-01-18,1946,Blackpool,Sunderland,0-5,0,5,1,1,5,-5,A
1947-01-18,1946,Brentford,Wolverhampton Wanderers,4-1,4,1,1,1,5,3,H
1947-01-18,1946,Charlton Athletic,Preston North End,0-0,0,0,1,1,0,0,D
1947-01-18,1946,Derby County,Stoke City,3-0,3,0,1,1,3,3,H
1947-01-18,1946,Grimsby Town,Sheffield United,2-1,2,1,1,1,3,1,H
1947-01-18,1946,Leeds United,Chelsea,2-1,2,1,1,1,3,1,H
1947-01-18,1946,Liverpool,Bolton Wanderers,0-3,0,3,1,1,3,-3,A
1947-01-18,1946,Middlesbrough,Manchester United,2-4,2,4,1,1,6,-2,A
1947-01-18,1946,Portsmouth,Everton,2-1,2,1,1,1,3,1,H
1947-01-25,1946,Aston Villa,Blackpool,1-1,1,1,1,1,2,0,D
1947-01-29,1946,Everton,Liverpool,1-0,1,0,1,1,1,1,H
1947-01-29,1946,Huddersfield Town,Portsmouth,1-2,1,2,1,1,3,-1,A
1947-01-29,1946,Preston North End,Middlesbrough,0-1,0,1,1,1,1,-1,A
1947-02-01,1946,Arsenal,Manchester United,6-2,6,2,1,1,8,4,H
1947-02-01,1946,Blackburn Rovers,Sunderland,1-2,1,2,1,1,3,-1,A
1947-02-01,1946,Blackpool,Derby County,2-1,2,1,1,1,3,1,H
1947-02-01,1946,Brentford,Aston Villa,0-2,0,2,1,1,2,-2,A
1947-02-01,1946,Charlton Athletic,Chelsea,2-3,2,3,1,1,5,-1,A
1947-02-01,1946,Everton,Huddersfield Town,1-0,1,0,1,1,1,1,H
1947-02-01,1946,Grimsby Town,Bolton Wanderers,2-2,2,2,1,1,4,0,D
1947-02-01,1946,Leeds United,Liverpool,1-2,1,2,1,1,3,-1,A
1947-02-01,1946,Middlesbrough,Sheffield United,2-4,2,4,1,1,6,-2,A
1947-02-01,1946,Stoke City,Preston North End,5-0,5,0,1,1,5,5,H
1947-02-03,1946,Bolton Wanderers,Leeds United,2-0,2,0,1,1,2,2,H
1947-02-05,1946,Manchester United,Stoke City,1-1,1,1,1,1,2,0,D
1947-02-08,1946,Arsenal,Blackpool,1-1,1,1,1,1,2,0,D
1947-02-08,1946,Chelsea,Grimsby Town,0-0,0,0,1,1,0,0,D
1947-02-08,1946,Sunderland,Portsmouth,0-0,0,0,1,1,0,0,D
1947-02-12,1946,Liverpool,Grimsby Town,5-0,5,0,1,1,5,5,H
1947-02-15,1946,Blackburn Rovers,Derby County,1-1,1,1,1,1,2,0,D
1947-02-15,1946,Blackpool,Preston North End,4-0,4,0,1,1,4,4,H
1947-02-15,1946,Everton,Sunderland,4-2,4,2,1,1,6,2,H
1947-02-15,1946,Middlesbrough,Bolton Wanderers,3-1,3,1,1,1,4,2,H
1947-02-15,1946,Portsmouth,Aston Villa,3-2,3,2,1,1,5,1,H
1947-02-15,1946,Stoke City,Chelsea,6-1,6,1,1,1,7,5,H
1947-02-19,1946,Bolton Wanderers,Charlton Athletic,0-1,0,1,1,1,1,-1,A
1947-02-22,1946,Bolton Wanderers,Everton,0-2,0,2,1,1,2,-2,A
1947-02-22,1946,Charlton Athletic,Aston Villa,1-1,1,1,1,1,2,0,D
1947-02-22,1946,Leeds United,Wolverhampton Wanderers,0-1,0,1,1,1,1,-1,A
1947-02-22,1946,Liverpool,Huddersfield Town,1-0,1,0,1,1,1,1,H
1947-02-22,1946,Manchester United,Blackpool,3-0,3,0,1,1,3,3,H
1947-02-22,1946,Middlesbrough,Derby County,1-0,1,0,1,1,1,1,H
1947-02-22,1946,Preston North End,Brentford,5-2,5,2,1,1,7,3,H
1947-02-22,1946,Sheffield United,Blackburn Rovers,0-1,0,1,1,1,1,-1,A
1947-02-22,1946,Stoke City,Arsenal,3-1,3,1,1,1,4,2,H
1947-03-01,1946,Arsenal,Chelsea,1-2,1,2,1,1,3,-1,A
1947-03-01,1946,Blackburn Rovers,Leeds United,1-0,1,0,1,1,1,1,H
1947-03-01,1946,Blackpool,Bolton Wanderers,0-1,0,1,1,1,1,-1,A
1947-03-01,1946,Derby County,Brentford,2-1,2,1,1,1,3,1,H
1947-03-01,1946,Portsmouth,Grimsby Town,4-1,4,1,1,1,5,3,H
1947-03-01,1946,Sunderland,Manchester United,1-1,1,1,1,1,2,0,D
1947-03-01,1946,Wolverhampton Wanderers,Stoke City,3-0,3,0,1,1,3,3,H
1947-03-08,1946,Charlton Athletic,Huddersfield Town,0-3,0,3,1,1,3,-3,A
1947-03-08,1946,Chelsea,Blackpool,1-4,1,4,1,1,5,-3,A
1947-03-08,1946,Grimsby Town,Everton,2-2,2,2,1,1,4,0,D
1947-03-08,1946,Liverpool,Blackburn Rovers,2-1,2,1,1,1,3,1,H
1947-03-08,1946,Manchester United,Aston Villa,2-1,2,1,1,1,3,1,H
1947-03-08,1946,Middlesbrough,Wolverhampton Wanderers,1-1,1,1,1,1,2,0,D
1947-03-15,1946,Arsenal,Preston North End,4-1,4,1,1,1,5,3,H
1947-03-15,1946,Blackburn Rovers,Bolton Wanderers,2-1,2,1,1,1,3,1,H
1947-03-15,1946,Blackpool,Sheffield United,4-2,4,2,1,1,6,2,H
1947-03-15,1946,Brentford,Chelsea,0-2,0,2,1,1,2,-2,A
1947-03-15,1946,Derby County,Manchester United,4-3,4,3,1,1,7,1,H
1947-03-15,1946,Huddersfield Town,Grimsby Town,3-2,3,2,1,1,5,1,H
1947-03-15,1946,Portsmouth,Liverpool,1-2,1,2,1,1,3,-1,A
1947-03-15,1946,Sunderland,Middlesbrough,1-0,1,0,1,1,1,1,H
1947-03-15,1946,Wolverhampton Wanderers,Charlton Athletic,2-0,2,0,1,1,2,2,H
1947-03-22,1946,Bolton Wanderers,Aston Villa,2-1,2,1,1,1,3,1,H
1947-03-22,1946,Charlton Athletic,Brentford,3-0,3,0,1,1,3,3,H
1947-03-22,1946,Chelsea,Sunderland,2-1,2,1,1,1,3,1,H
1947-03-22,1946,Grimsby Town,Blackpool,2-3,2,3,1,1,5,-1,A
1947-03-22,1946,Leeds United,Arsenal,1-1,1,1,1,1,2,0,D
1947-03-22,1946,Liverpool,Derby County,1-1,1,1,1,1,2,0,D
1947-03-22,1946,Manchester United,Everton,3-0,3,0,1,1,3,3,H
1947-03-22,1946,Middlesbrough,Blackburn Rovers,0-1,0,1,1,1,1,-1,A
1947-03-22,1946,Preston North End,Huddersfield Town,6-2,6,2,1,1,8,4,H
1947-03-22,1946,Sheffield United,Wolverhampton Wanderers,2-0,2,0,1,1,2,2,H
1947-03-22,1946,Stoke City,Portsmouth,1-1,1,1,1,1,2,0,D
1947-03-29,1946,Aston Villa,Chelsea,2-0,2,0,1,1,2,2,H
1947-03-29,1946,Blackpool,Leeds United,3-0,3,0,1,1,3,3,H
1947-03-29,1946,Brentford,Grimsby Town,0-1,0,1,1,1,1,-1,A
1947-03-29,1946,Derby County,Bolton Wanderers,1-3,1,3,1,1,4,-2,A
1947-03-29,1946,Everton,Stoke City,2-2,2,2,1,1,4,0,D
1947-03-29,1946,Huddersfield Town,Manchester United,2-2,2,2,1,1,4,0,D
1947-03-29,1946,Portsmouth,Middlesbrough,3-1,3,1,1,1,4,2,H
1947-03-29,1946,Sunderland,Sheffield United,2-1,2,1,1,1,3,1,H
1947-03-29,1946,Wolverhampton Wanderers,Preston North End,4-1,4,1,1,1,5,3,H
1947-04-04,1946,Arsenal,Huddersfield Town,1-2,1,2,1,1,3,-1,A
1947-04-04,1946,Bolton Wanderers,Sheffield United,3-2,3,2,1,1,5,1,H
1947-04-04,1946,Brentford,Portsmouth,1-3,1,3,1,1,4,-2,A
1947-04-04,1946,Charlton Athletic,Middlesbrough,3-3,3,3,1,1,6,0,D
1947-04-04,1946,Chelsea,Blackburn Rovers,0-2,0,2,1,1,2,-2,A
1947-04-04,1946,Everton,Blackpool,1-1,1,1,1,1,2,0,D
1947-04-04,1946,Grimsby Town,Stoke City,2-5,2,5,1,1,7,-3,A
1947-04-04,1946,Preston North End,Liverpool,0-0,0,0,1,1,0,0,D
1947-04-04,1946,Sunderland,Aston Villa,4-1,4,1,1,1,5,3,H
1947-04-05,1946,Bolton Wanderers,Arsenal,1-3,1,3,1,1,4,-2,A
1947-04-05,1946,Charlton Athletic,Portsmouth,0-0,0,0,1,1,0,0,D
1947-04-05,1946,Chelsea,Derby County,3-0,3,0,1,1,3,3,H
1947-04-05,1946,Grimsby Town,Blackburn Rovers,2-1,2,1,1,1,3,1,H
1947-04-05,1946,Leeds United,Brentford,1-2,1,2,1,1,3,-1,A
1947-04-05,1946,Liverpool,Blackpool,2-3,2,3,1,1,5,-1,A
1947-04-05,1946,Manchester United,Wolverhampton Wanderers,3-1,3,1,1,1,4,2,H
1947-04-05,1946,Middlesbrough,Everton,4-0,4,0,1,1,4,4,H
1947-04-05,1946,Preston North End,Sunderland,2-2,2,2,1,1,4,0,D
1947-04-05,1946,Sheffield United,Aston Villa,1-2,1,2,1,1,3,-1,A
1947-04-05,1946,Stoke City,Huddersfield Town,3-0,3,0,1,1,3,3,H
1947-04-07,1946,Blackburn Rovers,Chelsea,1-2,1,2,1,1,3,-1,A
1947-04-07,1946,Blackpool,Everton,0-3,0,3,1,1,3,-3,A
1947-04-07,1946,Derby County,Wolverhampton Wanderers,2-1,2,1,1,1,3,1,H
1947-04-07,1946,Huddersfield Town,Arsenal,0-0,0,0,1,1,0,0,D
1947-04-07,1946,Liverpool,Preston North End,3-0,3,0,1,1,3,3,H
1947-04-07,1946,Manchester United,Leeds United,3-1,3,1,1,1,4,2,H
1947-04-07,1946,Middlesbrough,Charlton Athletic,1-2,1,2,1,1,3,-1,A
1947-04-07,1946,Portsmouth,Brentford,3-0,3,0,1,1,3,3,H
1947-04-07,1946,Sheffield United,Bolton Wanderers,4-2,4,2,1,1,6,2,H
1947-04-07,1946,Stoke City,Grimsby Town,3-0,3,0,1,1,3,3,H
1947-04-08,1946,Aston Villa,Sunderland,4-0,4,0,1,1,4,4,H
1947-04-08,1946,Leeds United,Manchester United,0-2,0,2,1,1,2,-2,A
1947-04-08,1946,Wolverhampton Wanderers,Derby County,7-2,7,2,1,1,9,5,H
1947-04-12,1946,Arsenal,Middlesbrough,4-0,4,0,1,1,4,4,H
1947-04-12,1946,Aston Villa,Grimsby Town,3-3,3,3,1,1,6,0,D
1947-04-12,1946,Blackburn Rovers,Preston North End,1-2,1,2,1,1,3,-1,A
1947-04-12,1946,Blackpool,Stoke City,0-2,0,2,1,1,2,-2,A
1947-04-12,1946,Brentford,Manchester United,0-0,0,0,1,1,0,0,D
1947-04-12,1946,Derby County,Charlton Athletic,1-0,1,0,1,1,1,1,H
1947-04-12,1946,Everton,Chelsea,2-0,2,0,1,1,2,2,H
1947-04-12,1946,Huddersfield Town,Bolton Wanderers,1-0,1,0,1,1,1,1,H
1947-04-12,1946,Portsmouth,Sheffield United,0-0,0,0,1,1,0,0,D
1947-04-12,1946,Sunderland,Leeds United,1-0,1,0,1,1,1,1,H
1947-04-19,1946,Bolton Wanderers,Wolverhampton Wanderers,0-3,0,3,1,1,3,-3,A
1947-04-19,1946,Charlton Athletic,Arsenal,2-2,2,2,1,1,4,0,D
1947-04-19,1946,Chelsea,Huddersfield Town,1-0,1,0,1,1,1,1,H
1947-04-19,1946,Grimsby Town,Derby County,2-0,2,0,1,1,2,2,H
1947-04-19,1946,Leeds United,Aston Villa,1-1,1,1,1,1,2,0,D
1947-04-19,1946,Liverpool,Sunderland,1-0,1,0,1,1,1,1,H
1947-04-19,1946,Manchester United,Blackburn Rovers,4-0,4,0,1,1,4,4,H
1947-04-19,1946,Middlesbrough,Blackpool,1-2,1,2,1,1,3,-1,A
1947-04-19,1946,Preston North End,Portsmouth,1-1,1,1,1,1,2,0,D
1947-04-19,1946,Sheffield United,Everton,2-0,2,0,1,1,2,2,H
1947-04-19,1946,Stoke City,Brentford,3-1,3,1,1,1,4,2,H
1947-04-26,1946,Arsenal,Grimsby Town,5-3,5,3,1,1,8,2,H
1947-04-26,1946,Aston Villa,Liverpool,1-2,1,2,1,1,3,-1,A
1947-04-26,1946,Blackburn Rovers,Stoke City,0-2,0,2,1,1,2,-2,A
1947-04-26,1946,Brentford,Middlesbrough,0-0,0,0,1,1,0,0,D
1947-04-26,1946,Derby County,Leeds United,2-1,2,1,1,1,3,1,H
1947-04-26,1946,Everton,Preston North End,2-0,2,0,1,1,2,2,H
1947-04-26,1946,Huddersfield Town,Sheffield United,1-1,1,1,1,1,2,0,D
1947-04-26,1946,Portsmouth,Manchester United,0-1,0,1,1,1,1,-1,A
1947-04-26,1946,Sunderland,Bolton Wanderers,3-1,3,1,1,1,4,2,H
1947-04-26,1946,Wolverhampton Wanderers,Chelsea,6-4,6,4,1,1,10,2,H
1947-05-03,1946,Brentford,Blackburn Rovers,0-3,0,3,1,1,3,-3,A
1947-05-03,1946,Chelsea,Sheffield United,1-4,1,4,1,1,5,-3,A
1947-05-03,1946,Derby County,Huddersfield Town,1-0,1,0,1,1,1,1,H
1947-05-03,1946,Grimsby Town,Middlesbrough,4-0,4,0,1,1,4,4,H
1947-05-03,1946,Leeds United,Stoke City,1-2,1,2,1,1,3,-1,A
1947-05-03,1946,Liverpool,Manchester United,1-0,1,0,1,1,1,1,H
1947-05-03,1946,Portsmouth,Wolverhampton Wanderers,1-1,1,1,1,1,2,0,D
1947-05-03,1946,Sunderland,Charlton Athletic,1-1,1,1,1,1,2,0,D
1947-05-10,1946,Aston Villa,Blackburn Rovers,2-1,2,1,1,1,3,1,H
1947-05-10,1946,Bolton Wanderers,Brentford,1-0,1,0,1,1,1,1,H
1947-05-10,1946,Charlton Athletic,Liverpool,1-3,1,3,1,1,4,-2,A
1947-05-10,1946,Chelsea,Middlesbrough,2-0,2,0,1,1,2,2,H
1947-05-10,1946,Derby County,Arsenal,0-1,0,1,1,1,1,-1,A
1947-05-10,1946,Grimsby Town,Sunderland,1-2,1,2,1,1,3,-1,A
1947-05-10,1946,Huddersfield Town,Leeds United,1-0,1,0,1,1,1,1,H
1947-05-10,1946,Preston North End,Manchester United,1-1,1,1,1,1,2,0,D
1947-05-10,1946,Sheffield United,Portsmouth,3-1,3,1,1,1,4,2,H
1947-05-10,1946,Wolverhampton Wanderers,Everton,2-3,2,3,1,1,5,-1,A
1947-05-17,1946,Aston Villa,Preston North End,4-2,4,2,1,1,6,2,H
1947-05-17,1946,Blackpool,Charlton Athletic,0-0,0,0,1,1,0,0,D
1947-05-17,1946,Brentford,Liverpool,1-1,1,1,1,1,2,0,D
1947-05-17,1946,Derby County,Sheffield United,1-2,1,2,1,1,3,-1,A
1947-05-17,1946,Grimsby Town,Leeds United,4-1,4,1,1,1,5,3,H
1947-05-17,1946,Huddersfield Town,Middlesbrough,3-1,3,1,1,1,4,2,H
1947-05-17,1946,Manchester United,Portsmouth,3-0,3,0,1,1,3,3,H
1947-05-17,1946,Stoke City,Sunderland,0-0,0,0,1,1,0,0,D
1947-05-17,1946,Wolverhampton Wanderers,Blackburn Rovers,3-3,3,3,1,1,6,0,D
1947-05-24,1946,Arsenal,Liverpool,1-2,1,2,1,1,3,-1,A
1947-05-24,1946,Everton,Charlton Athletic,1-1,1,1,1,1,2,0,D
1947-05-24,1946,Leeds United,Portsmouth,0-1,0,1,1,1,1,-1,A
1947-05-24,1946,Sheffield United,Preston North End,2-3,2,3,1,1,5,-1,A
1947-05-24,1946,Sunderland,Brentford,2-1,2,1,1,1,3,1,H
1947-05-26,1946,Aston Villa,Stoke City,0-1,0,1,1,1,1,-1,A
1947-05-26,1946,Blackburn Rovers,Charlton Athletic,1-0,1,0,1,1,1,1,H
1947-05-26,1946,Brentford,Arsenal,0-1,0,1,1,1,1,-1,A
1947-05-26,1946,Chelsea,Portsmouth,0-3,0,3,1,1,3,-3,A
1947-05-26,1946,Everton,Leeds United,4-1,4,1,1,1,5,3,H
1947-05-26,1946,Huddersfield Town,Wolverhampton Wanderers,0-1,0,1,1,1,1,-1,A
1947-05-26,1946,Manchester United,Sheffield United,6-2,6,2,1,1,8,4,H
1947-05-26,1946,Preston North End,Derby County,1-1,1,1,1,1,2,0,D
1947-05-31,1946,Arsenal,Everton,2-1,2,1,1,1,3,1,H
1947-05-31,1946,Portsmouth,Derby County,1-2,1,2,1,1,3,-1,A
1947-05-31,1946,Sheffield United,Charlton Athletic,1-3,1,3,1,1,4,-2,A
1947-05-31,1946,Wolverhampton Wanderers,Liverpool,1-2,1,2,1,1,3,-1,A
1947-06-07,1946,Sheffield United,Arsenal,2-1,2,1,1,1,3,1,H
1947-06-14,1946,Sheffield United,Stoke City,2-1,2,1,1,1,3,1,H
1947-08-23,1947,Arsenal,Sunderland,3-1,3,1,1,1,4,2,H
1947-08-23,1947,Blackburn Rovers,Everton,2-3,2,3,1,1,5,-1,A
1947-08-23,1947,Blackpool,Chelsea,3-0,3,0,1,1,3,3,H
1947-08-23,1947,Bolton Wanderers,Stoke City,0-1,0,1,1,1,1,-1,A
1947-08-23,1947,Charlton Athletic,Sheffield United,4-0,4,0,1,1,4,4,H
1947-08-23,1947,Derby County,Huddersfield Town,0-0,0,0,1,1,0,0,D
1947-08-23,1947,Grimsby Town,Aston Villa,3-0,3,0,1,1,3,3,H
1947-08-23,1947,Liverpool,Preston North End,3-1,3,1,1,1,4,2,H
1947-08-23,1947,Manchester City,Wolverhampton Wanderers,4-3,4,3,1,1,7,1,H
1947-08-23,1947,Middlesbrough,Manchester United,2-2,2,2,1,1,4,0,D
1947-08-23,1947,Portsmouth,Burnley,0-1,0,1,1,1,1,-1,A
1947-08-25,1947,Preston North End,Bolton Wanderers,1-0,1,0,1,1,1,1,H
1947-08-25,1947,Sheffield United,Middlesbrough,1-1,1,1,1,1,2,0,D
1947-08-25,1947,Stoke City,Portsmouth,2-1,2,1,1,1,3,1,H
1947-08-26,1947,Burnley,Derby County,0-2,0,2,1,1,2,-2,A
1947-08-27,1947,Charlton Athletic,Arsenal,2-4,2,4,1,1,6,-2,A
1947-08-27,1947,Chelsea,Blackburn Rovers,1-0,1,0,1,1,1,1,H
1947-08-27,1947,Everton,Manchester City,1-0,1,0,1,1,1,1,H
1947-08-27,1947,Huddersfield Town,Blackpool,2-0,2,0,1,1,2,2,H
1947-08-27,1947,Manchester United,Liverpool,2-0,2,0,1,1,2,2,H
1947-08-27,1947,Sunderland,Aston Villa,0-0,0,0,1,1,0,0,D
1947-08-27,1947,Wolverhampton Wanderers,Grimsby Town,8-1,8,1,1,1,9,7,H
1947-08-30,1947,Aston Villa,Manchester City,1-1,1,1,1,1,2,0,D
1947-08-30,1947,Burnley,Bolton Wanderers,2-0,2,0,1,1,2,2,H
1947-08-30,1947,Chelsea,Derby County,1-0,1,0,1,1,1,1,H
1947-08-30,1947,Everton,Blackpool,1-2,1,2,1,1,3,-1,A
1947-08-30,1947,Huddersfield Town,Portsmouth,0-2,0,2,1,1,2,-2,A
1947-08-30,1947,Manchester United,Charlton Athletic,6-2,6,2,1,1,8,4,H
1947-08-30,1947,Preston North End,Middlesbrough,2-1,2,1,1,1,3,1,H
1947-08-30,1947,Sheffield United,Arsenal,1-2,1,2,1,1,3,-1,A
1947-08-30,1947,Stoke City,Liverpool,0-2,0,2,1,1,2,-2,A
1947-08-30,1947,Sunderland,Grimsby Town,4-2,4,2,1,1,6,2,H
1947-08-30,1947,Wolverhampton Wanderers,Blackburn Rovers,5-1,5,1,1,1,6,4,H
1947-09-01,1947,Aston Villa,Sunderland,2-0,2,0,1,1,2,2,H
1947-09-01,1947,Blackpool,Huddersfield Town,4-0,4,0,1,1,4,4,H
1947-09-01,1947,Bolton Wanderers,Preston North End,1-2,1,2,1,1,3,-1,A
1947-09-03,1947,Arsenal,Charlton Athletic,6-0,6,0,1,1,6,6,H
1947-09-03,1947,Derby County,Burnley,1-1,1,1,1,1,2,0,D
1947-09-03,1947,Grimsby Town,Wolverhampton Wanderers,0-4,0,4,1,1,4,-4,A
1947-09-03,1947,Liverpool,Manchester United,2-2,2,2,1,1,4,0,D
1947-09-03,1947,Manchester City,Everton,0-1,0,1,1,1,1,-1,A
1947-09-03,1947,Middlesbrough,Sheffield United,3-0,3,0,1,1,3,3,H
1947-09-03,1947,Portsmouth,Stoke City,3-0,3,0,1,1,3,3,H
1947-09-06,1947,Arsenal,Manchester United,2-1,2,1,1,1,3,1,H
1947-09-06,1947,Blackburn Rovers,Aston Villa,0-0,0,0,1,1,0,0,D
1947-09-06,1947,Blackpool,Wolverhampton Wanderers,2-2,2,2,1,1,4,0,D
1947-09-06,1947,Bolton Wanderers,Portsmouth,4-0,4,0,1,1,4,4,H
1947-09-06,1947,Charlton Athletic,Preston North End,1-2,1,2,1,1,3,-1,A
1947-09-06,1947,Derby County,Everton,1-0,1,0,1,1,1,1,H
1947-09-06,1947,Grimsby Town,Sheffield United,0-3,0,3,1,1,3,-3,A
1947-09-06,1947,Huddersfield Town,Chelsea,3-1,3,1,1,1,4,2,H
1947-09-06,1947,Liverpool,Burnley,1-1,1,1,1,1,2,0,D
1947-09-06,1947,Manchester City,Sunderland,3-0,3,0,1,1,3,3,H
1947-09-06,1947,Middlesbrough,Stoke City,2-1,2,1,1,1,3,1,H
1947-09-08,1947,Aston Villa,Everton,3-0,3,0,1,1,3,3,H
1947-09-08,1947,Blackpool,Blackburn Rovers,1-0,1,0,1,1,1,1,H
1947-09-08,1947,Burnley,Manchester United,0-0,0,0,1,1,0,0,D
1947-09-08,1947,Sheffield United,Liverpool,3-1,3,1,1,1,4,2,H
1947-09-08,1947,Stoke City,Preston North End,0-1,0,1,1,1,1,-1,A
1947-09-10,1947,Arsenal,Bolton Wanderers,2-0,2,0,1,1,2,2,H
1947-09-10,1947,Chelsea,Sunderland,1-1,1,1,1,1,2,0,D
1947-09-10,1947,Derby County,Manchester City,0-0,0,0,1,1,0,0,D
1947-09-10,1947,Huddersfield Town,Grimsby Town,5-1,5,1,1,1,6,4,H
1947-09-10,1947,Wolverhampton Wanderers,Middlesbrough,1-3,1,3,1,1,4,-2,A
1947-09-13,1947,Aston Villa,Blackpool,0-1,0,1,1,1,1,-1,A
1947-09-13,1947,Burnley,Middlesbrough,3-0,3,0,1,1,3,3,H
1947-09-13,1947,Chelsea,Bolton Wanderers,1-1,1,1,1,1,2,0,D
1947-09-13,1947,Everton,Huddersfield Town,1-1,1,1,1,1,2,0,D
1947-09-13,1947,Grimsby Town,Manchester City,1-0,1,0,1,1,1,1,H
1947-09-13,1947,Manchester United,Sheffield United,0-1,0,1,1,1,1,-1,A
1947-09-13,1947,Portsmouth,Liverpool,1-0,1,0,1,1,1,1,H
1947-09-13,1947,Preston North End,Arsenal,0-0,0,0,1,1,0,0,D
1947-09-13,1947,Stoke City,Charlton Athletic,0-1,0,1,1,1,1,-1,A
1947-09-13,1947,Sunderland,Blackburn Rovers,0-1,0,1,1,1,1,-1,A
1947-09-13,1947,Wolverhampton Wanderers,Derby County,1-0,1,0,1,1,1,1,H
1947-09-15,1947,Blackburn Rovers,Blackpool,1-1,1,1,1,1,2,0,D
1947-09-17,1947,Charlton Athletic,Liverpool,2-0,2,0,1,1,2,2,H
1947-09-17,1947,Everton,Aston Villa,3-0,3,0,1,1,3,3,H
1947-09-17,1947,Grimsby Town,Huddersfield Town,3-0,3,0,1,1,3,3,H
1947-09-17,1947,Manchester City,Derby County,3-2,3,2,1,1,5,1,H
1947-09-17,1947,Portsmouth,Sheffield United,6-0,6,0,1,1,6,6,H
1947-09-17,1947,Preston North End,Stoke City,2-1,2,1,1,1,3,1,H
1947-09-17,1947,Sunderland,Chelsea,2-3,2,3,1,1,5,-1,A
1947-09-20,1947,Arsenal,Stoke City,3-0,3,0,1,1,3,3,H
1947-09-20,1947,Blackburn Rovers,Grimsby Town,4-0,4,0,1,1,4,4,H
1947-09-20,1947,Blackpool,Sunderland,0-1,0,1,1,1,1,-1,A
1947-09-20,1947,Charlton Athletic,Burnley,1-1,1,1,1,1,2,0,D
1947-09-20,1947,Chelsea,Everton,3-1,3,1,1,1,4,2,H
1947-09-20,1947,Derby County,Aston Villa,1-3,1,3,1,1,4,-2,A
1947-09-20,1947,Huddersfield Town,Wolverhampton Wanderers,0-1,0,1,1,1,1,-1,A
1947-09-20,1947,Liverpool,Bolton Wanderers,0-0,0,0,1,1,0,0,D
1947-09-20,1947,Manchester City,Manchester United,0-0,0,0,1,1,0,0,D
1947-09-20,1947,Middlesbrough,Portsmouth,1-2,1,2,1,1,3,-1,A
1947-09-20,1947,Sheffield United,Preston North End,3-1,3,1,1,1,4,2,H
1947-09-27,1947,Aston Villa,Huddersfield Town,2-1,2,1,1,1,3,1,H
1947-09-27,1947,Bolton Wanderers,Middlesbrough,1-3,1,3,1,1,4,-2,A
1947-09-27,1947,Burnley,Arsenal,0-1,0,1,1,1,1,-1,A
1947-09-27,1947,Everton,Liverpool,0-3,0,3,1,1,3,-3,A
1947-09-27,1947,Grimsby Town,Blackpool,0-1,0,1,1,1,1,-1,A
1947-09-27,1947,Manchester City,Blackburn Rovers,1-3,1,3,1,1,4,-2,A
1947-09-27,1947,Portsmouth,Charlton Athletic,3-1,3,1,1,1,4,2,H
1947-09-27,1947,Preston North End,Manchester United,2-1,2,1,1,1,3,1,H
1947-09-27,1947,Stoke City,Sheffield United,1-1,1,1,1,1,2,0,D
1947-09-27,1947,Sunderland,Derby County,1-1,1,1,1,1,2,0,D
1947-09-27,1947,Wolverhampton Wanderers,Chelsea,1-0,1,0,1,1,1,1,H
1947-10-04,1947,Arsenal,Portsmouth,0-0,0,0,1,1,0,0,D
1947-10-04,1947,Blackburn Rovers,Preston North End,2-3,2,3,1,1,5,-1,A
1947-10-04,1947,Blackpool,Manchester City,1-1,1,1,1,1,2,0,D
1947-10-04,1947,Charlton Athletic,Bolton Wanderers,2-1,2,1,1,1,3,1,H
1947-10-04,1947,Chelsea,Aston Villa,4-2,4,2,1,1,6,2,H
1947-10-04,1947,Derby County,Grimsby Town,4-1,4,1,1,1,5,3,H
1947-10-04,1947,Everton,Wolverhampton Wanderers,1-1,1,1,1,1,2,0,D
1947-10-04,1947,Huddersfield Town,Sunderland,2-2,2,2,1,1,4,0,D
1947-10-04,1947,Manchester United,Stoke City,1-1,1,1,1,1,2,0,D
1947-10-04,1947,Middlesbrough,Liverpool,3-1,3,1,1,1,4,2,H
1947-10-04,1947,Sheffield United,Burnley,1-1,1,1,1,1,2,0,D
1947-10-11,1947,Arsenal,Aston Villa,1-0,1,0,1,1,1,1,H
1947-10-11,1947,Bolton Wanderers,Huddersfield Town,1-5,1,5,1,1,6,-4,A
1947-10-11,1947,Burnley,Blackpool,1-0,1,0,1,1,1,1,H
1947-10-11,1947,Charlton Athletic,Wolverhampton Wanderers,5-1,5,1,1,1,6,4,H
1947-10-11,1947,Liverpool,Chelsea,3-0,3,0,1,1,3,3,H
1947-10-11,1947,Manchester United,Grimsby Town,3-4,3,4,1,1,7,-1,A
1947-10-11,1947,Middlesbrough,Everton,0-1,0,1,1,1,1,-1,A
1947-10-11,1947,Portsmouth,Derby County,0-0,0,0,1,1,0,0,D
1947-10-11,1947,Preston North End,Manchester City,2-1,2,1,1,1,3,1,H
1947-10-11,1947,Sheffield United,Sunderland,3-2,3,2,1,1,5,1,H
1947-10-11,1947,Stoke City,Blackburn Rovers,2-1,2,1,1,1,3,1,H
1947-10-18,1947,Aston Villa,Sheffield United,2-0,2,0,1,1,2,2,H
1947-10-18,1947,Blackburn Rovers,Burnley,1-2,1,2,1,1,3,-1,A
1947-10-18,1947,Blackpool,Portsmouth,1-0,1,0,1,1,1,1,H
1947-10-18,1947,Chelsea,Middlesbrough,4-2,4,2,1,1,6,2,H
1947-10-18,1947,Derby County,Bolton Wanderers,2-1,2,1,1,1,3,1,H
1947-10-18,1947,Everton,Charlton Athletic,0-1,0,1,1,1,1,-1,A
1947-10-18,1947,Grimsby Town,Preston North End,1-1,1,1,1,1,2,0,D
1947-10-18,1947,Huddersfield Town,Liverpool,1-1,1,1,1,1,2,0,D
1947-10-18,1947,Manchester City,Stoke City,3-0,3,0,1,1,3,3,H
1947-10-18,1947,Sunderland,Manchester United,1-0,1,0,1,1,1,1,H
1947-10-18,1947,Wolverhampton Wanderers,Arsenal,1-1,1,1,1,1,2,0,D
1947-10-25,1947,Arsenal,Everton,1-1,1,1,1,1,2,0,D
1947-10-25,1947,Bolton Wanderers,Blackpool,1-0,1,0,1,1,1,1,H
1947-10-25,1947,Burnley,Manchester City,1-1,1,1,1,1,2,0,D
1947-10-25,1947,Charlton Athletic,Chelsea,3-1,3,1,1,1,4,2,H
1947-10-25,1947,Liverpool,Derby County,2-2,2,2,1,1,4,0,D
1947-10-25,1947,Manchester United,Aston Villa,2-0,2,0,1,1,2,2,H
1947-10-25,1947,Middlesbrough,Huddersfield Town,1-0,1,0,1,1,1,1,H
1947-10-25,1947,Portsmouth,Blackburn Rovers,1-1,1,1,1,1,2,0,D
1947-10-25,1947,Preston North End,Sunderland,2-2,2,2,1,1,4,0,D
1947-10-25,1947,Sheffield United,Wolverhampton Wanderers,2-2,2,2,1,1,4,0,D
1947-10-25,1947,Stoke City,Grimsby Town,2-1,2,1,1,1,3,1,H
1947-11-01,1947,Aston Villa,Preston North End,4-1,4,1,1,1,5,3,H
1947-11-01,1947,Blackburn Rovers,Bolton Wanderers,4-0,4,0,1,1,4,4,H
1947-11-01,1947,Blackpool,Liverpool,2-0,2,0,1,1,2,2,H
1947-11-01,1947,Chelsea,Arsenal,0-0,0,0,1,1,0,0,D
1947-11-01,1947,Derby County,Middlesbrough,4-2,4,2,1,1,6,2,H
1947-11-01,1947,Everton,Sheffield United,2-0,2,0,1,1,2,2,H
1947-11-01,1947,Grimsby Town,Burnley,1-2,1,2,1,1,3,-1,A
1947-11-01,1947,Huddersfield Town,Charlton Athletic,0-1,0,1,1,1,1,-1,A
1947-11-01,1947,Manchester City,Portsmouth,1-0,1,0,1,1,1,1,H
1947-11-01,1947,Sunderland,Stoke City,1-0,1,0,1,1,1,1,H
1947-11-01,1947,Wolverhampton Wanderers,Manchester United,2-6,2,6,1,1,8,-4,A
1947-11-08,1947,Arsenal,Blackpool,2-1,2,1,1,1,3,1,H
1947-11-08,1947,Bolton Wanderers,Sunderland,3-1,3,1,1,1,4,2,H
1947-11-08,1947,Burnley,Wolverhampton Wanderers,1-1,1,1,1,1,2,0,D
1947-11-08,1947,Charlton Athletic,Blackburn Rovers,0-1,0,1,1,1,1,-1,A
1947-11-08,1947,Liverpool,Grimsby Town,3-1,3,1,1,1,4,2,H
1947-11-08,1947,Manchester United,Huddersfield Town,4-4,4,4,1,1,8,0,D
1947-11-08,1947,Middlesbrough,Manchester City,2-1,2,1,1,1,3,1,H
1947-11-08,1947,Portsmouth,Aston Villa,2-4,2,4,1,1,6,-2,A
1947-11-08,1947,Preston North End,Chelsea,2-0,2,0,1,1,2,2,H
1947-11-08,1947,Sheffield United,Derby County,1-2,1,2,1,1,3,-1,A
1947-11-08,1947,Stoke City,Everton,1-1,1,1,1,1,2,0,D
1947-11-15,1947,Aston Villa,Bolton Wanderers,3-1,3,1,1,1,4,2,H
1947-11-15,1947,Blackburn Rovers,Arsenal,0-1,0,1,1,1,1,-1,A
1947-11-15,1947,Blackpool,Sheffield United,2-1,2,1,1,1,3,1,H
1947-11-15,1947,Chelsea,Stoke City,4-1,4,1,1,1,5,3,H
1947-11-15,1947,Derby County,Manchester United,1-1,1,1,1,1,2,0,D
1947-11-15,1947,Everton,Burnley,0-3,0,3,1,1,3,-3,A
1947-11-15,1947,Grimsby Town,Middlesbrough,0-5,0,5,1,1,5,-5,A
1947-11-15,1947,Huddersfield Town,Preston North End,1-0,1,0,1,1,1,1,H
1947-11-15,1947,Manchester City,Charlton Athletic,4-0,4,0,1,1,4,4,H
1947-11-15,1947,Sunderland,Liverpool,5-1,5,1,1,1,6,4,H
1947-11-15,1947,Wolverhampton Wanderers,Portsmouth,3-1,3,1,1,1,4,2,H
1947-11-22,1947,Arsenal,Huddersfield Town,2-0,2,0,1,1,2,2,H
1947-11-22,1947,Bolton Wanderers,Manchester City,2-1,2,1,1,1,3,1,H
1947-11-22,1947,Burnley,Sunderland,4-0,4,0,1,1,4,4,H
1947-11-22,1947,Charlton Athletic,Derby County,1-5,1,5,1,1,6,-4,A
1947-11-22,1947,Liverpool,Blackburn Rovers,2-1,2,1,1,1,3,1,H
1947-11-22,1947,Manchester United,Everton,2-2,2,2,1,1,4,0,D
1947-11-22,1947,Middlesbrough,Blackpool,4-0,4,0,1,1,4,4,H
1947-11-22,1947,Portsmouth,Grimsby Town,4-0,4,0,1,1,4,4,H
1947-11-22,1947,Preston North End,Wolverhampton Wanderers,1-3,1,3,1,1,4,-2,A
1947-11-22,1947,Sheffield United,Chelsea,3-1,3,1,1,1,4,2,H
1947-11-22,1947,Stoke City,Aston Villa,1-2,1,2,1,1,3,-1,A
1947-11-29,1947,Aston Villa,Burnley,2-2,2,2,1,1,4,0,D
1947-11-29,1947,Blackburn Rovers,Middlesbrough,1-7,1,7,1,1,8,-6,A
1947-11-29,1947,Blackpool,Charlton Athletic,3-1,3,1,1,1,4,2,H
1947-11-29,1947,Chelsea,Manchester United,0-4,0,4,1,1,4,-4,A
1947-11-29,1947,Derby County,Arsenal,1-0,1,0,1,1,1,1,H
1947-11-29,1947,Everton,Preston North End,2-1,2,1,1,1,3,1,H
1947-11-29,1947,Grimsby Town,Bolton Wanderers,0-2,0,2,1,1,2,-2,A
1947-11-29,1947,Huddersfield Town,Sheffield United,2-1,2,1,1,1,3,1,H
1947-11-29,1947,Manchester City,Liverpool,2-0,2,0,1,1,2,2,H
1947-11-29,1947,Sunderland,Portsmouth,4-1,4,1,1,1,5,3,H
1947-11-29,1947,Wolverhampton Wanderers,Stoke City,1-2,1,2,1,1,3,-1,A
1947-12-06,1947,Arsenal,Manchester City,1-1,1,1,1,1,2,0,D
1947-12-06,1947,Bolton Wanderers,Wolverhampton Wanderers,3-2,3,2,1,1,5,1,H
1947-12-06,1947,Burnley,Chelsea,1-0,1,0,1,1,1,1,H
1947-12-06,1947,Charlton Athletic,Grimsby Town,2-3,2,3,1,1,5,-1,A
1947-12-06,1947,Liverpool,Aston Villa,3-3,3,3,1,1,6,0,D
1947-12-06,1947,Manchester United,Blackpool,1-1,1,1,1,1,2,0,D
1947-12-06,1947,Middlesbrough,Sunderland,2-2,2,2,1,1,4,0,D
1947-12-06,1947,Portsmouth,Everton,3-0,3,0,1,1,3,3,H
1947-12-06,1947,Preston North End,Derby County,7-4,7,4,1,1,11,3,H
1947-12-06,1947,Sheffield United,Blackburn Rovers,4-1,4,1,1,1,5,3,H
1947-12-06,1947,Stoke City,Huddersfield Town,1-1,1,1,1,1,2,0,D
1947-12-13,1947,Aston Villa,Middlesbrough,1-1,1,1,1,1,2,0,D
1947-12-13,1947,Blackburn Rovers,Manchester United,1-1,1,1,1,1,2,0,D
1947-12-13,1947,Blackpool,Preston North End,0-1,0,1,1,1,1,-1,A
1947-12-13,1947,Chelsea,Portsmouth,1-0,1,0,1,1,1,1,H
1947-12-13,1947,Derby County,Stoke City,1-1,1,1,1,1,2,0,D
1947-12-13,1947,Everton,Bolton Wanderers,2-0,2,0,1,1,2,2,H
1947-12-13,1947,Grimsby Town,Arsenal,0-4,0,4,1,1,4,-4,A
1947-12-13,1947,Huddersfield Town,Burnley,0-1,0,1,1,1,1,-1,A
1947-12-13,1947,Manchester City,Sheffield United,4-3,4,3,1,1,7,1,H
1947-12-13,1947,Sunderland,Charlton Athletic,0-1,0,1,1,1,1,-1,A
1947-12-13,1947,Wolverhampton Wanderers,Liverpool,1-2,1,2,1,1,3,-1,A
1947-12-20,1947,Aston Villa,Grimsby Town,2-2,2,2,1,1,4,0,D
1947-12-20,1947,Burnley,Portsmouth,3-2,3,2,1,1,5,1,H
1947-12-20,1947,Chelsea,Blackpool,2-2,2,2,1,1,4,0,D
1947-12-20,1947,Everton,Blackburn Rovers,4-1,4,1,1,1,5,3,H
1947-12-20,1947,Huddersfield Town,Derby County,2-1,2,1,1,1,3,1,H
1947-12-20,1947,Manchester United,Middlesbrough,2-1,2,1,1,1,3,1,H
1947-12-20,1947,Preston North End,Liverpool,3-3,3,3,1,1,6,0,D
1947-12-20,1947,Sheffield United,Charlton Athletic,1-1,1,1,1,1,2,0,D
1947-12-20,1947,Stoke City,Bolton Wanderers,2-0,2,0,1,1,2,2,H
1947-12-20,1947,Sunderland,Arsenal,1-1,1,1,1,1,2,0,D
1947-12-20,1947,Wolverhampton Wanderers,Manchester City,1-0,1,0,1,1,1,1,H
1947-12-25,1947,Blackburn Rovers,Derby County,3-4,3,4,1,1,7,-1,A
1947-12-25,1947,Blackpool,Stoke City,1-2,1,2,1,1,3,-1,A
1947-12-25,1947,Burnley,Preston North End,1-0,1,0,1,1,1,1,H
1947-12-25,1947,Charlton Athletic,Middlesbrough,1-0,1,0,1,1,1,1,H
1947-12-25,1947,Grimsby Town,Chelsea,0-0,0,0,1,1,0,0,D
1947-12-25,1947,Liverpool,Arsenal,1-3,1,3,1,1,4,-2,A
1947-12-25,1947,Manchester United,Portsmouth,3-2,3,2,1,1,5,1,H
1947-12-25,1947,Sheffield United,Bolton Wanderers,2-1,2,1,1,1,3,1,H
1947-12-25,1947,Sunderland,Everton,2-0,2,0,1,1,2,2,H
1947-12-26,1947,Aston Villa,Wolverhampton Wanderers,1-2,1,2,1,1,3,-1,A
1947-12-26,1947,Everton,Sunderland,3-0,3,0,1,1,3,3,H
1947-12-26,1947,Manchester City,Huddersfield Town,1-1,1,1,1,1,2,0,D
1947-12-26,1947,Preston North End,Burnley,3-2,3,2,1,1,5,1,H
1947-12-27,1947,Arsenal,Liverpool,1-2,1,2,1,1,3,-1,A
1947-12-27,1947,Bolton Wanderers,Sheffield United,2-3,2,3,1,1,5,-1,A
1947-12-27,1947,Chelsea,Grimsby Town,2-3,2,3,1,1,5,-1,A
1947-12-27,1947,Derby County,Blackburn Rovers,5-0,5,0,1,1,5,5,H
1947-12-27,1947,Huddersfield Town,Manchester City,1-1,1,1,1,1,2,0,D
1947-12-27,1947,Middlesbrough,Charlton Athletic,1-2,1,2,1,1,3,-1,A
1947-12-27,1947,Portsmouth,Manchester United,1-3,1,3,1,1,4,-2,A
1947-12-27,1947,Stoke City,Blackpool,1-1,1,1,1,1,2,0,D
1947-12-27,1947,Wolverhampton Wanderers,Aston Villa,4-1,4,1,1,1,5,3,H
1948-01-01,1947,Blackburn Rovers,Chelsea,1-1,1,1,1,1,2,0,D
1948-01-01,1947,Bolton Wanderers,Arsenal,0-1,0,1,1,1,1,-1,A
1948-01-01,1947,Liverpool,Charlton Athletic,2-3,2,3,1,1,5,-1,A
1948-01-01,1947,Manchester United,Burnley,5-0,5,0,1,1,5,5,H
1948-01-01,1947,Middlesbrough,Wolverhampton Wanderers,2-4,2,4,1,1,6,-2,A
1948-01-01,1947,Sheffield United,Portsmouth,1-2,1,2,1,1,3,-1,A
1948-01-03,1947,Arsenal,Sheffield United,3-2,3,2,1,1,5,1,H
1948-01-03,1947,Blackburn Rovers,Wolverhampton Wanderers,1-0,1,0,1,1,1,1,H
1948-01-03,1947,Blackpool,Everton,5-0,5,0,1,1,5,5,H
1948-01-03,1947,Bolton Wanderers,Burnley,1-1,1,1,1,1,2,0,D
1948-01-03,1947,Charlton Athletic,Manchester United,1-2,1,2,1,1,3,-1,A
1948-01-03,1947,Derby County,Chelsea,5-1,5,1,1,1,6,4,H
1948-01-03,1947,Grimsby Town,Sunderland,1-2,1,2,1,1,3,-1,A
1948-01-03,1947,Liverpool,Stoke City,0-0,0,0,1,1,0,0,D
1948-01-03,1947,Manchester City,Aston Villa,0-2,0,2,1,1,2,-2,A
1948-01-03,1947,Middlesbrough,Preston North End,1-1,1,1,1,1,2,0,D
1948-01-03,1947,Portsmouth,Huddersfield Town,3-2,3,2,1,1,5,1,H
1948-01-17,1947,Burnley,Liverpool,3-0,3,0,1,1,3,3,H
1948-01-17,1947,Chelsea,Huddersfield Town,2-4,2,4,1,1,6,-2,A
1948-01-17,1947,Everton,Derby County,1-3,1,3,1,1,4,-2,A
1948-01-17,1947,Manchester United,Arsenal,1-1,1,1,1,1,2,0,D
1948-01-17,1947,Portsmouth,Bolton Wanderers,2-0,2,0,1,1,2,2,H
1948-01-17,1947,Preston North End,Charlton Athletic,2-1,2,1,1,1,3,1,H
1948-01-17,1947,Sheffield United,Grimsby Town,4-0,4,0,1,1,4,4,H
1948-01-17,1947,Stoke City,Middlesbrough,2-4,2,4,1,1,6,-2,A
1948-01-17,1947,Sunderland,Manchester City,0-1,0,1,1,1,1,-1,A
1948-01-17,1947,Wolverhampton Wanderers,Blackpool,1-1,1,1,1,1,2,0,D
1948-01-24,1947,Sunderland,Bolton Wanderers,1-2,1,2,1,1,3,-1,A
1948-01-31,1947,Arsenal,Preston North End,3-0,3,0,1,1,3,3,H
1948-01-31,1947,Blackburn Rovers,Sunderland,4-3,4,3,1,1,7,1,H
1948-01-31,1947,Blackpool,Aston Villa,1-0,1,0,1,1,1,1,H
1948-01-31,1947,Bolton Wanderers,Chelsea,2-1,2,1,1,1,3,1,H
1948-01-31,1947,Charlton Athletic,Stoke City,0-1,0,1,1,1,1,-1,A
1948-01-31,1947,Liverpool,Portsmouth,0-3,0,3,1,1,3,-3,A
1948-01-31,1947,Manchester City,Grimsby Town,3-1,3,1,1,1,4,2,H
1948-01-31,1947,Middlesbrough,Burnley,1-2,1,2,1,1,3,-1,A
1948-01-31,1947,Sheffield United,Manchester United,2-1,2,1,1,1,3,1,H
1948-02-07,1947,Bolton Wanderers,Liverpool,3-0,3,0,1,1,3,3,H
1948-02-07,1947,Grimsby Town,Blackburn Rovers,2-2,2,2,1,1,4,0,D
1948-02-07,1947,Stoke City,Arsenal,0-0,0,0,1,1,0,0,D
1948-02-07,1947,Wolverhampton Wanderers,Huddersfield Town,2-1,2,1,1,1,3,1,H
1948-02-14,1947,Arsenal,Burnley,3-0,3,0,1,1,3,3,H
1948-02-14,1947,Blackburn Rovers,Manchester City,1-0,1,0,1,1,1,1,H
1948-02-14,1947,Blackpool,Grimsby Town,3-1,3,1,1,1,4,2,H
1948-02-14,1947,Charlton Athletic,Portsmouth,2-2,2,2,1,1,4,0,D
1948-02-14,1947,Chelsea,Wolverhampton Wanderers,1-1,1,1,1,1,2,0,D
1948-02-14,1947,Derby County,Sunderland,5-1,5,1,1,1,6,4,H
1948-02-14,1947,Huddersfield Town,Aston Villa,0-1,0,1,1,1,1,-1,A
1948-02-14,1947,Manchester United,Preston North End,1-1,1,1,1,1,2,0,D
1948-02-14,1947,Middlesbrough,Bolton Wanderers,4-1,4,1,1,1,5,3,H
1948-02-14,1947,Sheffield United,Stoke City,3-0,3,0,1,1,3,3,H
1948-02-21,1947,Aston Villa,Chelsea,3-0,3,0,1,1,3,3,H
1948-02-21,1947,Bolton Wanderers,Charlton Athletic,1-0,1,0,1,1,1,1,H
1948-02-21,1947,Burnley,Sheffield United,0-0,0,0,1,1,0,0,D
1948-02-21,1947,Grimsby Town,Derby County,2-3,2,3,1,1,5,-1,A
1948-02-21,1947,Liverpool,Middlesbrough,0-1,0,1,1,1,1,-1,A
1948-02-21,1947,Manchester City,Blackpool,1-0,1,0,1,1,1,1,H
1948-02-21,1947,Preston North End,Blackburn Rovers,2-1,2,1,1,1,3,1,H
1948-02-21,1947,Stoke City,Manchester United,0-2,0,2,1,1,2,-2,A
1948-02-21,1947,Sunderland,Huddersfield Town,2-0,2,0,1,1,2,2,H
1948-02-21,1947,Wolverhampton Wanderers,Everton,2-4,2,4,1,1,6,-2,A
1948-02-28,1947,Aston Villa,Arsenal,4-2,4,2,1,1,6,2,H
1948-02-28,1947,Blackburn Rovers,Stoke City,2-0,2,0,1,1,2,2,H
1948-02-28,1947,Chelsea,Liverpool,3-1,3,1,1,1,4,2,H
1948-02-28,1947,Everton,Middlesbrough,2-1,2,1,1,1,3,1,H
1948-02-28,1947,Huddersfield Town,Bolton Wanderers,1-2,1,2,1,1,3,-1,A
1948-02-28,1947,Sunderland,Sheffield United,1-1,1,1,1,1,2,0,D
1948-02-28,1947,Wolverhampton Wanderers,Charlton Athletic,2-0,2,0,1,1,2,2,H
1948-03-06,1947,Arsenal,Wolverhampton Wanderers,5-2,5,2,1,1,7,3,H
1948-03-06,1947,Burnley,Blackburn Rovers,0-0,0,0,1,1,0,0,D
1948-03-06,1947,Charlton Athletic,Everton,2-3,2,3,1,1,5,-1,A
1948-03-06,1947,Liverpool,Huddersfield Town,4-0,4,0,1,1,4,4,H
1948-03-06,1947,Manchester United,Sunderland,3-1,3,1,1,1,4,2,H
1948-03-06,1947,Middlesbrough,Chelsea,0-0,0,0,1,1,0,0,D
1948-03-06,1947,Portsmouth,Blackpool,1-1,1,1,1,1,2,0,D
1948-03-06,1947,Preston North End,Grimsby Town,2-1,2,1,1,1,3,1,H
1948-03-06,1947,Sheffield United,Aston Villa,3-1,3,1,1,1,4,2,H
1948-03-06,1947,Stoke City,Manchester City,3-0,3,0,1,1,3,3,H
1948-03-13,1947,Blackburn Rovers,Portsmouth,1-0,1,0,1,1,1,1,H
1948-03-13,1947,Chelsea,Charlton Athletic,3-0,3,0,1,1,3,3,H
1948-03-13,1947,Everton,Arsenal,0-2,0,2,1,1,2,-2,A
1948-03-13,1947,Grimsby Town,Stoke City,0-0,0,0,1,1,0,0,D
1948-03-13,1947,Huddersfield Town,Middlesbrough,2-1,2,1,1,1,3,1,H
1948-03-13,1947,Manchester City,Burnley,4-1,4,1,1,1,5,3,H
1948-03-13,1947,Sunderland,Preston North End,0-2,0,2,1,1,2,-2,A
1948-03-13,1947,Wolverhampton Wanderers,Sheffield United,1-1,1,1,1,1,2,0,D
1948-03-17,1947,Grimsby Town,Manchester United,1-1,1,1,1,1,2,0,D
1948-03-20,1947,Arsenal,Chelsea,0-2,0,2,1,1,2,-2,A
1948-03-20,1947,Bolton Wanderers,Blackburn Rovers,1-0,1,0,1,1,1,1,H
1948-03-20,1947,Burnley,Grimsby Town,4-1,4,1,1,1,5,3,H
1948-03-20,1947,Charlton Athletic,Huddersfield Town,0-0,0,0,1,1,0,0,D
1948-03-20,1947,Liverpool,Blackpool,2-0,2,0,1,1,2,2,H
1948-03-20,1947,Manchester United,Wolverhampton Wanderers,3-2,3,2,1,1,5,1,H
1948-03-20,1947,Middlesbrough,Derby County,1-1,1,1,1,1,2,0,D
1948-03-20,1947,Portsmouth,Manchester City,1-0,1,0,1,1,1,1,H
1948-03-20,1947,Preston North End,Aston Villa,3-0,3,0,1,1,3,3,H
1948-03-20,1947,Sheffield United,Everton,2-1,2,1,1,1,3,1,H
1948-03-20,1947,Stoke City,Sunderland,3-1,3,1,1,1,4,2,H
1948-03-22,1947,Aston Villa,Manchester United,0-1,0,1,1,1,1,-1,A
1948-03-26,1947,Arsenal,Middlesbrough,7-0,7,0,1,1,7,7,H
1948-03-26,1947,Blackburn Rovers,Huddersfield Town,1-2,1,2,1,1,3,-1,A
1948-03-26,1947,Blackpool,Derby County,2-2,2,2,1,1,4,0,D
1948-03-26,1947,Burnley,Stoke City,4-0,4,0,1,1,4,4,H
1948-03-26,1947,Charlton Athletic,Aston Villa,1-1,1,1,1,1,2,0,D
1948-03-26,1947,Chelsea,Manchester City,2-2,2,2,1,1,4,0,D
1948-03-26,1947,Grimsby Town,Everton,3-0,3,0,1,1,3,3,H
1948-03-26,1947,Liverpool,Sheffield United,4-0,4,0,1,1,4,4,H
1948-03-26,1947,Manchester United,Bolton Wanderers,0-2,0,2,1,1,2,-2,A
1948-03-26,1947,Portsmouth,Preston North End,1-0,1,0,1,1,1,1,H
1948-03-26,1947,Sunderland,Wolverhampton Wanderers,2-1,2,1,1,1,3,1,H
1948-03-27,1947,Aston Villa,Portsmouth,2-1,2,1,1,1,3,1,H
1948-03-27,1947,Blackburn Rovers,Charlton Athletic,0-0,0,0,1,1,0,0,D
1948-03-27,1947,Blackpool,Arsenal,3-0,3,0,1,1,3,3,H
1948-03-27,1947,Chelsea,Preston North End,2-0,2,0,1,1,2,2,H
1948-03-27,1947,Derby County,Sheffield United,1-1,1,1,1,1,2,0,D
1948-03-27,1947,Everton,Stoke City,0-1,0,1,1,1,1,-1,A
1948-03-27,1947,Grimsby Town,Liverpool,0-2,0,2,1,1,2,-2,A
1948-03-27,1947,Huddersfield Town,Manchester United,0-2,0,2,1,1,2,-2,A
1948-03-27,1947,Manchester City,Middlesbrough,2-0,2,0,1,1,2,2,H
1948-03-27,1947,Wolverhampton Wanderers,Burnley,1-1,1,1,1,1,2,0,D
1948-03-29,1947,Bolton Wanderers,Manchester United,0-1,0,1,1,1,1,-1,A
1948-03-29,1947,Derby County,Blackpool,1-0,1,0,1,1,1,1,H
1948-03-29,1947,Everton,Grimsby Town,3-1,3,1,1,1,4,2,H
1948-03-29,1947,Huddersfield Town,Blackburn Rovers,1-1,1,1,1,1,2,0,D
1948-03-29,1947,Manchester City,Chelsea,1-0,1,0,1,1,1,1,H
1948-03-29,1947,Middlesbrough,Arsenal,1-1,1,1,1,1,2,0,D
1948-03-29,1947,Preston North End,Portsmouth,1-2,1,2,1,1,3,-1,A
1948-03-29,1947,Stoke City,Burnley,3-0,3,0,1,1,3,3,H
1948-03-29,1947,Wolverhampton Wanderers,Sunderland,2-1,2,1,1,1,3,1,H
1948-03-30,1947,Aston Villa,Charlton Athletic,2-1,2,1,1,1,3,1,H
1948-03-31,1947,Derby County,Liverpool,0-4,0,4,1,1,4,-4,A
1948-04-03,1947,Arsenal,Blackburn Rovers,2-0,2,0,1,1,2,2,H
1948-04-03,1947,Bolton Wanderers,Aston Villa,1-0,1,0,1,1,1,1,H
1948-04-03,1947,Burnley,Everton,0-1,0,1,1,1,1,-1,A
1948-04-03,1947,Charlton Athletic,Manchester City,0-1,0,1,1,1,1,-1,A
1948-04-03,1947,Liverpool,Sunderland,0-0,0,0,1,1,0,0,D
1948-04-03,1947,Manchester United,Derby County,1-0,1,0,1,1,1,1,H
1948-04-03,1947,Middlesbrough,Grimsby Town,4-1,4,1,1,1,5,3,H
1948-04-03,1947,Portsmouth,Wolverhampton Wanderers,2-0,2,0,1,1,2,2,H
1948-04-03,1947,Preston North End,Huddersfield Town,0-2,0,2,1,1,2,-2,A
1948-04-03,1947,Sheffield United,Blackpool,2-1,2,1,1,1,3,1,H
1948-04-03,1947,Stoke City,Chelsea,2-0,2,0,1,1,2,2,H
1948-04-05,1947,Blackpool,Bolton Wanderers,1-1,1,1,1,1,2,0,D
1948-04-07,1947,Aston Villa,Derby County,2-2,2,2,1,1,4,0,D
1948-04-07,1947,Blackpool,Burnley,0-1,0,1,1,1,1,-1,A
1948-04-07,1947,Manchester United,Manchester City,1-1,1,1,1,1,2,0,D
1948-04-07,1947,Preston North End,Sheffield United,3-3,3,3,1,1,6,0,D
1948-04-10,1947,Aston Villa,Stoke City,1-0,1,0,1,1,1,1,H
1948-04-10,1947,Blackburn Rovers,Liverpool,1-2,1,2,1,1,3,-1,A
1948-04-10,1947,Blackpool,Middlesbrough,1-0,1,0,1,1,1,1,H
1948-04-10,1947,Chelsea,Sheffield United,1-0,1,0,1,1,1,1,H
1948-04-10,1947,Derby County,Charlton Athletic,0-3,0,3,1,1,3,-3,A
1948-04-10,1947,Everton,Manchester United,2-0,2,0,1,1,2,2,H
1948-04-10,1947,Grimsby Town,Portsmouth,1-0,1,0,1,1,1,1,H
1948-04-10,1947,Huddersfield Town,Arsenal,1-1,1,1,1,1,2,0,D
1948-04-10,1947,Manchester City,Bolton Wanderers,0-2,0,2,1,1,2,-2,A
1948-04-10,1947,Sunderland,Burnley,2-0,2,0,1,1,2,2,H
1948-04-10,1947,Wolverhampton Wanderers,Preston North End,4-2,4,2,1,1,6,2,H
1948-04-12,1947,Sunderland,Blackpool,1-0,1,0,1,1,1,1,H
1948-04-14,1947,Aston Villa,Blackburn Rovers,3-2,3,2,1,1,5,1,H
1948-04-14,1947,Derby County,Wolverhampton Wanderers,1-2,1,2,1,1,3,-1,A
1948-04-14,1947,Everton,Chelsea,2-3,2,3,1,1,5,-1,A
1948-04-14,1947,Portsmouth,Middlesbrough,6-1,6,1,1,1,7,5,H
1948-04-17,1947,Arsenal,Derby County,1-2,1,2,1,1,3,-1,A
1948-04-17,1947,Bolton Wanderers,Grimsby Town,2-0,2,0,1,1,2,2,H
1948-04-17,1947,Burnley,Aston Villa,1-0,1,0,1,1,1,1,H
1948-04-17,1947,Charlton Athletic,Blackpool,2-0,2,0,1,1,2,2,H
1948-04-17,1947,Liverpool,Manchester City,1-1,1,1,1,1,2,0,D
1948-04-17,1947,Manchester United,Chelsea,5-0,5,0,1,1,5,5,H
1948-04-17,1947,Middlesbrough,Blackburn Rovers,1-1,1,1,1,1,2,0,D
1948-04-17,1947,Portsmouth,Sunderland,2-2,2,2,1,1,4,0,D
1948-04-17,1947,Preston North End,Everton,3-0,3,0,1,1,3,3,H
1948-04-17,1947,Sheffield United,Huddersfield Town,0-1,0,1,1,1,1,-1,A
1948-04-17,1947,Stoke City,Wolverhampton Wanderers,2-3,2,3,1,1,5,-1,A
1948-04-20,1947,Burnley,Charlton Athletic,0-2,0,2,1,1,2,-2,A
1948-04-21,1947,Bolton Wanderers,Derby County,0-3,0,3,1,1,3,-3,A
1948-04-21,1947,Liverpool,Everton,4-0,4,0,1,1,4,4,H
1948-04-21,1947,Manchester City,Preston North End,0-3,0,3,1,1,3,-3,A
1948-04-21,1947,Portsmouth,Arsenal,0-0,0,0,1,1,0,0,D
1948-04-24,1947,Aston Villa,Liverpool,2-1,2,1,1,1,3,1,H
1948-04-24,1947,Blackburn Rovers,Sheffield United,4-0,4,0,1,1,4,4,H
1948-04-24,1947,Chelsea,Burnley,0-2,0,2,1,1,2,-2,A
1948-04-24,1947,Derby County,Preston North End,2-1,2,1,1,1,3,1,H
1948-04-24,1947,Everton,Portsmouth,0-2,0,2,1,1,2,-2,A
1948-04-24,1947,Grimsby Town,Charlton Athletic,1-3,1,3,1,1,4,-2,A
1948-04-24,1947,Huddersfield Town,Stoke City,0-0,0,0,1,1,0,0,D
1948-04-24,1947,Manchester City,Arsenal,0-0,0,0,1,1,0,0,D
1948-04-24,1947,Sunderland,Middlesbrough,3-0,3,0,1,1,3,3,H
1948-04-24,1947,Wolverhampton Wanderers,Bolton Wanderers,1-0,1,0,1,1,1,1,H
1948-04-28,1947,Blackpool,Manchester United,1-0,1,0,1,1,1,1,H
1948-04-28,1947,Derby County,Portsmouth,2-1,2,1,1,1,3,1,H
1948-04-28,1947,Huddersfield Town,Everton,1-3,1,3,1,1,4,-2,A
1948-05-01,1947,Arsenal,Grimsby Town,8-0,8,0,1,1,8,8,H
1948-05-01,1947,Bolton Wanderers,Everton,0-0,0,0,1,1,0,0,D
1948-05-01,1947,Burnley,Huddersfield Town,2-1,2,1,1,1,3,1,H
1948-05-01,1947,Charlton Athletic,Sunderland,1-0,1,0,1,1,1,1,H
1948-05-01,1947,Liverpool,Wolverhampton Wanderers,2-1,2,1,1,1,3,1,H
1948-05-01,1947,Manchester United,Blackburn Rovers,4-1,4,1,1,1,5,3,H
1948-05-01,1947,Middlesbrough,Aston Villa,1-3,1,3,1,1,4,-2,A
1948-05-01,1947,Portsmouth,Chelsea,2-1,2,1,1,1,3,1,H
1948-05-01,1947,Preston North End,Blackpool,0-7,0,7,1,1,7,-7,A
1948-05-01,1947,Sheffield United,Manchester City,2-1,2,1,1,1,3,1,H
1948-05-01,1947,Stoke City,Derby County,1-0,1,0,1,1,1,1,H
1948-08-21,1948,Aston Villa,Liverpool,2-1,2,1,1,1,3,1,H
1948-08-21,1948,Burnley,Manchester City,1-0,1,0,1,1,1,1,H
1948-08-21,1948,Chelsea,Middlesbrough,1-0,1,0,1,1,1,1,H
1948-08-21,1948,Everton,Newcastle United,3-3,3,3,1,1,6,0,D
1948-08-21,1948,Huddersfield Town,Arsenal,1-1,1,1,1,1,2,0,D
1948-08-21,1948,Manchester United,Derby County,1-2,1,2,1,1,3,-1,A
1948-08-21,1948,Preston North End,Portsmouth,2-2,2,2,1,1,4,0,D
1948-08-21,1948,Sheffield United,Blackpool,3-2,3,2,1,1,5,1,H
1948-08-21,1948,Stoke City,Charlton Athletic,2-2,2,2,1,1,4,0,D
1948-08-21,1948,Sunderland,Bolton Wanderers,2-0,2,0,1,1,2,2,H
1948-08-21,1948,Wolverhampton Wanderers,Birmingham City,2-2,2,2,1,1,4,0,D
1948-08-23,1948,Blackpool,Manchester United,0-3,0,3,1,1,3,-3,A
1948-08-25,1948,Arsenal,Stoke City,3-0,3,0,1,1,3,3,H
1948-08-25,1948,Birmingham City,Middlesbrough,0-0,0,0,1,1,0,0,D
1948-08-25,1948,Bolton Wanderers,Aston Villa,3-0,3,0,1,1,3,3,H
1948-08-25,1948,Charlton Athletic,Burnley,3-1,3,1,1,1,4,2,H
1948-08-25,1948,Derby County,Huddersfield Town,4-1,4,1,1,1,5,3,H
1948-08-25,1948,Liverpool,Sheffield United,3-3,3,3,1,1,6,0,D
1948-08-25,1948,Manchester City,Preston North End,3-2,3,2,1,1,5,1,H
1948-08-25,1948,Newcastle United,Chelsea,2-2,2,2,1,1,4,0,D
1948-08-25,1948,Portsmouth,Everton,4-0,4,0,1,1,4,4,H
1948-08-25,1948,Wolverhampton Wanderers,Sunderland,0-1,0,1,1,1,1,-1,A
1948-08-28,1948,Arsenal,Manchester United,0-1,0,1,1,1,1,-1,A
1948-08-28,1948,Birmingham City,Chelsea,1-0,1,0,1,1,1,1,H
1948-08-28,1948,Blackpool,Aston Villa,1-0,1,0,1,1,1,1,H
1948-08-28,1948,Bolton Wanderers,Wolverhampton Wanderers,0-5,0,5,1,1,5,-5,A
1948-08-28,1948,Charlton Athletic,Huddersfield Town,3-1,3,1,1,1,4,2,H
1948-08-28,1948,Derby County,Sheffield United,2-1,2,1,1,1,3,1,H
1948-08-28,1948,Liverpool,Sunderland,4-0,4,0,1,1,4,4,H
1948-08-28,1948,Manchester City,Stoke City,0-0,0,0,1,1,0,0,D
1948-08-28,1948,Middlesbrough,Everton,1-0,1,0,1,1,1,1,H
1948-08-28,1948,Newcastle United,Preston North End,2-5,2,5,1,1,7,-3,A
1948-08-28,1948,Portsmouth,Burnley,1-0,1,0,1,1,1,1,H
1948-08-30,1948,Aston Villa,Bolton Wanderers,2-4,2,4,1,1,6,-2,A
1948-08-30,1948,Sheffield United,Liverpool,1-2,1,2,1,1,3,-1,A
1948-08-30,1948,Stoke City,Arsenal,1-0,1,0,1,1,1,1,H
1948-08-31,1948,Burnley,Charlton Athletic,0-0,0,0,1,1,0,0,D
1948-09-01,1948,Chelsea,Newcastle United,2-3,2,3,1,1,5,-1,A
1948-09-01,1948,Everton,Portsmouth,0-5,0,5,1,1,5,-5,A
1948-09-01,1948,Huddersfield Town,Derby County,1-1,1,1,1,1,2,0,D
1948-09-01,1948,Manchester United,Blackpool,3-4,3,4,1,1,7,-1,A
1948-09-01,1948,Middlesbrough,Birmingham City,1-1,1,1,1,1,2,0,D
1948-09-01,1948,Preston North End,Manchester City,1-3,1,3,1,1,4,-2,A
1948-09-01,1948,Sunderland,Wolverhampton Wanderers,3-3,3,3,1,1,6,0,D
1948-09-04,1948,Aston Villa,Derby County,1-1,1,1,1,1,2,0,D
1948-09-04,1948,Burnley,Newcastle United,0-3,0,3,1,1,3,-3,A
1948-09-04,1948,Charlton Athletic,Manchester City,3-2,3,2,1,1,5,1,H
1948-09-04,1948,Chelsea,Bolton Wanderers,2-2,2,2,1,1,4,0,D
1948-09-04,1948,Everton,Birmingham City,0-5,0,5,1,1,5,-5,A
1948-09-04,1948,Manchester United,Huddersfield Town,4-1,4,1,1,1,5,3,H
1948-09-04,1948,Preston North End,Middlesbrough,6-1,6,1,1,1,7,5,H
1948-09-04,1948,Sheffield United,Arsenal,1-1,1,1,1,1,2,0,D
1948-09-04,1948,Stoke City,Portsmouth,0-1,0,1,1,1,1,-1,A
1948-09-04,1948,Sunderland,Blackpool,2-2,2,2,1,1,4,0,D
1948-09-04,1948,Wolverhampton Wanderers,Liverpool,0-0,0,0,1,1,0,0,D
1948-09-06,1948,Blackpool,Derby County,1-1,1,1,1,1,2,0,D
1948-09-06,1948,Bolton Wanderers,Huddersfield Town,1-2,1,2,1,1,3,-1,A
1948-09-06,1948,Burnley,Preston North End,1-0,1,0,1,1,1,1,H
1948-09-06,1948,Sheffield United,Sunderland,2-5,2,5,1,1,7,-3,A
1948-09-08,1948,Arsenal,Liverpool,1-1,1,1,1,1,2,0,D
1948-09-08,1948,Charlton Athletic,Chelsea,1-1,1,1,1,1,2,0,D
1948-09-08,1948,Everton,Stoke City,2-1,2,1,1,1,3,1,H
1948-09-08,1948,Manchester City,Birmingham City,1-0,1,0,1,1,1,1,H
1948-09-08,1948,Newcastle United,Aston Villa,2-1,2,1,1,1,3,1,H
1948-09-08,1948,Portsmouth,Middlesbrough,1-0,1,0,1,1,1,1,H
1948-09-08,1948,Wolverhampton Wanderers,Manchester United,3-2,3,2,1,1,5,1,H
1948-09-11,1948,Arsenal,Aston Villa,3-1,3,1,1,1,4,2,H
1948-09-11,1948,Birmingham City,Preston North End,1-0,1,0,1,1,1,1,H
1948-09-11,1948,Blackpool,Wolverhampton Wanderers,1-3,1,3,1,1,4,-2,A
1948-09-11,1948,Chelsea,Everton,6-0,6,0,1,1,6,6,H
1948-09-11,1948,Derby County,Sunderland,2-2,2,2,1,1,4,0,D
1948-09-11,1948,Huddersfield Town,Sheffield United,0-0,0,0,1,1,0,0,D
1948-09-11,1948,Liverpool,Bolton Wanderers,0-1,0,1,1,1,1,-1,A
1948-09-11,1948,Manchester City,Manchester United,0-0,0,0,1,1,0,0,D
1948-09-11,1948,Middlesbrough,Burnley,4-1,4,1,1,1,5,3,H
1948-09-11,1948,Newcastle United,Stoke City,2-2,2,2,1,1,4,0,D
1948-09-11,1948,Portsmouth,Charlton Athletic,3-1,3,1,1,1,4,2,H
1948-09-13,1948,Aston Villa,Newcastle United,2-4,2,4,1,1,6,-2,A
1948-09-13,1948,Stoke City,Everton,1-0,1,0,1,1,1,1,H
1948-09-15,1948,Birmingham City,Manchester City,4-1,4,1,1,1,5,3,H
1948-09-15,1948,Derby County,Blackpool,3-1,3,1,1,1,4,2,H
1948-09-15,1948,Huddersfield Town,Bolton Wanderers,0-2,0,2,1,1,2,-2,A
1948-09-15,1948,Liverpool,Arsenal,0-1,0,1,1,1,1,-1,A
1948-09-15,1948,Manchester United,Wolverhampton Wanderers,2-0,2,0,1,1,2,2,H
1948-09-15,1948,Middlesbrough,Portsmouth,1-1,1,1,1,1,2,0,D
1948-09-15,1948,Preston North End,Burnley,0-3,0,3,1,1,3,-3,A
1948-09-15,1948,Sunderland,Sheffield United,2-0,2,0,1,1,2,2,H
1948-09-16,1948,Chelsea,Charlton Athletic,2-2,2,2,1,1,4,0,D
1948-09-18,1948,Aston Villa,Huddersfield Town,3-3,3,3,1,1,6,0,D
1948-09-18,1948,Bolton Wanderers,Blackpool,2-2,2,2,1,1,4,0,D
1948-09-18,1948,Burnley,Birmingham City,2-2,2,2,1,1,4,0,D
1948-09-18,1948,Charlton Athletic,Newcastle United,0-0,0,0,1,1,0,0,D
1948-09-18,1948,Everton,Liverpool,1-1,1,1,1,1,2,0,D
1948-09-18,1948,Manchester City,Portsmouth,1-1,1,1,1,1,2,0,D
1948-09-18,1948,Preston North End,Chelsea,3-2,3,2,1,1,5,1,H
1948-09-18,1948,Sheffield United,Manchester United,2-2,2,2,1,1,4,0,D
1948-09-18,1948,Stoke City,Middlesbrough,3-0,3,0,1,1,3,3,H
1948-09-18,1948,Sunderland,Arsenal,1-1,1,1,1,1,2,0,D
1948-09-18,1948,Wolverhampton Wanderers,Derby County,2-2,2,2,1,1,4,0,D
1948-09-25,1948,Arsenal,Wolverhampton Wanderers,3-1,3,1,1,1,4,2,H
1948-09-25,1948,Birmingham City,Stoke City,2-1,2,1,1,1,3,1,H
1948-09-25,1948,Blackpool,Liverpool,1-0,1,0,1,1,1,1,H
1948-09-25,1948,Chelsea,Burnley,1-0,1,0,1,1,1,1,H
1948-09-25,1948,Derby County,Bolton Wanderers,1-0,1,0,1,1,1,1,H
1948-09-25,1948,Everton,Preston North End,4-1,4,1,1,1,5,3,H
1948-09-25,1948,Huddersfield Town,Sunderland,2-0,2,0,1,1,2,2,H
1948-09-25,1948,Manchester United,Aston Villa,3-1,3,1,1,1,4,2,H
1948-09-25,1948,Middlesbrough,Charlton Athletic,2-4,2,4,1,1,6,-2,A
1948-09-25,1948,Newcastle United,Manchester City,0-0,0,0,1,1,0,0,D
1948-09-25,1948,Portsmouth,Sheffield United,3-0,3,0,1,1,3,3,H
1948-10-02,1948,Aston Villa,Sheffield United,4-3,4,3,1,1,7,1,H
1948-10-02,1948,Bolton Wanderers,Arsenal,1-0,1,0,1,1,1,1,H
1948-10-02,1948,Burnley,Everton,1-0,1,0,1,1,1,1,H
1948-10-02,1948,Charlton Athletic,Birmingham City,1-1,1,1,1,1,2,0,D
1948-10-02,1948,Liverpool,Derby County,0-0,0,0,1,1,0,0,D
1948-10-02,1948,Manchester City,Middlesbrough,1-0,1,0,1,1,1,1,H
1948-10-02,1948,Portsmouth,Newcastle United,1-0,1,0,1,1,1,1,H
1948-10-02,1948,Preston North End,Blackpool,1-3,1,3,1,1,4,-2,A
1948-10-02,1948,Stoke City,Chelsea,4-3,4,3,1,1,7,1,H
1948-10-02,1948,Sunderland,Manchester United,2-1,2,1,1,1,3,1,H
1948-10-02,1948,Wolverhampton Wanderers,Huddersfield Town,7-1,7,1,1,1,8,6,H
1948-10-09,1948,Arsenal,Burnley,3-1,3,1,1,1,4,2,H
1948-10-09,1948,Aston Villa,Portsmouth,1-1,1,1,1,1,2,0,D
1948-10-09,1948,Blackpool,Everton,3-0,3,0,1,1,3,3,H
1948-10-09,1948,Bolton Wanderers,Birmingham City,0-0,0,0,1,1,0,0,D
1948-10-09,1948,Derby County,Preston North End,1-0,1,0,1,1,1,1,H
1948-10-09,1948,Huddersfield Town,Stoke City,1-3,1,3,1,1,4,-2,A
1948-10-09,1948,Liverpool,Chelsea,1-1,1,1,1,1,2,0,D
1948-10-09,1948,Manchester United,Charlton Athletic,1-1,1,1,1,1,2,0,D
1948-10-09,1948,Sheffield United,Manchester City,0-2,0,2,1,1,2,-2,A
1948-10-09,1948,Sunderland,Newcastle United,1-1,1,1,1,1,2,0,D
1948-10-09,1948,Wolverhampton Wanderers,Middlesbrough,0-3,0,3,1,1,3,-3,A
1948-10-16,1948,Birmingham City,Liverpool,0-1,0,1,1,1,1,-1,A
1948-10-16,1948,Burnley,Huddersfield Town,1-2,1,2,1,1,3,-1,A
1948-10-16,1948,Charlton Athletic,Sheffield United,2-1,2,1,1,1,3,1,H
1948-10-16,1948,Chelsea,Blackpool,3-3,3,3,1,1,6,0,D
1948-10-16,1948,Everton,Derby County,0-1,0,1,1,1,1,-1,A
1948-10-16,1948,Manchester City,Aston Villa,4-1,4,1,1,1,5,3,H
1948-10-16,1948,Middlesbrough,Bolton Wanderers,5-0,5,0,1,1,5,5,H
1948-10-16,1948,Newcastle United,Wolverhampton Wanderers,3-1,3,1,1,1,4,2,H
1948-10-16,1948,Portsmouth,Sunderland,3-0,3,0,1,1,3,3,H
1948-10-16,1948,Preston North End,Arsenal,1-1,1,1,1,1,2,0,D
1948-10-16,1948,Stoke City,Manchester United,2-1,2,1,1,1,3,1,H
1948-10-23,1948,Arsenal,Everton,5-0,5,0,1,1,5,5,H
1948-10-23,1948,Aston Villa,Charlton Athletic,4-3,4,3,1,1,7,1,H
1948-10-23,1948,Blackpool,Birmingham City,1-0,1,0,1,1,1,1,H
1948-10-23,1948,Bolton Wanderers,Newcastle United,1-5,1,5,1,1,6,-4,A
1948-10-23,1948,Derby County,Chelsea,2-1,2,1,1,1,3,1,H
1948-10-23,1948,Huddersfield Town,Preston North End,0-2,0,2,1,1,2,-2,A
1948-10-23,1948,Liverpool,Middlesbrough,4-0,4,0,1,1,4,4,H
1948-10-23,1948,Manchester United,Burnley,1-1,1,1,1,1,2,0,D
1948-10-23,1948,Sheffield United,Stoke City,2-2,2,2,1,1,4,0,D
1948-10-23,1948,Sunderland,Manchester City,3-0,3,0,1,1,3,3,H
1948-10-23,1948,Wolverhampton Wanderers,Portsmouth,3-0,3,0,1,1,3,3,H
1948-10-30,1948,Birmingham City,Derby County,0-1,0,1,1,1,1,-1,A
1948-10-30,1948,Burnley,Sheffield United,2-0,2,0,1,1,2,2,H
1948-10-30,1948,Charlton Athletic,Sunderland,4-0,4,0,1,1,4,4,H
1948-10-30,1948,Chelsea,Arsenal,0-1,0,1,1,1,1,-1,A
1948-10-30,1948,Everton,Huddersfield Town,2-0,2,0,1,1,2,2,H
1948-10-30,1948,Manchester City,Wolverhampton Wanderers,3-3,3,3,1,1,6,0,D
1948-10-30,1948,Middlesbrough,Blackpool,1-0,1,0,1,1,1,1,H
1948-10-30,1948,Newcastle United,Liverpool,1-0,1,0,1,1,1,1,H
1948-10-30,1948,Portsmouth,Bolton Wanderers,0-0,0,0,1,1,0,0,D
1948-10-30,1948,Preston North End,Manchester United,1-6,1,6,1,1,7,-5,A
1948-10-30,1948,Stoke City,Aston Villa,4-2,4,2,1,1,6,2,H
1948-11-06,1948,Arsenal,Birmingham City,2-0,2,0,1,1,2,2,H
1948-11-06,1948,Aston Villa,Burnley,3-1,3,1,1,1,4,2,H
1948-11-06,1948,Blackpool,Newcastle United,1-3,1,3,1,1,4,-2,A
1948-11-06,1948,Bolton Wanderers,Manchester City,5-1,5,1,1,1,6,4,H
1948-11-06,1948,Derby County,Middlesbrough,2-0,2,0,1,1,2,2,H
1948-11-06,1948,Huddersfield Town,Chelsea,3-4,3,4,1,1,7,-1,A
1948-11-06,1948,Liverpool,Portsmouth,3-1,3,1,1,1,4,2,H
1948-11-06,1948,Manchester United,Everton,2-0,2,0,1,1,2,2,H
1948-11-06,1948,Sheffield United,Preston North End,3-2,3,2,1,1,5,1,H
1948-11-06,1948,Sunderland,Stoke City,1-1,1,1,1,1,2,0,D
1948-11-06,1948,Wolverhampton Wanderers,Charlton Athletic,2-0,2,0,1,1,2,2,H
1948-11-13,1948,Birmingham City,Huddersfield Town,1-0,1,0,1,1,1,1,H
1948-11-13,1948,Burnley,Sunderland,3-1,3,1,1,1,4,2,H
1948-11-13,1948,Charlton Athletic,Bolton Wanderers,1-4,1,4,1,1,5,-3,A
1948-11-13,1948,Chelsea,Manchester United,1-1,1,1,1,1,2,0,D
1948-11-13,1948,Everton,Sheffield United,2-1,2,1,1,1,3,1,H
1948-11-13,1948,Manchester City,Liverpool,2-4,2,4,1,1,6,-2,A
1948-11-13,1948,Middlesbrough,Arsenal,0-1,0,1,1,1,1,-1,A
1948-11-13,1948,Newcastle United,Derby County,3-0,3,0,1,1,3,3,H
1948-11-13,1948,Portsmouth,Blackpool,1-1,1,1,1,1,2,0,D
1948-11-13,1948,Preston North End,Aston Villa,0-1,0,1,1,1,1,-1,A
1948-11-13,1948,Stoke City,Wolverhampton Wanderers,2-1,2,1,1,1,3,1,H
1948-11-20,1948,Arsenal,Newcastle United,0-1,0,1,1,1,1,-1,A
1948-11-20,1948,Aston Villa,Everton,0-1,0,1,1,1,1,-1,A
1948-11-20,1948,Blackpool,Manchester City,1-1,1,1,1,1,2,0,D
1948-11-20,1948,Bolton Wanderers,Stoke City,2-1,2,1,1,1,3,1,H
1948-11-20,1948,Derby County,Portsmouth,1-0,1,0,1,1,1,1,H
1948-11-20,1948,Huddersfield Town,Middlesbrough,0-0,0,0,1,1,0,0,D
1948-11-20,1948,Liverpool,Charlton Athletic,1-1,1,1,1,1,2,0,D
1948-11-20,1948,Manchester United,Birmingham City,3-0,3,0,1,1,3,3,H
1948-11-20,1948,Sheffield United,Chelsea,2-1,2,1,1,1,3,1,H
1948-11-20,1948,Sunderland,Preston North End,0-0,0,0,1,1,0,0,D
1948-11-20,1948,Wolverhampton Wanderers,Burnley,3-0,3,0,1,1,3,3,H
1948-11-27,1948,Birmingham City,Sheffield United,1-2,1,2,1,1,3,-1,A
1948-11-27,1948,Burnley,Bolton Wanderers,3-0,3,0,1,1,3,3,H
1948-11-27,1948,Charlton Athletic,Blackpool,0-0,0,0,1,1,0,0,D
1948-11-27,1948,Chelsea,Aston Villa,2-1,2,1,1,1,3,1,H
1948-11-27,1948,Everton,Sunderland,1-0,1,0,1,1,1,1,H
1948-11-27,1948,Manchester City,Derby County,2-1,2,1,1,1,3,1,H
1948-11-27,1948,Middlesbrough,Manchester United,1-4,1,4,1,1,5,-3,A
1948-11-27,1948,Newcastle United,Huddersfield Town,2-4,2,4,1,1,6,-2,A
1948-11-27,1948,Portsmouth,Arsenal,4-1,4,1,1,1,5,3,H
1948-11-27,1948,Preston North End,Wolverhampton Wanderers,1-1,1,1,1,1,2,0,D
1948-11-27,1948,Stoke City,Liverpool,3-0,3,0,1,1,3,3,H
1948-12-04,1948,Arsenal,Manchester City,1-1,1,1,1,1,2,0,D
1948-12-04,1948,Aston Villa,Birmingham City,0-3,0,3,1,1,3,-3,A
1948-12-04,1948,Blackpool,Stoke City,2-1,2,1,1,1,3,1,H
1948-12-04,1948,Bolton Wanderers,Preston North End,5-3,5,3,1,1,8,2,H
1948-12-04,1948,Derby County,Charlton Athletic,5-1,5,1,1,1,6,4,H
1948-12-04,1948,Huddersfield Town,Portsmouth,0-0,0,0,1,1,0,0,D
1948-12-04,1948,Liverpool,Burnley,1-1,1,1,1,1,2,0,D
1948-12-04,1948,Manchester United,Newcastle United,1-1,1,1,1,1,2,0,D
1948-12-04,1948,Sheffield United,Middlesbrough,1-0,1,0,1,1,1,1,H
1948-12-04,1948,Sunderland,Chelsea,3-0,3,0,1,1,3,3,H
1948-12-04,1948,Wolverhampton Wanderers,Everton,1-0,1,0,1,1,1,1,H
1948-12-11,1948,Birmingham City,Sunderland,0-0,0,0,1,1,0,0,D
1948-12-11,1948,Burnley,Blackpool,2-0,2,0,1,1,2,2,H
1948-12-11,1948,Charlton Athletic,Arsenal,4-3,4,3,1,1,7,1,H
1948-12-11,1948,Chelsea,Wolverhampton Wanderers,4-1,4,1,1,1,5,3,H
1948-12-11,1948,Everton,Bolton Wanderers,1-0,1,0,1,1,1,1,H
1948-12-11,1948,Manchester City,Huddersfield Town,3-1,3,1,1,1,4,2,H
1948-12-11,1948,Middlesbrough,Aston Villa,6-0,6,0,1,1,6,6,H
1948-12-11,1948,Newcastle United,Sheffield United,3-2,3,2,1,1,5,1,H
1948-12-11,1948,Portsmouth,Manchester United,2-2,2,2,1,1,4,0,D
1948-12-11,1948,Preston North End,Liverpool,3-2,3,2,1,1,5,1,H
1948-12-11,1948,Stoke City,Derby County,4-2,4,2,1,1,6,2,H
1948-12-18,1948,Arsenal,Huddersfield Town,3-0,3,0,1,1,3,3,H
1948-12-18,1948,Birmingham City,Wolverhampton Wanderers,0-1,0,1,1,1,1,-1,A
1948-12-18,1948,Blackpool,Sheffield United,0-3,0,3,1,1,3,-3,A
1948-12-18,1948,Bolton Wanderers,Sunderland,4-1,4,1,1,1,5,3,H
1948-12-18,1948,Charlton Athletic,Stoke City,4-1,4,1,1,1,5,3,H
1948-12-18,1948,Derby County,Manchester United,1-3,1,3,1,1,4,-2,A
1948-12-18,1948,Liverpool,Aston Villa,1-1,1,1,1,1,2,0,D
1948-12-18,1948,Manchester City,Burnley,2-2,2,2,1,1,4,0,D
1948-12-18,1948,Middlesbrough,Chelsea,1-1,1,1,1,1,2,0,D
1948-12-18,1948,Newcastle United,Everton,1-0,1,0,1,1,1,1,H
1948-12-18,1948,Portsmouth,Preston North End,3-1,3,1,1,1,4,2,H
1948-12-25,1948,Arsenal,Derby County,3-3,3,3,1,1,6,0,D
1948-12-25,1948,Birmingham City,Newcastle United,2-0,2,0,1,1,2,2,H
1948-12-25,1948,Blackpool,Huddersfield Town,0-0,0,0,1,1,0,0,D
1948-12-25,1948,Burnley,Stoke City,1-3,1,3,1,1,4,-2,A
1948-12-25,1948,Charlton Athletic,Preston North End,0-0,0,0,1,1,0,0,D
1948-12-25,1948,Chelsea,Portsmouth,1-2,1,2,1,1,3,-1,A
1948-12-25,1948,Everton,Manchester City,0-0,0,0,1,1,0,0,D
1948-12-25,1948,Manchester United,Liverpool,0-0,0,0,1,1,0,0,D
1948-12-25,1948,Sheffield United,Bolton Wanderers,1-1,1,1,1,1,2,0,D
1948-12-25,1948,Sunderland,Middlesbrough,1-0,1,0,1,1,1,1,H
1948-12-25,1948,Wolverhampton Wanderers,Aston Villa,4-0,4,0,1,1,4,4,H
1948-12-27,1948,Aston Villa,Wolverhampton Wanderers,5-1,5,1,1,1,6,4,H
1948-12-27,1948,Bolton Wanderers,Sheffield United,6-1,6,1,1,1,7,5,H
1948-12-27,1948,Derby County,Arsenal,2-1,2,1,1,1,3,1,H
1948-12-27,1948,Huddersfield Town,Blackpool,1-0,1,0,1,1,1,1,H
1948-12-27,1948,Liverpool,Manchester United,0-2,0,2,1,1,2,-2,A
1948-12-27,1948,Manchester City,Everton,0-0,0,0,1,1,0,0,D
1948-12-27,1948,Middlesbrough,Sunderland,0-0,0,0,1,1,0,0,D
1948-12-27,1948,Newcastle United,Birmingham City,1-0,1,0,1,1,1,1,H
1948-12-27,1948,Portsmouth,Chelsea,5-2,5,2,1,1,7,3,H
1948-12-27,1948,Preston North End,Charlton Athletic,2-3,2,3,1,1,5,-1,A
1948-12-27,1948,Stoke City,Burnley,2-1,2,1,1,1,3,1,H
1949-01-01,1948,Aston Villa,Blackpool,2-5,2,5,1,1,7,-3,A
1949-01-01,1948,Burnley,Portsmouth,2-1,2,1,1,1,3,1,H
1949-01-01,1948,Chelsea,Birmingham City,2-0,2,0,1,1,2,2,H
1949-01-01,1948,Everton,Middlesbrough,3-1,3,1,1,1,4,2,H
1949-01-01,1948,Huddersfield Town,Charlton Athletic,1-2,1,2,1,1,3,-1,A
1949-01-01,1948,Manchester United,Arsenal,2-0,2,0,1,1,2,2,H
1949-01-01,1948,Preston North End,Newcastle United,2-1,2,1,1,1,3,1,H
1949-01-01,1948,Sheffield United,Derby County,3-1,3,1,1,1,4,2,H
1949-01-01,1948,Stoke City,Manchester City,2-3,2,3,1,1,5,-1,A
1949-01-01,1948,Sunderland,Liverpool,0-2,0,2,1,1,2,-2,A
1949-01-01,1948,Wolverhampton Wanderers,Bolton Wanderers,2-0,2,0,1,1,2,2,H
1949-01-15,1948,Arsenal,Sheffield United,5-3,5,3,1,1,8,2,H
1949-01-15,1948,Blackpool,Sunderland,3-3,3,3,1,1,6,0,D
1949-01-15,1948,Manchester City,Charlton Athletic,0-1,0,1,1,1,1,-1,A
1949-01-15,1948,Middlesbrough,Preston North End,1-0,1,0,1,1,1,1,H
1949-01-15,1948,Newcastle United,Burnley,1-1,1,1,1,1,2,0,D
1949-01-15,1948,Portsmouth,Stoke City,1-0,1,0,1,1,1,1,H
1949-01-22,1948,Aston Villa,Arsenal,1-0,1,0,1,1,1,1,H
1949-01-22,1948,Bolton Wanderers,Liverpool,0-3,0,3,1,1,3,-3,A
1949-01-22,1948,Burnley,Middlesbrough,0-0,0,0,1,1,0,0,D
1949-01-22,1948,Charlton Athletic,Portsmouth,0-1,0,1,1,1,1,-1,A
1949-01-22,1948,Everton,Chelsea,2-1,2,1,1,1,3,1,H
1949-01-22,1948,Manchester United,Manchester City,0-0,0,0,1,1,0,0,D
1949-01-22,1948,Preston North End,Birmingham City,0-0,0,0,1,1,0,0,D
1949-01-22,1948,Sheffield United,Huddersfield Town,0-0,0,0,1,1,0,0,D
1949-01-22,1948,Stoke City,Newcastle United,1-1,1,1,1,1,2,0,D
1949-01-22,1948,Sunderland,Derby County,2-1,2,1,1,1,3,1,H
1949-01-22,1948,Wolverhampton Wanderers,Blackpool,2-1,2,1,1,1,3,1,H
1949-02-05,1948,Arsenal,Sunderland,5-0,5,0,1,1,5,5,H
1949-02-05,1948,Birmingham City,Burnley,0-0,0,0,1,1,0,0,D
1949-02-05,1948,Chelsea,Preston North End,5-3,5,3,1,1,8,2,H
1949-02-05,1948,Derby County,Wolverhampton Wanderers,3-2,3,2,1,1,5,1,H
1949-02-05,1948,Liverpool,Everton,0-0,0,0,1,1,0,0,D
1949-02-05,1948,Newcastle United,Charlton Athletic,2-0,2,0,1,1,2,2,H
1949-02-05,1948,Portsmouth,Manchester City,3-1,3,1,1,1,4,2,H
1949-02-12,1948,Birmingham City,Everton,0-0,0,0,1,1,0,0,D
1949-02-12,1948,Blackpool,Bolton Wanderers,1-0,1,0,1,1,1,1,H
1949-02-12,1948,Huddersfield Town,Aston Villa,0-1,0,1,1,1,1,-1,A
1949-02-19,1948,Aston Villa,Manchester United,2-1,2,1,1,1,3,1,H
1949-02-19,1948,Bolton Wanderers,Derby County,4-0,4,0,1,1,4,4,H
1949-02-19,1948,Burnley,Chelsea,3-0,3,0,1,1,3,3,H
1949-02-19,1948,Charlton Athletic,Middlesbrough,2-0,2,0,1,1,2,2,H
1949-02-19,1948,Liverpool,Blackpool,1-1,1,1,1,1,2,0,D
1949-02-19,1948,Manchester City,Newcastle United,1-0,1,0,1,1,1,1,H
1949-02-19,1948,Preston North End,Everton,3-1,3,1,1,1,4,2,H
1949-02-19,1948,Sheffield United,Portsmouth,3-1,3,1,1,1,4,2,H
1949-02-19,1948,Stoke City,Birmingham City,2-1,2,1,1,1,3,1,H
1949-02-19,1948,Sunderland,Huddersfield Town,0-1,0,1,1,1,1,-1,A
1949-02-19,1948,Wolverhampton Wanderers,Arsenal,1-3,1,3,1,1,4,-2,A
1949-02-26,1948,Arsenal,Bolton Wanderers,5-0,5,0,1,1,5,5,H
1949-02-26,1948,Birmingham City,Charlton Athletic,1-0,1,0,1,1,1,1,H
1949-02-26,1948,Blackpool,Preston North End,2-2,2,2,1,1,4,0,D
1949-02-26,1948,Chelsea,Stoke City,2-2,2,2,1,1,4,0,D
1949-02-26,1948,Everton,Burnley,2-1,2,1,1,1,3,1,H
1949-02-26,1948,Middlesbrough,Manchester City,0-1,0,1,1,1,1,-1,A
1949-02-26,1948,Sheffield United,Aston Villa,0-1,0,1,1,1,1,-1,A
1949-03-05,1948,Birmingham City,Bolton Wanderers,0-0,0,0,1,1,0,0,D
1949-03-05,1948,Burnley,Arsenal,1-1,1,1,1,1,2,0,D
1949-03-05,1948,Charlton Athletic,Manchester United,2-3,2,3,1,1,5,-1,A
1949-03-05,1948,Chelsea,Liverpool,2-1,2,1,1,1,3,1,H
1949-03-05,1948,Everton,Blackpool,5-0,5,0,1,1,5,5,H
1949-03-05,1948,Manchester City,Sheffield United,1-0,1,0,1,1,1,1,H
1949-03-05,1948,Middlesbrough,Wolverhampton Wanderers,4-4,4,4,1,1,8,0,D
1949-03-05,1948,Newcastle United,Sunderland,2-1,2,1,1,1,3,1,H
1949-03-05,1948,Portsmouth,Aston Villa,3-0,3,0,1,1,3,3,H
1949-03-05,1948,Preston North End,Derby County,0-0,0,0,1,1,0,0,D
1949-03-05,1948,Stoke City,Huddersfield Town,1-3,1,3,1,1,4,-2,A
1949-03-12,1948,Arsenal,Preston North End,0-0,0,0,1,1,0,0,D
1949-03-12,1948,Aston Villa,Manchester City,1-0,1,0,1,1,1,1,H
1949-03-12,1948,Blackpool,Chelsea,2-1,2,1,1,1,3,1,H
1949-03-12,1948,Bolton Wanderers,Middlesbrough,4-1,4,1,1,1,5,3,H
1949-03-12,1948,Derby County,Everton,3-2,3,2,1,1,5,1,H
1949-03-12,1948,Huddersfield Town,Burnley,1-0,1,0,1,1,1,1,H
1949-03-12,1948,Liverpool,Birmingham City,1-0,1,0,1,1,1,1,H
1949-03-12,1948,Manchester United,Stoke City,3-0,3,0,1,1,3,3,H
1949-03-12,1948,Sheffield United,Charlton Athletic,2-0,2,0,1,1,2,2,H
1949-03-12,1948,Sunderland,Portsmouth,1-4,1,4,1,1,5,-3,A
1949-03-12,1948,Wolverhampton Wanderers,Newcastle United,3-0,3,0,1,1,3,3,H
1949-03-19,1948,Birmingham City,Manchester United,1-0,1,0,1,1,1,1,H
1949-03-19,1948,Burnley,Wolverhampton Wanderers,0-0,0,0,1,1,0,0,D
1949-03-19,1948,Charlton Athletic,Liverpool,2-1,2,1,1,1,3,1,H
1949-03-19,1948,Chelsea,Sheffield United,1-0,1,0,1,1,1,1,H
1949-03-19,1948,Everton,Aston Villa,1-3,1,3,1,1,4,-2,A
1949-03-19,1948,Manchester City,Blackpool,1-1,1,1,1,1,2,0,D
1949-03-19,1948,Middlesbrough,Huddersfield Town,1-0,1,0,1,1,1,1,H
1949-03-19,1948,Newcastle United,Arsenal,3-2,3,2,1,1,5,1,H
1949-03-19,1948,Portsmouth,Derby County,1-0,1,0,1,1,1,1,H
1949-03-19,1948,Preston North End,Sunderland,1-3,1,3,1,1,4,-2,A
1949-03-19,1948,Stoke City,Bolton Wanderers,4-0,4,0,1,1,4,4,H
1949-03-26,1948,Aston Villa,Chelsea,1-1,1,1,1,1,2,0,D
1949-03-26,1948,Blackpool,Charlton Athletic,0-1,0,1,1,1,1,-1,A
1949-03-26,1948,Bolton Wanderers,Burnley,0-1,0,1,1,1,1,-1,A
1949-03-26,1948,Derby County,Manchester City,2-0,2,0,1,1,2,2,H
1949-03-26,1948,Huddersfield Town,Newcastle United,0-2,0,2,1,1,2,-2,A
1949-03-26,1948,Liverpool,Stoke City,4-0,4,0,1,1,4,4,H
1949-03-26,1948,Sheffield United,Birmingham City,4-0,4,0,1,1,4,4,H
1949-03-26,1948,Sunderland,Everton,1-1,1,1,1,1,2,0,D
1949-04-02,1948,Birmingham City,Arsenal,1-1,1,1,1,1,2,0,D
1949-04-02,1948,Burnley,Aston Villa,1-1,1,1,1,1,2,0,D
1949-04-02,1948,Charlton Athletic,Everton,3-1,3,1,1,1,4,2,H
1949-04-02,1948,Chelsea,Huddersfield Town,5-0,5,0,1,1,5,5,H
1949-04-02,1948,Manchester City,Bolton Wanderers,1-0,1,0,1,1,1,1,H
1949-04-02,1948,Middlesbrough,Derby County,1-0,1,0,1,1,1,1,H
1949-04-02,1948,Newcastle United,Blackpool,3-1,3,1,1,1,4,2,H
1949-04-02,1948,Portsmouth,Liverpool,3-2,3,2,1,1,5,1,H
1949-04-02,1948,Preston North End,Sheffield United,4-1,4,1,1,1,5,3,H
1949-04-02,1948,Stoke City,Sunderland,0-0,0,0,1,1,0,0,D
1949-04-06,1948,Huddersfield Town,Manchester United,2-1,2,1,1,1,3,1,H
1949-04-06,1948,Liverpool,Wolverhampton Wanderers,0-0,0,0,1,1,0,0,D
1949-04-06,1948,Newcastle United,Portsmouth,0-5,0,5,1,1,5,-5,A
1949-04-09,1948,Arsenal,Middlesbrough,1-1,1,1,1,1,2,0,D
1949-04-09,1948,Aston Villa,Preston North End,2-0,2,0,1,1,2,2,H
1949-04-09,1948,Blackpool,Portsmouth,1-0,1,0,1,1,1,1,H
1949-04-09,1948,Bolton Wanderers,Charlton Athletic,2-2,2,2,1,1,4,0,D
1949-04-09,1948,Derby County,Newcastle United,2-4,2,4,1,1,6,-2,A
1949-04-09,1948,Huddersfield Town,Birmingham City,0-0,0,0,1,1,0,0,D
1949-04-09,1948,Liverpool,Manchester City,0-1,0,1,1,1,1,-1,A
1949-04-09,1948,Manchester United,Chelsea,1-1,1,1,1,1,2,0,D
1949-04-09,1948,Sheffield United,Everton,1-1,1,1,1,1,2,0,D
1949-04-09,1948,Sunderland,Burnley,0-0,0,0,1,1,0,0,D
1949-04-09,1948,Wolverhampton Wanderers,Stoke City,3-1,3,1,1,1,4,2,H
1949-04-13,1948,Charlton Athletic,Wolverhampton Wanderers,2-3,2,3,1,1,5,-1,A
1949-04-15,1948,Blackpool,Arsenal,1-1,1,1,1,1,2,0,D
1949-04-15,1948,Bolton Wanderers,Manchester United,0-1,0,1,1,1,1,-1,A
1949-04-15,1948,Burnley,Derby County,3-1,3,1,1,1,4,2,H
1949-04-15,1948,Liverpool,Huddersfield Town,0-1,0,1,1,1,1,-1,A
1949-04-15,1948,Manchester City,Chelsea,1-0,1,0,1,1,1,1,H
1949-04-15,1948,Newcastle United,Middlesbrough,1-0,1,0,1,1,1,1,H
1949-04-15,1948,Portsmouth,Birmingham City,3-1,3,1,1,1,4,2,H
1949-04-15,1948,Preston North End,Stoke City,2-1,2,1,1,1,3,1,H
1949-04-15,1948,Sunderland,Aston Villa,0-0,0,0,1,1,0,0,D
1949-04-16,1948,Birmingham City,Blackpool,1-1,1,1,1,1,2,0,D
1949-04-16,1948,Burnley,Manchester United,0-2,0,2,1,1,2,-2,A
1949-04-16,1948,Charlton Athletic,Aston Villa,0-2,0,2,1,1,2,-2,A
1949-04-16,1948,Chelsea,Derby County,0-3,0,3,1,1,3,-3,A
1949-04-16,1948,Everton,Arsenal,0-0,0,0,1,1,0,0,D
1949-04-16,1948,Manchester City,Sunderland,1-1,1,1,1,1,2,0,D
1949-04-16,1948,Middlesbrough,Liverpool,0-1,0,1,1,1,1,-1,A
1949-04-16,1948,Newcastle United,Bolton Wanderers,1-1,1,1,1,1,2,0,D
1949-04-16,1948,Portsmouth,Wolverhampton Wanderers,5-0,5,0,1,1,5,5,H
1949-04-16,1948,Preston North End,Huddersfield Town,2-0,2,0,1,1,2,2,H
1949-04-16,1948,Stoke City,Sheffield United,0-1,0,1,1,1,1,-1,A
1949-04-18,1948,Arsenal,Blackpool,2-0,2,0,1,1,2,2,H
1949-04-18,1948,Birmingham City,Portsmouth,3-0,3,0,1,1,3,3,H
1949-04-18,1948,Chelsea,Manchester City,1-1,1,1,1,1,2,0,D
1949-04-18,1948,Derby County,Burnley,2-0,2,0,1,1,2,2,H
1949-04-18,1948,Everton,Charlton Athletic,1-1,1,1,1,1,2,0,D
1949-04-18,1948,Huddersfield Town,Liverpool,0-4,0,4,1,1,4,-4,A
1949-04-18,1948,Manchester United,Bolton Wanderers,3-0,3,0,1,1,3,3,H
1949-04-18,1948,Middlesbrough,Newcastle United,3-2,3,2,1,1,5,1,H
1949-04-18,1948,Sheffield United,Wolverhampton Wanderers,1-1,1,1,1,1,2,0,D
1949-04-18,1948,Stoke City,Preston North End,2-0,2,0,1,1,2,2,H
1949-04-19,1948,Aston Villa,Sunderland,1-1,1,1,1,1,2,0,D
1949-04-19,1948,Wolverhampton Wanderers,Sheffield United,6-0,6,0,1,1,6,6,H
1949-04-21,1948,Manchester United,Sunderland,1-2,1,2,1,1,3,-1,A
1949-04-23,1948,Arsenal,Chelsea,1-2,1,2,1,1,3,-1,A
1949-04-23,1948,Aston Villa,Stoke City,2-1,2,1,1,1,3,1,H
1949-04-23,1948,Blackpool,Middlesbrough,1-1,1,1,1,1,2,0,D
1949-04-23,1948,Bolton Wanderers,Portsmouth,1-2,1,2,1,1,3,-1,A
1949-04-23,1948,Derby County,Birmingham City,1-0,1,0,1,1,1,1,H
1949-04-23,1948,Huddersfield Town,Everton,1-1,1,1,1,1,2,0,D
1949-04-23,1948,Liverpool,Newcastle United,1-1,1,1,1,1,2,0,D
1949-04-23,1948,Manchester United,Preston North End,2-2,2,2,1,1,4,0,D
1949-04-23,1948,Sheffield United,Burnley,0-0,0,0,1,1,0,0,D
1949-04-23,1948,Sunderland,Charlton Athletic,1-0,1,0,1,1,1,1,H
1949-04-23,1948,Wolverhampton Wanderers,Manchester City,1-1,1,1,1,1,2,0,D
1949-04-27,1948,Derby County,Aston Villa,2-2,2,2,1,1,4,0,D
1949-04-27,1948,Everton,Manchester United,2-0,2,0,1,1,2,2,H
1949-04-27,1948,Manchester City,Arsenal,0-3,0,3,1,1,3,-3,A
1949-04-27,1948,Middlesbrough,Stoke City,1-1,1,1,1,1,2,0,D
1949-04-30,1948,Birmingham City,Aston Villa,0-1,0,1,1,1,1,-1,A
1949-04-30,1948,Burnley,Liverpool,0-2,0,2,1,1,2,-2,A
1949-04-30,1948,Charlton Athletic,Derby County,1-5,1,5,1,1,6,-4,A
1949-04-30,1948,Chelsea,Sunderland,0-1,0,1,1,1,1,-1,A
1949-04-30,1948,Middlesbrough,Sheffield United,3-1,3,1,1,1,4,2,H
1949-04-30,1948,Newcastle United,Manchester United,0-1,0,1,1,1,1,-1,A
1949-04-30,1948,Portsmouth,Huddersfield Town,2-0,2,0,1,1,2,2,H
1949-04-30,1948,Preston North End,Bolton Wanderers,1-1,1,1,1,1,2,0,D
1949-04-30,1948,Stoke City,Blackpool,3-2,3,2,1,1,5,1,H
1949-05-02,1948,Manchester United,Middlesbrough,1-0,1,0,1,1,1,1,H
1949-05-02,1948,Wolverhampton Wanderers,Preston North End,2-1,2,1,1,1,3,1,H
1949-05-04,1948,Arsenal,Portsmouth,3-2,3,2,1,1,5,1,H
1949-05-04,1948,Bolton Wanderers,Chelsea,1-1,1,1,1,1,2,0,D
1949-05-04,1948,Derby County,Liverpool,3-0,3,0,1,1,3,3,H
1949-05-04,1948,Everton,Wolverhampton Wanderers,1-0,1,0,1,1,1,1,H
1949-05-04,1948,Manchester United,Sheffield United,3-2,3,2,1,1,5,1,H
1949-05-05,1948,Huddersfield Town,Wolverhampton Wanderers,4-0,4,0,1,1,4,4,H
1949-05-07,1948,Arsenal,Charlton Athletic,2-0,2,0,1,1,2,2,H
1949-05-07,1948,Aston Villa,Middlesbrough,1-1,1,1,1,1,2,0,D
1949-05-07,1948,Blackpool,Burnley,1-1,1,1,1,1,2,0,D
1949-05-07,1948,Bolton Wanderers,Everton,1-0,1,0,1,1,1,1,H
1949-05-07,1948,Derby County,Stoke City,4-1,4,1,1,1,5,3,H
1949-05-07,1948,Huddersfield Town,Manchester City,1-0,1,0,1,1,1,1,H
1949-05-07,1948,Liverpool,Preston North End,0-2,0,2,1,1,2,-2,A
1949-05-07,1948,Manchester United,Portsmouth,3-2,3,2,1,1,5,1,H
1949-05-07,1948,Sheffield United,Newcastle United,0-0,0,0,1,1,0,0,D
1949-05-07,1948,Sunderland,Birmingham City,1-1,1,1,1,1,2,0,D
1949-05-07,1948,Wolverhampton Wanderers,Chelsea,1-1,1,1,1,1,2,0,D