Date,Season,home,visitor,FT,hgoal,vgoal,division,tier,totgoal,goaldif,result
1888-09-08,1888,Bolton Wanderers,Derby County,3-6,3,6,1,1,9,-3,A
1888-09-08,1888,Everton,Accrington F.C.,2-1,2,1,1,1,3,1,H
1888-09-08,1888,Preston North End,Burnley,5-2,5,2,1,1,7,3,H
1888-09-08,1888,Stoke City,West Bromwich Albion,0-2,0,2,1,1,2,-2,A
1888-09-08,1888,Wolverhampton Wanderers,Aston Villa,1-1,1,1,1,1,2,0,D
1888-09-15,1888,Aston Villa,Stoke City,5-1,5,1,1,1,6,4,H
1888-09-15,1888,Blackburn Rovers,Accrington F.C.,5-5,5,5,1,1,10,0,D
1888-09-15,1888,Bolton Wanderers,Burnley,3-4,3,4,1,1,7,-1,A
1888-09-15,1888,Derby County,West Bromwich Albion,1-2,1,2,1,1,3,-1,A
1888-09-15,1888,Everton,Notts County,2-1,2,1,1,1,3,1,H
1888-09-15,1888,Wolverhampton Wanderers,Preston North End,0-4,0,4,1,1,4,-4,A
1888-09-22,1888,Aston Villa,Everton,2-1,2,1,1,1,3,1,H
1888-09-22,1888,Blackburn Rovers,West Bromwich Albion,6-2,6,2,1,1,8,4,H
1888-09-22,1888,Derby County,Accrington F.C.,1-1,1,1,1,1,2,0,D
1888-09-22,1888,Preston North End,Bolton Wanderers,3-1,3,1,1,1,4,2,H
1888-09-22,1888,Stoke City,Notts County,3-0,3,0,1,1,3,3,H
1888-09-22,1888,Wolverhampton Wanderers,Burnley,4-1,4,1,1,1,5,3,H
1888-09-29,1888,Aston Villa,Notts County,9-1,9,1,1,1,10,8,H
1888-09-29,1888,Bolton Wanderers,Everton,6-2,6,2,1,1,8,4,H
1888-09-29,1888,Derby County,Preston North End,2-3,2,3,1,1,5,-1,A
1888-09-29,1888,Stoke City,Accrington F.C.,2-4,2,4,1,1,6,-2,A
1888-09-29,1888,West Bromwich Albion,Burnley,4-3,4,3,1,1,7,1,H
1888-09-29,1888,Wolverhampton Wanderers,Blackburn Rovers,2-2,2,2,1,1,4,0,D
1888-10-06,1888,Accrington F.C.,Wolverhampton Wanderers,4-4,4,4,1,1,8,0,D
1888-10-06,1888,Burnley,Bolton Wanderers,4-1,4,1,1,1,5,3,H
1888-10-06,1888,Everton,Aston Villa,2-0,2,0,1,1,2,2,H
1888-10-06,1888,Notts County,Blackburn Rovers,3-3,3,3,1,1,6,0,D
1888-10-06,1888,Preston North End,Stoke City,7-0,7,0,1,1,7,7,H
1888-10-06,1888,West Bromwich Albion,Derby County,5-0,5,0,1,1,5,5,H
1888-10-13,1888,Accrington F.C.,Derby County,6-2,6,2,1,1,8,4,H
1888-10-13,1888,Aston Villa,Blackburn Rovers,6-1,6,1,1,1,7,5,H
1888-10-13,1888,Bolton Wanderers,Stoke City,2-1,2,1,1,1,3,1,H
1888-10-13,1888,Burnley,Wolverhampton Wanderers,0-4,0,4,1,1,4,-4,A
1888-10-13,1888,Notts County,Everton,3-1,3,1,1,1,4,2,H
1888-10-13,1888,Preston North End,West Bromwich Albion,3-0,3,0,1,1,3,3,H
1888-10-20,1888,Accrington F.C.,Preston North End,0-0,0,0,1,1,0,0,D
1888-10-20,1888,Blackburn Rovers,Wolverhampton Wanderers,2-2,2,2,1,1,4,0,D
1888-10-20,1888,Bolton Wanderers,Aston Villa,2-3,2,3,1,1,5,-1,A
1888-10-20,1888,Derby County,Everton,2-4,2,4,1,1,6,-2,A
1888-10-20,1888,Stoke City,Burnley,4-3,4,3,1,1,7,1,H
1888-10-20,1888,West Bromwich Albion,Notts County,4-2,4,2,1,1,6,2,H
1888-10-27,1888,Aston Villa,Accrington F.C.,4-3,4,3,1,1,7,1,H
1888-10-27,1888,Blackburn Rovers,Stoke City,5-2,5,2,1,1,7,3,H
1888-10-27,1888,Everton,Derby County,6-2,6,2,1,1,8,4,H
1888-10-27,1888,Notts County,Burnley,6-1,6,1,1,1,7,5,H
1888-10-27,1888,Preston North End,Wolverhampton Wanderers,5-2,5,2,1,1,7,3,H
1888-11-03,1888,Burnley,Blackburn Rovers,1-7,1,7,1,1,8,-6,A
1888-11-03,1888,Everton,Bolton Wanderers,2-1,2,1,1,1,3,1,H
1888-11-03,1888,Notts County,Preston North End,0-7,0,7,1,1,7,-7,A
1888-11-03,1888,Stoke City,Aston Villa,1-1,1,1,1,1,2,0,D
1888-11-03,1888,West Bromwich Albion,Accrington F.C.,2-2,2,2,1,1,4,0,D
1888-11-03,1888,Wolverhampton Wanderers,Derby County,4-1,4,1,1,1,5,3,H
1888-11-05,1888,West Bromwich Albion,Bolton Wanderers,1-5,1,5,1,1,6,-4,A
1888-11-10,1888,Blackburn Rovers,Everton,3-0,3,0,1,1,3,3,H
1888-11-10,1888,Burnley,West Bromwich Albion,2-0,2,0,1,1,2,2,H
1888-11-10,1888,Notts County,Accrington F.C.,3-3,3,3,1,1,6,0,D
1888-11-10,1888,Preston North End,Aston Villa,1-1,1,1,1,1,2,0,D
1888-11-10,1888,Wolverhampton Wanderers,Bolton Wanderers,3-2,3,2,1,1,5,1,H
1888-11-12,1888,Stoke City,Preston North End,0-3,0,3,1,1,3,-3,A
1888-11-17,1888,Blackburn Rovers,Aston Villa,5-1,5,1,1,1,6,4,H
1888-11-17,1888,Bolton Wanderers,West Bromwich Albion,1-2,1,2,1,1,3,-1,A
1888-11-17,1888,Burnley,Everton,2-2,2,2,1,1,4,0,D
1888-11-17,1888,Preston North End,Accrington F.C.,2-0,2,0,1,1,2,2,H
1888-11-17,1888,Stoke City,Wolverhampton Wanderers,0-1,0,1,1,1,1,-1,A
1888-11-24,1888,Accrington F.C.,West Bromwich Albion,2-1,2,1,1,1,3,1,H
1888-11-24,1888,Aston Villa,Wolverhampton Wanderers,2-1,2,1,1,1,3,1,H
1888-11-24,1888,Bolton Wanderers,Preston North End,2-5,2,5,1,1,7,-3,A
1888-11-24,1888,Derby County,Blackburn Rovers,0-2,0,2,1,1,2,-2,A
1888-11-24,1888,Everton,Burnley,3-2,3,2,1,1,5,1,H
1888-11-24,1888,Notts County,Stoke City,0-3,0,3,1,1,3,-3,A
1888-12-01,1888,Accrington F.C.,Burnley,5-1,5,1,1,1,6,4,H
1888-12-01,1888,Everton,West Bromwich Albion,1-4,1,4,1,1,5,-3,A
1888-12-01,1888,Stoke City,Blackburn Rovers,2-1,2,1,1,1,3,1,H
1888-12-08,1888,Blackburn Rovers,Bolton Wanderers,4-4,4,4,1,1,8,0,D
1888-12-08,1888,Burnley,Stoke City,2-1,2,1,1,1,3,1,H
1888-12-08,1888,Notts County,Aston Villa,2-4,2,4,1,1,6,-2,A
1888-12-08,1888,Preston North End,Derby County,5-0,5,0,1,1,5,5,H
1888-12-08,1888,Wolverhampton Wanderers,Accrington F.C.,4-0,4,0,1,1,4,4,H
1888-12-15,1888,Accrington F.C.,Aston Villa,1-1,1,1,1,1,2,0,D
1888-12-15,1888,Blackburn Rovers,Notts County,5-2,5,2,1,1,7,3,H
1888-12-15,1888,Burnley,Preston North End,2-2,2,2,1,1,4,0,D
1888-12-15,1888,Stoke City,Everton,0-0,0,0,1,1,0,0,D
1888-12-15,1888,Wolverhampton Wanderers,West Bromwich Albion,2-1,2,1,1,1,3,1,H
1888-12-22,1888,Aston Villa,Burnley,4-2,4,2,1,1,6,2,H
1888-12-22,1888,Bolton Wanderers,Accrington F.C.,4-1,4,1,1,1,5,3,H
1888-12-22,1888,Derby County,Notts County,3-2,3,2,1,1,5,1,H
1888-12-22,1888,Preston North End,Everton,3-0,3,0,1,1,3,3,H
1888-12-22,1888,West Bromwich Albion,Blackburn Rovers,2-1,2,1,1,1,3,1,H
1888-12-22,1888,Wolverhampton Wanderers,Stoke City,4-1,4,1,1,1,5,3,H
1888-12-26,1888,Derby County,Bolton Wanderers,2-3,2,3,1,1,5,-1,A
1888-12-26,1888,West Bromwich Albion,Preston North End,0-5,0,5,1,1,5,-5,A
1888-12-29,1888,Accrington F.C.,Everton,3-1,3,1,1,1,4,2,H
1888-12-29,1888,Aston Villa,Derby County,4-2,4,2,1,1,6,2,H
1888-12-29,1888,Bolton Wanderers,Wolverhampton Wanderers,2-1,2,1,1,1,3,1,H
1888-12-29,1888,Burnley,Notts County,1-0,1,0,1,1,1,1,H
1888-12-29,1888,Preston North End,Blackburn Rovers,1-0,1,0,1,1,1,1,H
1888-12-29,1888,West Bromwich Albion,Stoke City,2-0,2,0,1,1,2,2,H
1889-01-05,1888,Burnley,Aston Villa,4-0,4,0,1,1,4,4,H
1889-01-05,1888,Preston North End,Notts County,4-1,4,1,1,1,5,3,H
1889-01-05,1888,West Bromwich Albion,Wolverhampton Wanderers,1-3,1,3,1,1,4,-2,A
1889-01-12,1888,Aston Villa,Bolton Wanderers,6-2,6,2,1,1,8,4,H
1889-01-12,1888,Blackburn Rovers,Preston North End,2-2,2,2,1,1,4,0,D
1889-01-12,1888,Burnley,Accrington F.C.,2-2,2,2,1,1,4,0,D
1889-01-12,1888,Derby County,Wolverhampton Wanderers,3-0,3,0,1,1,3,3,H
1889-01-12,1888,Everton,Stoke City,2-1,2,1,1,1,3,1,H
1889-01-12,1888,Notts County,West Bromwich Albion,2-1,2,1,1,1,3,1,H
1889-01-19,1888,Accrington F.C.,Blackburn Rovers,0-2,0,2,1,1,2,-2,A
1889-01-19,1888,Aston Villa,West Bromwich Albion,2-0,2,0,1,1,2,2,H
1889-01-19,1888,Burnley,Derby County,1-0,1,0,1,1,1,1,H
1889-01-19,1888,Everton,Preston North End,0-2,0,2,1,1,2,-2,A
1889-01-19,1888,Notts County,Wolverhampton Wanderers,3-0,3,0,1,1,3,3,H
1889-01-19,1888,Stoke City,Bolton Wanderers,2-2,2,2,1,1,4,0,D
1889-01-26,1888,Accrington F.C.,Notts County,1-2,1,2,1,1,3,-1,A
1889-01-26,1888,Bolton Wanderers,Blackburn Rovers,3-2,3,2,1,1,5,1,H
1889-01-26,1888,Derby County,Stoke City,2-1,2,1,1,1,3,1,H
1889-01-26,1888,West Bromwich Albion,Aston Villa,3-3,3,3,1,1,6,0,D
1889-01-26,1888,Wolverhampton Wanderers,Everton,4-0,4,0,1,1,4,4,H
1889-02-04,1888,Blackburn Rovers,Burnley,4-2,4,2,1,1,6,2,H
1889-02-09,1888,Aston Villa,Preston North End,0-2,0,2,1,1,2,-2,A
1889-02-09,1888,Everton,Wolverhampton Wanderers,1-2,1,2,1,1,3,-1,A
1889-02-23,1888,West Bromwich Albion,Everton,1-0,1,0,1,1,1,1,H
1889-02-23,1888,Wolverhampton Wanderers,Notts County,2-1,2,1,1,1,3,1,H
1889-03-02,1888,Derby County,Burnley,1-0,1,0,1,1,1,1,H
1889-03-05,1888,Notts County,Bolton Wanderers,0-4,0,4,1,1,4,-4,A
1889-03-09,1888,Bolton Wanderers,Notts County,7-3,7,3,1,1,10,4,H
1889-03-09,1888,Derby County,Aston Villa,5-2,5,2,1,1,7,3,H
1889-03-16,1888,Notts County,Derby County,3-5,3,5,1,1,8,-2,A
1889-03-23,1888,Accrington F.C.,Bolton Wanderers,2-3,2,3,1,1,5,-1,A
1889-03-30,1888,Everton,Blackburn Rovers,3-1,3,1,1,1,4,2,H
1889-04-06,1888,Stoke City,Derby County,1-1,1,1,1,1,2,0,D
1889-04-15,1888,Blackburn Rovers,Derby County,3-0,3,0,1,1,3,3,H
1889-04-20,1888,Accrington F.C.,Stoke City,2-0,2,0,1,1,2,2,H
1889-09-07,1889,Aston Villa,Burnley,2-2,2,2,1,1,4,0,D
1889-09-07,1889,Everton,Blackburn Rovers,3-2,3,2,1,1,5,1,H
1889-09-07,1889,Stoke City,Derby County,1-1,1,1,1,1,2,0,D
1889-09-07,1889,Wolverhampton Wanderers,Notts County,2-0,2,0,1,1,2,2,H
1889-09-14,1889,Aston Villa,Notts County,1-1,1,1,1,1,2,0,D
1889-09-14,1889,Blackburn Rovers,Wolverhampton Wanderers,4-3,4,3,1,1,7,1,H
1889-09-14,1889,Bolton Wanderers,Accrington F.C.,2-4,2,4,1,1,6,-2,A
1889-09-14,1889,Derby County,West Bromwich Albion,3-1,3,1,1,1,4,2,H
1889-09-14,1889,Everton,Burnley,2-1,2,1,1,1,3,1,H
1889-09-14,1889,Preston North End,Stoke City,10-0,10,0,1,1,10,10,H
1889-09-16,1889,Wolverhampton Wanderers,Everton,2-1,2,1,1,1,3,1,H
1889-09-21,1889,Aston Villa,Preston North End,5-3,5,3,1,1,8,2,H
1889-09-21,1889,Blackburn Rovers,Derby County,4-2,4,2,1,1,6,2,H
1889-09-21,1889,Bolton Wanderers,Everton,3-4,3,4,1,1,7,-1,A
1889-09-21,1889,Burnley,Accrington F.C.,2-2,2,2,1,1,4,0,D
1889-09-21,1889,Notts County,West Bromwich Albion,1-2,1,2,1,1,3,-1,A
1889-09-28,1889,Accrington F.C.,Blackburn Rovers,2-2,2,2,1,1,4,0,D
1889-09-28,1889,Burnley,Preston North End,0-3,0,3,1,1,3,-3,A
1889-09-28,1889,Derby County,Notts County,2-0,2,0,1,1,2,2,H
1889-09-28,1889,Everton,Bolton Wanderers,3-0,3,0,1,1,3,3,H
1889-09-28,1889,Stoke City,Wolverhampton Wanderers,2-1,2,1,1,1,3,1,H
1889-09-28,1889,West Bromwich Albion,Aston Villa,3-0,3,0,1,1,3,3,H
1889-09-30,1889,Everton,Wolverhampton Wanderers,1-1,1,1,1,1,2,0,D
1889-10-05,1889,Burnley,Aston Villa,2-6,2,6,1,1,8,-4,A
1889-10-05,1889,Derby County,Everton,2-2,2,2,1,1,4,0,D
1889-10-05,1889,Notts County,Stoke City,3-1,3,1,1,1,4,2,H
1889-10-05,1889,Preston North End,West Bromwich Albion,5-0,5,0,1,1,5,5,H
1889-10-05,1889,Wolverhampton Wanderers,Accrington F.C.,2-1,2,1,1,1,3,1,H
1889-10-12,1889,Accrington F.C.,Notts County,1-8,1,8,1,1,9,-7,A
1889-10-12,1889,Aston Villa,Derby County,7-1,7,1,1,1,8,6,H
1889-10-12,1889,Bolton Wanderers,Preston North End,2-6,2,6,1,1,8,-4,A
1889-10-12,1889,Burnley,West Bromwich Albion,1-2,1,2,1,1,3,-1,A
1889-10-12,1889,Wolverhampton Wanderers,Stoke City,2-2,2,2,1,1,4,0,D
1889-10-19,1889,Accrington F.C.,Burnley,2-2,2,2,1,1,4,0,D
1889-10-19,1889,Blackburn Rovers,Aston Villa,7-0,7,0,1,1,7,7,H
1889-10-19,1889,Derby County,Preston North End,2-1,2,1,1,1,3,1,H
1889-10-19,1889,Notts County,Everton,4-3,4,3,1,1,7,1,H
1889-10-19,1889,Stoke City,Bolton Wanderers,0-1,0,1,1,1,1,-1,A
1889-10-19,1889,West Bromwich Albion,Wolverhampton Wanderers,1-4,1,4,1,1,5,-3,A
1889-10-26,1889,Aston Villa,West Bromwich Albion,1-0,1,0,1,1,1,1,H
1889-10-26,1889,Blackburn Rovers,Burnley,7-1,7,1,1,1,8,6,H
1889-10-26,1889,Bolton Wanderers,Notts County,0-4,0,4,1,1,4,-4,A
1889-10-26,1889,Derby County,Stoke City,2-0,2,0,1,1,2,2,H
1889-10-26,1889,Everton,Accrington F.C.,2-2,2,2,1,1,4,0,D
1889-10-26,1889,Preston North End,Wolverhampton Wanderers,0-2,0,2,1,1,2,-2,A
1889-11-02,1889,Aston Villa,Wolverhampton Wanderers,2-1,2,1,1,1,3,1,H
1889-11-02,1889,Blackburn Rovers,Preston North End,3-4,3,4,1,1,7,-1,A
1889-11-02,1889,Everton,Stoke City,8-0,8,0,1,1,8,8,H
1889-11-02,1889,Notts County,Burnley,1-1,1,1,1,1,2,0,D
1889-11-04,1889,West Bromwich Albion,Bolton Wanderers,6-3,6,3,1,1,9,3,H
1889-11-09,1889,Bolton Wanderers,Blackburn Rovers,3-2,3,2,1,1,5,1,H
1889-11-09,1889,Burnley,Wolverhampton Wanderers,1-2,1,2,1,1,3,-1,A
1889-11-09,1889,Notts County,Aston Villa,1-1,1,1,1,1,2,0,D
1889-11-09,1889,Preston North End,Accrington F.C.,3-1,3,1,1,1,4,2,H
1889-11-09,1889,Stoke City,Everton,1-2,1,2,1,1,3,-1,A
1889-11-09,1889,West Bromwich Albion,Derby County,2-3,2,3,1,1,5,-1,A
1889-11-11,1889,Stoke City,Preston North End,1-2,1,2,1,1,3,-1,A
1889-11-16,1889,Accrington F.C.,Derby County,6-1,6,1,1,1,7,5,H
1889-11-16,1889,Blackburn Rovers,Notts County,9-1,9,1,1,1,10,8,H
1889-11-16,1889,Bolton Wanderers,Aston Villa,2-0,2,0,1,1,2,2,H
1889-11-16,1889,Everton,Preston North End,1-5,1,5,1,1,6,-4,A
1889-11-16,1889,Stoke City,West Bromwich Albion,1-3,1,3,1,1,4,-2,A
1889-11-23,1889,Aston Villa,Everton,1-2,1,2,1,1,3,-1,A
1889-11-23,1889,Blackburn Rovers,Accrington F.C.,3-2,3,2,1,1,5,1,H
1889-11-23,1889,Derby County,Wolverhampton Wanderers,3-3,3,3,1,1,6,0,D
1889-11-23,1889,Preston North End,Bolton Wanderers,3-1,3,1,1,1,4,2,H
1889-11-23,1889,West Bromwich Albion,Burnley,6-1,6,1,1,1,7,5,H
1889-11-30,1889,Accrington F.C.,Aston Villa,4-2,4,2,1,1,6,2,H
1889-11-30,1889,Blackburn Rovers,West Bromwich Albion,5-0,5,0,1,1,5,5,H
1889-11-30,1889,Bolton Wanderers,Derby County,7-1,7,1,1,1,8,6,H
1889-11-30,1889,Preston North End,Burnley,6-0,6,0,1,1,6,6,H
1889-12-07,1889,Aston Villa,Stoke City,6-1,6,1,1,1,7,5,H
1889-12-07,1889,Bolton Wanderers,West Bromwich Albion,7-0,7,0,1,1,7,7,H
1889-12-07,1889,Everton,Notts County,5-3,5,3,1,1,8,2,H
1889-12-07,1889,Preston North End,Blackburn Rovers,1-1,1,1,1,1,2,0,D
1889-12-07,1889,Wolverhampton Wanderers,Burnley,9-1,9,1,1,1,10,8,H
1889-12-14,1889,Notts County,Wolverhampton Wanderers,0-2,0,2,1,1,2,-2,A
1889-12-21,1889,Blackburn Rovers,Bolton Wanderers,7-1,7,1,1,1,8,6,H
1889-12-21,1889,Notts County,Derby County,3-1,3,1,1,1,4,2,H
1889-12-21,1889,Preston North End,Everton,1-2,1,2,1,1,3,-1,A
1889-12-21,1889,West Bromwich Albion,Accrington F.C.,4-1,4,1,1,1,5,3,H
1889-12-21,1889,Wolverhampton Wanderers,Aston Villa,1-1,1,1,1,1,2,0,D
1889-12-23,1889,Stoke City,Blackburn Rovers,0-3,0,3,1,1,3,-3,A
1889-12-25,1889,Preston North End,Aston Villa,3-2,3,2,1,1,5,1,H
1889-12-26,1889,Aston Villa,Accrington F.C.,1-2,1,2,1,1,3,-1,A
1889-12-26,1889,Derby County,Bolton Wanderers,3-2,3,2,1,1,5,1,H
1889-12-26,1889,West Bromwich Albion,Preston North End,2-2,2,2,1,1,4,0,D
1889-12-26,1889,Wolverhampton Wanderers,Blackburn Rovers,2-4,2,4,1,1,6,-2,A
1889-12-28,1889,Accrington F.C.,Stoke City,2-1,2,1,1,1,3,1,H
1889-12-28,1889,Blackburn Rovers,Everton,2-4,2,4,1,1,6,-2,A
1889-12-28,1889,Derby County,Aston Villa,5-0,5,0,1,1,5,5,H
1889-12-28,1889,Wolverhampton Wanderers,West Bromwich Albion,1-1,1,1,1,1,2,0,D
1890-01-01,1889,Accrington F.C.,Wolverhampton Wanderers,6-3,6,3,1,1,9,3,H
1890-01-04,1889,Accrington F.C.,Bolton Wanderers,3-1,3,1,1,1,4,2,H
1890-01-04,1889,Blackburn Rovers,Stoke City,8-0,8,0,1,1,8,8,H
1890-01-04,1889,Derby County,Burnley,4-1,4,1,1,1,5,3,H
1890-01-04,1889,Everton,Aston Villa,7-0,7,0,1,1,7,7,H
1890-01-04,1889,West Bromwich Albion,Notts County,4-2,4,2,1,1,6,2,H
1890-01-04,1889,Wolverhampton Wanderers,Preston North End,0-1,0,1,1,1,1,-1,A
1890-01-11,1889,Burnley,Stoke City,1-3,1,3,1,1,4,-2,A
1890-01-11,1889,Notts County,Bolton Wanderers,3-5,3,5,1,1,8,-2,A
1890-01-11,1889,Preston North End,Derby County,5-0,5,0,1,1,5,5,H
1890-01-11,1889,West Bromwich Albion,Blackburn Rovers,3-2,3,2,1,1,5,1,H
1890-01-25,1889,Aston Villa,Bolton Wanderers,1-2,1,2,1,1,3,-1,A
1890-01-25,1889,Wolverhampton Wanderers,Derby County,2-1,2,1,1,1,3,1,H
1890-02-08,1889,Accrington F.C.,West Bromwich Albion,0-0,0,0,1,1,0,0,D
1890-02-08,1889,Bolton Wanderers,Stoke City,5-0,5,0,1,1,5,5,H
1890-02-08,1889,Burnley,Everton,0-1,0,1,1,1,1,-1,A
1890-02-08,1889,Derby County,Blackburn Rovers,4-0,4,0,1,1,4,4,H
1890-02-15,1889,Derby County,Accrington F.C.,2-3,2,3,1,1,5,-1,A
1890-02-18,1889,Notts County,Blackburn Rovers,1-1,1,1,1,1,2,0,D
1890-02-22,1889,Accrington F.C.,Everton,5-3,5,3,1,1,8,2,H
1890-02-22,1889,Burnley,Blackburn Rovers,1-2,1,2,1,1,3,-1,A
1890-02-24,1889,Bolton Wanderers,Wolverhampton Wanderers,4-1,4,1,1,1,5,3,H
1890-03-01,1889,Burnley,Bolton Wanderers,7-0,7,0,1,1,7,7,H
1890-03-01,1889,Preston North End,Notts County,4-3,4,3,1,1,7,1,H
1890-03-01,1889,Stoke City,Accrington F.C.,7-1,7,1,1,1,8,6,H
1890-03-08,1889,Burnley,Derby County,2-0,2,0,1,1,2,2,H
1890-03-08,1889,Everton,West Bromwich Albion,5-1,5,1,1,1,6,4,H
1890-03-10,1889,Stoke City,Burnley,3-4,3,4,1,1,7,-1,A
1890-03-13,1889,Notts County,Accrington F.C.,3-1,3,1,1,1,4,2,H
1890-03-15,1889,Accrington F.C.,Preston North End,2-2,2,2,1,1,4,0,D
1890-03-15,1889,Burnley,Notts County,3-0,3,0,1,1,3,3,H
1890-03-15,1889,Everton,Derby County,3-0,3,0,1,1,3,3,H
1890-03-15,1889,West Bromwich Albion,Stoke City,2-1,2,1,1,1,3,1,H
1890-03-15,1889,Wolverhampton Wanderers,Bolton Wanderers,5-1,5,1,1,1,6,4,H
1890-03-17,1889,Bolton Wanderers,Burnley,2-2,2,2,1,1,4,0,D
1890-03-17,1889,Stoke City,Aston Villa,1-1,1,1,1,1,2,0,D
1890-03-22,1889,West Bromwich Albion,Everton,4-1,4,1,1,1,5,3,H
1890-03-24,1889,Stoke City,Notts County,1-1,1,1,1,1,2,0,D
1890-03-27,1889,Notts County,Preston North End,0-1,0,1,1,1,1,-1,A
1890-03-31,1889,Aston Villa,Blackburn Rovers,3-0,3,0,1,1,3,3,H
1890-09-06,1890,Accrington F.C.,Burnley,1-1,1,1,1,1,2,0,D
1890-09-06,1890,Bolton Wanderers,Notts County,4-2,4,2,1,1,6,2,H
1890-09-06,1890,Derby County,Blackburn Rovers,8-5,8,5,1,1,13,3,H
1890-09-06,1890,West Bromwich Albion,Everton,1-4,1,4,1,1,5,-3,A
1890-09-06,1890,Wolverhampton Wanderers,Aston Villa,2-1,2,1,1,1,3,1,H
1890-09-13,1890,Aston Villa,Notts County,3-2,3,2,1,1,5,1,H
1890-09-13,1890,Blackburn Rovers,Accrington F.C.,0-0,0,0,1,1,0,0,D
1890-09-13,1890,Bolton Wanderers,Derby County,3-1,3,1,1,1,4,2,H
1890-09-13,1890,Everton,Wolverhampton Wanderers,5-0,5,0,1,1,5,5,H
1890-09-13,1890,Preston North End,West Bromwich Albion,3-0,3,0,1,1,3,3,H
1890-09-13,1890,Sunderland,Burnley,2-3,2,3,1,1,5,-1,A
1890-09-15,1890,Sunderland,Wolverhampton Wanderers,3-4,3,4,1,1,7,-1,A
1890-09-20,1890,Bolton Wanderers,Everton,0-5,0,5,1,1,5,-5,A
1890-09-20,1890,Burnley,Aston Villa,2-1,2,1,1,1,3,1,H
1890-09-20,1890,Derby County,Preston North End,1-3,1,3,1,1,4,-2,A
1890-09-20,1890,Notts County,Accrington F.C.,5-0,5,0,1,1,5,5,H
1890-09-20,1890,West Bromwich Albion,Sunderland,0-4,0,4,1,1,4,-4,A
1890-09-22,1890,Wolverhampton Wanderers,Notts County,1-1,1,1,1,1,2,0,D
1890-09-27,1890,Accrington F.C.,Everton,1-2,1,2,1,1,3,-1,A
1890-09-27,1890,Aston Villa,West Bromwich Albion,0-4,0,4,1,1,4,-4,A
1890-09-27,1890,Blackburn Rovers,Wolverhampton Wanderers,2-3,2,3,1,1,5,-1,A
1890-09-27,1890,Burnley,Sunderland,3-3,3,3,1,1,6,0,D
1890-09-27,1890,Notts County,Derby County,2-1,2,1,1,1,3,1,H
1890-09-27,1890,Preston North End,Bolton Wanderers,1-0,1,0,1,1,1,1,H
1890-10-02,1890,Notts County,Bolton Wanderers,3-1,3,1,1,1,4,2,H
1890-10-04,1890,Bolton Wanderers,Aston Villa,4-0,4,0,1,1,4,4,H
1890-10-04,1890,Everton,Derby County,7-0,7,0,1,1,7,7,H
1890-10-04,1890,Preston North End,Blackburn Rovers,1-2,1,2,1,1,3,-1,A
1890-10-04,1890,West Bromwich Albion,Burnley,3-1,3,1,1,1,4,2,H
1890-10-04,1890,Wolverhampton Wanderers,Accrington F.C.,3-0,3,0,1,1,3,3,H
1890-10-11,1890,Accrington F.C.,Preston North End,1-3,1,3,1,1,4,-2,A
1890-10-11,1890,Aston Villa,Everton,2-2,2,2,1,1,4,0,D
1890-10-11,1890,Blackburn Rovers,Sunderland,3-2,3,2,1,1,5,1,H
1890-10-11,1890,Burnley,Bolton Wanderers,1-2,1,2,1,1,3,-1,A
1890-10-11,1890,Notts County,West Bromwich Albion,3-2,3,2,1,1,5,1,H
1890-10-11,1890,Wolverhampton Wanderers,Derby County,5-1,5,1,1,1,6,4,H
1890-10-18,1890,Burnley,Blackburn Rovers,1-6,1,6,1,1,7,-5,A
1890-10-18,1890,Derby County,Aston Villa,5-4,5,4,1,1,9,1,H
1890-10-18,1890,Everton,Bolton Wanderers,2-0,2,0,1,1,2,2,H
1890-10-18,1890,Preston North End,Wolverhampton Wanderers,5-1,5,1,1,1,6,4,H
1890-10-18,1890,Sunderland,Accrington F.C.,2-2,2,2,1,1,4,0,D
1890-10-18,1890,West Bromwich Albion,Notts County,1-1,1,1,1,1,2,0,D
1890-10-25,1890,Accrington F.C.,Notts County,3-2,3,2,1,1,5,1,H
1890-10-25,1890,Aston Villa,Derby County,4-0,4,0,1,1,4,4,H
1890-10-25,1890,Blackburn Rovers,Preston North End,1-0,1,0,1,1,1,1,H
1890-10-25,1890,Bolton Wanderers,Sunderland,2-5,2,5,1,1,7,-3,A
1890-10-25,1890,Everton,West Bromwich Albion,2-3,2,3,1,1,5,-1,A
1890-10-25,1890,Wolverhampton Wanderers,Burnley,3-1,3,1,1,1,4,2,H
1890-11-01,1890,Burnley,Wolverhampton Wanderers,4-2,4,2,1,1,6,2,H
1890-11-01,1890,Notts County,Everton,3-1,3,1,1,1,4,2,H
1890-11-01,1890,Preston North End,Accrington F.C.,1-1,1,1,1,1,2,0,D
1890-11-01,1890,Sunderland,Blackburn Rovers,3-1,3,1,1,1,4,2,H
1890-11-01,1890,West Bromwich Albion,Aston Villa,0-3,0,3,1,1,3,-3,A
1890-11-03,1890,West Bromwich Albion,Bolton Wanderers,2-4,2,4,1,1,6,-2,A
1890-11-08,1890,Accrington F.C.,Derby County,4-0,4,0,1,1,4,4,H
1890-11-08,1890,Aston Villa,Burnley,4-4,4,4,1,1,8,0,D
1890-11-08,1890,Blackburn Rovers,Everton,2-1,2,1,1,1,3,1,H
1890-11-08,1890,Preston North End,Notts County,0-0,0,0,1,1,0,0,D
1890-11-08,1890,Sunderland,West Bromwich Albion,1-1,1,1,1,1,2,0,D
1890-11-08,1890,Wolverhampton Wanderers,Bolton Wanderers,1-0,1,0,1,1,1,1,H
1890-11-15,1890,Aston Villa,Accrington F.C.,3-1,3,1,1,1,4,2,H
1890-11-15,1890,Bolton Wanderers,Preston North End,1-0,1,0,1,1,1,1,H
1890-11-15,1890,Burnley,Derby County,6-1,6,1,1,1,7,5,H
1890-11-15,1890,Everton,Sunderland,1-0,1,0,1,1,1,1,H
1890-11-15,1890,Notts County,Blackburn Rovers,1-2,1,2,1,1,3,-1,A
1890-11-22,1890,Accrington F.C.,Sunderland,4-1,4,1,1,1,5,3,H
1890-11-22,1890,Aston Villa,Bolton Wanderers,5-0,5,0,1,1,5,5,H
1890-11-22,1890,Blackburn Rovers,Burnley,5-2,5,2,1,1,7,3,H
1890-11-22,1890,Derby County,West Bromwich Albion,3-1,3,1,1,1,4,2,H
1890-11-22,1890,Notts County,Wolverhampton Wanderers,1-1,1,1,1,1,2,0,D
1890-11-22,1890,Preston North End,Everton,2-0,2,0,1,1,2,2,H
1890-11-29,1890,Burnley,Accrington F.C.,2-0,2,0,1,1,2,2,H
1890-11-29,1890,Everton,Blackburn Rovers,3-1,3,1,1,1,4,2,H
1890-11-29,1890,Notts County,Aston Villa,7-1,7,1,1,1,8,6,H
1890-11-29,1890,West Bromwich Albion,Derby County,3-4,3,4,1,1,7,-1,A
1890-11-29,1890,Wolverhampton Wanderers,Preston North End,2-0,2,0,1,1,2,2,H
1890-12-06,1890,Blackburn Rovers,Aston Villa,5-1,5,1,1,1,6,4,H
1890-12-06,1890,Burnley,West Bromwich Albion,5-4,5,4,1,1,9,1,H
1890-12-06,1890,Derby County,Accrington F.C.,1-2,1,2,1,1,3,-1,A
1890-12-06,1890,Notts County,Preston North End,2-1,2,1,1,1,3,1,H
1890-12-06,1890,Wolverhampton Wanderers,Everton,0-1,0,1,1,1,1,-1,A
1890-12-13,1890,Aston Villa,Blackburn Rovers,2-2,2,2,1,1,4,0,D
1890-12-13,1890,Bolton Wanderers,Accrington F.C.,6-0,6,0,1,1,6,6,H
1890-12-13,1890,Derby County,Everton,2-6,2,6,1,1,8,-4,A
1890-12-13,1890,West Bromwich Albion,Wolverhampton Wanderers,0-1,0,1,1,1,1,-1,A
1890-12-15,1890,Notts County,Sunderland,2-1,2,1,1,1,3,1,H
1890-12-20,1890,Blackburn Rovers,West Bromwich Albion,2-1,2,1,1,1,3,1,H
1890-12-20,1890,Burnley,Notts County,0-1,0,1,1,1,1,-1,A
1890-12-20,1890,Preston North End,Derby County,6-0,6,0,1,1,6,6,H
1890-12-20,1890,Sunderland,Everton,1-0,1,0,1,1,1,1,H
1890-12-26,1890,Aston Villa,Sunderland,0-0,0,0,1,1,0,0,D
1890-12-26,1890,Derby County,Bolton Wanderers,1-1,1,1,1,1,2,0,D
1890-12-26,1890,Everton,Accrington F.C.,3-2,3,2,1,1,5,1,H
1890-12-26,1890,Wolverhampton Wanderers,Blackburn Rovers,2-0,2,0,1,1,2,2,H
1890-12-27,1890,Derby County,Notts County,3-1,3,1,1,1,4,2,H
1890-12-27,1890,Everton,Burnley,7-3,7,3,1,1,10,4,H
1890-12-27,1890,Wolverhampton Wanderers,Sunderland,0-3,0,3,1,1,3,-3,A
1890-12-29,1890,Bolton Wanderers,Wolverhampton Wanderers,6-0,6,0,1,1,6,6,H
1891-01-01,1890,Accrington F.C.,Wolverhampton Wanderers,1-2,1,2,1,1,3,-1,A
1891-01-01,1890,Everton,Aston Villa,5-0,5,0,1,1,5,5,H
1891-01-03,1890,Blackburn Rovers,Derby County,8-0,8,0,1,1,8,8,H
1891-01-03,1890,Everton,Notts County,4-2,4,2,1,1,6,2,H
1891-01-03,1890,Wolverhampton Wanderers,West Bromwich Albion,4-0,4,0,1,1,4,4,H
1891-01-10,1890,Accrington F.C.,Bolton Wanderers,2-1,2,1,1,1,3,1,H
1891-01-10,1890,Derby County,Wolverhampton Wanderers,9-0,9,0,1,1,9,9,H
1891-01-10,1890,Everton,Preston North End,0-1,0,1,1,1,1,-1,A
1891-01-10,1890,Sunderland,Aston Villa,5-1,5,1,1,1,6,4,H
1891-01-24,1890,Derby County,Burnley,2-4,2,4,1,1,6,-2,A
1891-01-24,1890,Preston North End,Aston Villa,4-1,4,1,1,1,5,3,H
1891-01-24,1890,Sunderland,Notts County,4-0,4,0,1,1,4,4,H
1891-02-05,1890,Preston North End,Burnley,7-0,7,0,1,1,7,7,H
1891-02-07,1890,Derby County,Sunderland,3-1,3,1,1,1,4,2,H
1891-02-07,1890,West Bromwich Albion,Preston North End,1-3,1,3,1,1,4,-2,A
1891-02-10,1890,Notts County,Burnley,4-0,4,0,1,1,4,4,H
1891-02-10,1890,Sunderland,Bolton Wanderers,2-0,2,0,1,1,2,2,H
1891-02-21,1890,Preston North End,Sunderland,0-0,0,0,1,1,0,0,D
1891-03-04,1890,Accrington F.C.,Blackburn Rovers,0-4,0,4,1,1,4,-4,A
1891-03-07,1890,Blackburn Rovers,Bolton Wanderers,0-2,0,2,1,1,2,-2,A
1891-03-07,1890,Burnley,Preston North End,6-2,6,2,1,1,8,4,H
1891-03-07,1890,West Bromwich Albion,Accrington F.C.,5-1,5,1,1,1,6,4,H
1891-03-09,1890,Aston Villa,Preston North End,0-1,0,1,1,1,1,-1,A
1891-03-09,1890,West Bromwich Albion,Blackburn Rovers,1-0,1,0,1,1,1,1,H
1891-03-14,1890,Aston Villa,Wolverhampton Wanderers,6-2,6,2,1,1,8,4,H
1891-03-14,1890,Blackburn Rovers,Notts County,1-7,1,7,1,1,8,-6,A
1891-03-14,1890,Bolton Wanderers,West Bromwich Albion,7-1,7,1,1,1,8,6,H
1891-03-14,1890,Burnley,Everton,3-2,3,2,1,1,5,1,H
1891-03-14,1890,Sunderland,Preston North End,3-0,3,0,1,1,3,3,H
1891-03-21,1890,Accrington F.C.,Aston Villa,1-3,1,3,1,1,4,-2,A
1891-03-21,1890,Bolton Wanderers,Burnley,1-0,1,0,1,1,1,1,H
1891-03-21,1890,Sunderland,Derby County,5-1,5,1,1,1,6,4,H
1891-03-28,1890,Bolton Wanderers,Blackburn Rovers,2-0,2,0,1,1,2,2,H
1891-04-18,1890,Accrington F.C.,West Bromwich Albion,1-0,1,0,1,1,1,1,H
1891-09-05,1891,Accrington F.C.,Burnley,1-0,1,0,1,1,1,1,H
1891-09-05,1891,Aston Villa,Blackburn Rovers,5-1,5,1,1,1,6,4,H
1891-09-05,1891,Darwen,Bolton Wanderers,1-2,1,2,1,1,3,-1,A
1891-09-05,1891,Notts County,Preston North End,2-0,2,0,1,1,2,2,H
1891-09-05,1891,Stoke City,Derby County,2-1,2,1,1,1,3,1,H
1891-09-05,1891,Sunderland,Wolverhampton Wanderers,5-2,5,2,1,1,7,3,H
1891-09-05,1891,West Bromwich Albion,Everton,4-0,4,0,1,1,4,4,H
1891-09-07,1891,Burnley,Preston North End,2-0,2,0,1,1,2,2,H
1891-09-07,1891,Everton,Darwen,5-3,5,3,1,1,8,2,H
1891-09-12,1891,Aston Villa,West Bromwich Albion,5-1,5,1,1,1,6,4,H
1891-09-12,1891,Blackburn Rovers,Notts County,5-4,5,4,1,1,9,1,H
1891-09-12,1891,Bolton Wanderers,Darwen,1-0,1,0,1,1,1,1,H
1891-09-12,1891,Derby County,Accrington F.C.,3-1,3,1,1,1,4,2,H
1891-09-12,1891,Preston North End,Sunderland,3-1,3,1,1,1,4,2,H
1891-09-12,1891,Stoke City,Wolverhampton Wanderers,1-3,1,3,1,1,4,-2,A
1891-09-14,1891,Wolverhampton Wanderers,Accrington F.C.,5-0,5,0,1,1,5,5,H
1891-09-19,1891,Bolton Wanderers,Sunderland,4-3,4,3,1,1,7,1,H
1891-09-19,1891,Burnley,Stoke City,4-1,4,1,1,1,5,3,H
1891-09-19,1891,Darwen,Accrington F.C.,5-2,5,2,1,1,7,3,H
1891-09-19,1891,Derby County,Notts County,3-0,3,0,1,1,3,3,H
1891-09-19,1891,Everton,Blackburn Rovers,3-1,3,1,1,1,4,2,H
1891-09-19,1891,Preston North End,Aston Villa,0-1,0,1,1,1,1,-1,A
1891-09-19,1891,West Bromwich Albion,Wolverhampton Wanderers,4-3,4,3,1,1,7,1,H
1891-09-21,1891,Preston North End,Burnley,5-1,5,1,1,1,6,4,H
1891-09-26,1891,Accrington F.C.,Everton,1-1,1,1,1,1,2,0,D
1891-09-26,1891,Blackburn Rovers,Burnley,3-3,3,3,1,1,6,0,D
1891-09-26,1891,Bolton Wanderers,Preston North End,3-0,3,0,1,1,3,3,H
1891-09-26,1891,Notts County,Stoke City,1-1,1,1,1,1,2,0,D
1891-09-26,1891,Wolverhampton Wanderers,Derby County,1-3,1,3,1,1,4,-2,A
1891-09-28,1891,Aston Villa,Sunderland,5-3,5,3,1,1,8,2,H
1891-09-28,1891,Wolverhampton Wanderers,Darwen,2-2,2,2,1,1,4,0,D
1891-10-01,1891,Notts County,Bolton Wanderers,2-0,2,0,1,1,2,2,H
1891-10-03,1891,Bolton Wanderers,Accrington F.C.,3-4,3,4,1,1,7,-1,A
1891-10-03,1891,Darwen,Stoke City,9-3,9,3,1,1,12,6,H
1891-10-03,1891,Derby County,Aston Villa,4-2,4,2,1,1,6,2,H
1891-10-03,1891,Preston North End,Wolverhampton Wanderers,2-0,2,0,1,1,2,2,H
1891-10-03,1891,Sunderland,Everton,2-1,2,1,1,1,3,1,H
1891-10-03,1891,West Bromwich Albion,Blackburn Rovers,2-2,2,2,1,1,4,0,D
1891-10-10,1891,Accrington F.C.,Darwen,1-1,1,1,1,1,2,0,D
1891-10-10,1891,Aston Villa,Bolton Wanderers,1-2,1,2,1,1,3,-1,A
1891-10-10,1891,Blackburn Rovers,Wolverhampton Wanderers,2-0,2,0,1,1,2,2,H
1891-10-10,1891,Everton,Preston North End,1-1,1,1,1,1,2,0,D
1891-10-10,1891,Notts County,West Bromwich Albion,4-0,4,0,1,1,4,4,H
1891-10-10,1891,Stoke City,Burnley,3-0,3,0,1,1,3,3,H
1891-10-17,1891,Bolton Wanderers,Everton,1-0,1,0,1,1,1,1,H
1891-10-17,1891,Burnley,Aston Villa,4-1,4,1,1,1,5,3,H
1891-10-17,1891,Darwen,Blackburn Rovers,3-5,3,5,1,1,8,-2,A
1891-10-17,1891,Derby County,Stoke City,3-3,3,3,1,1,6,0,D
1891-10-17,1891,West Bromwich Albion,Sunderland,2-5,2,5,1,1,7,-3,A
1891-10-17,1891,Wolverhampton Wanderers,Notts County,2-1,2,1,1,1,3,1,H
1891-10-24,1891,Accrington F.C.,Wolverhampton Wanderers,3-2,3,2,1,1,5,1,H
1891-10-24,1891,Blackburn Rovers,Preston North End,2-4,2,4,1,1,6,-2,A
1891-10-24,1891,Bolton Wanderers,Burnley,2-0,2,0,1,1,2,2,H
1891-10-24,1891,Derby County,Everton,0-3,0,3,1,1,3,-3,A
1891-10-24,1891,Notts County,Darwen,5-0,5,0,1,1,5,5,H
1891-10-24,1891,Stoke City,Aston Villa,2-3,2,3,1,1,5,-1,A
1891-10-24,1891,Sunderland,West Bromwich Albion,4-0,4,0,1,1,4,4,H
1891-10-31,1891,Bolton Wanderers,Blackburn Rovers,4-2,4,2,1,1,6,2,H
1891-10-31,1891,Darwen,Aston Villa,1-5,1,5,1,1,6,-4,A
1891-10-31,1891,Derby County,Wolverhampton Wanderers,2-1,2,1,1,1,3,1,H
1891-10-31,1891,Preston North End,Everton,4-0,4,0,1,1,4,4,H
1891-10-31,1891,Sunderland,Accrington F.C.,4-1,4,1,1,1,5,3,H
1891-10-31,1891,West Bromwich Albion,Notts County,2-2,2,2,1,1,4,0,D
1891-11-02,1891,West Bromwich Albion,Bolton Wanderers,0-2,0,2,1,1,2,-2,A
1891-11-07,1891,Accrington F.C.,Bolton Wanderers,0-3,0,3,1,1,3,-3,A
1891-11-07,1891,Aston Villa,Notts County,5-1,5,1,1,1,6,4,H
1891-11-07,1891,Blackburn Rovers,Sunderland,3-1,3,1,1,1,4,2,H
1891-11-07,1891,Everton,West Bromwich Albion,4-3,4,3,1,1,7,1,H
1891-11-07,1891,Stoke City,Preston North End,0-1,0,1,1,1,1,-1,A
1891-11-07,1891,Wolverhampton Wanderers,Burnley,0-0,0,0,1,1,0,0,D
1891-11-09,1891,Stoke City,Blackburn Rovers,0-1,0,1,1,1,1,-1,A
1891-11-14,1891,Bolton Wanderers,Stoke City,1-1,1,1,1,1,2,0,D
1891-11-14,1891,Burnley,Accrington F.C.,2-1,2,1,1,1,3,1,H
1891-11-14,1891,Darwen,Everton,3-1,3,1,1,1,4,2,H
1891-11-14,1891,Notts County,Wolverhampton Wanderers,2-2,2,2,1,1,4,0,D
1891-11-14,1891,Preston North End,Blackburn Rovers,3-2,3,2,1,1,5,1,H
1891-11-14,1891,Sunderland,Derby County,7-1,7,1,1,1,8,6,H
1891-11-14,1891,West Bromwich Albion,Aston Villa,0-3,0,3,1,1,3,-3,A
1891-11-21,1891,Accrington F.C.,Notts County,2-0,2,0,1,1,2,2,H
1891-11-21,1891,Aston Villa,Stoke City,2-1,2,1,1,1,3,1,H
1891-11-21,1891,Blackburn Rovers,Bolton Wanderers,4-0,4,0,1,1,4,4,H
1891-11-21,1891,Derby County,Darwen,7-0,7,0,1,1,7,7,H
1891-11-21,1891,Sunderland,Burnley,2-1,2,1,1,1,3,1,H
1891-11-21,1891,West Bromwich Albion,Preston North End,1-2,1,2,1,1,3,-1,A
1891-11-21,1891,Wolverhampton Wanderers,Everton,5-1,5,1,1,1,6,4,H
1891-11-28,1891,Burnley,West Bromwich Albion,3-2,3,2,1,1,5,1,H
1891-11-28,1891,Darwen,Derby County,2-0,2,0,1,1,2,2,H
1891-11-28,1891,Everton,Aston Villa,5-1,5,1,1,1,6,4,H
1891-11-28,1891,Notts County,Accrington F.C.,9-0,9,0,1,1,9,9,H
1891-11-28,1891,Preston North End,Bolton Wanderers,4-0,4,0,1,1,4,4,H
1891-11-28,1891,Stoke City,Sunderland,1-3,1,3,1,1,4,-2,A
1891-11-28,1891,Wolverhampton Wanderers,Blackburn Rovers,6-1,6,1,1,1,7,5,H
1891-12-05,1891,Aston Villa,Burnley,6-1,6,1,1,1,7,5,H
1891-12-05,1891,Blackburn Rovers,Everton,2-2,2,2,1,1,4,0,D
1891-12-05,1891,Bolton Wanderers,Wolverhampton Wanderers,3-0,3,0,1,1,3,3,H
1891-12-05,1891,Derby County,Preston North End,1-2,1,2,1,1,3,-1,A
1891-12-05,1891,Stoke City,Darwen,5-1,5,1,1,1,6,4,H
1891-12-05,1891,Sunderland,Notts County,4-0,4,0,1,1,4,4,H
1891-12-05,1891,West Bromwich Albion,Accrington F.C.,3-1,3,1,1,1,4,2,H
1891-12-12,1891,Burnley,Blackburn Rovers,3-0,3,0,1,1,3,3,H
1891-12-12,1891,Everton,Wolverhampton Wanderers,2-1,2,1,1,1,3,1,H
1891-12-12,1891,Preston North End,Notts County,6-0,6,0,1,1,6,6,H
1891-12-12,1891,Stoke City,Bolton Wanderers,0-1,0,1,1,1,1,-1,A
1891-12-12,1891,Sunderland,Darwen,7-0,7,0,1,1,7,7,H
1891-12-12,1891,West Bromwich Albion,Derby County,4-2,4,2,1,1,6,2,H
1891-12-19,1891,Bolton Wanderers,West Bromwich Albion,1-1,1,1,1,1,2,0,D
1891-12-19,1891,Derby County,Burnley,0-1,0,1,1,1,1,-1,A
1891-12-19,1891,Notts County,Blackburn Rovers,2-2,2,2,1,1,4,0,D
1891-12-19,1891,Stoke City,Accrington F.C.,3-1,3,1,1,1,4,2,H
1891-12-19,1891,Wolverhampton Wanderers,Aston Villa,2-0,2,0,1,1,2,2,H
1891-12-25,1891,Blackburn Rovers,Darwen,4-0,4,0,1,1,4,4,H
1891-12-25,1891,Everton,Sunderland,0-4,0,4,1,1,4,-4,A
1891-12-25,1891,Preston North End,Stoke City,3-2,3,2,1,1,5,1,H
1891-12-26,1891,Aston Villa,Darwen,7-0,7,0,1,1,7,7,H
1891-12-26,1891,Blackburn Rovers,Accrington F.C.,2-2,2,2,1,1,4,0,D
1891-12-26,1891,Derby County,Bolton Wanderers,3-2,3,2,1,1,5,1,H
1891-12-26,1891,West Bromwich Albion,Burnley,1-0,1,0,1,1,1,1,H
1891-12-26,1891,Wolverhampton Wanderers,Sunderland,1-3,1,3,1,1,4,-2,A
1891-12-28,1891,Aston Villa,Everton,3-4,3,4,1,1,7,-1,A
1891-12-28,1891,Wolverhampton Wanderers,West Bromwich Albion,2-1,2,1,1,1,3,1,H
1892-01-01,1891,Bolton Wanderers,Derby County,3-1,3,1,1,1,4,2,H
1892-01-01,1891,Darwen,Preston North End,0-4,0,4,1,1,4,-4,A
1892-01-02,1891,Accrington F.C.,Preston North End,1-3,1,3,1,1,4,-2,A
1892-01-02,1891,Blackburn Rovers,Derby County,0-2,0,2,1,1,2,-2,A
1892-01-02,1891,Everton,Burnley,1-1,1,1,1,1,2,0,D
1892-01-02,1891,Notts County,Aston Villa,5-2,5,2,1,1,7,3,H
1892-01-02,1891,Wolverhampton Wanderers,Stoke City,4-1,4,1,1,1,5,3,H
1892-01-04,1891,Accrington F.C.,Aston Villa,3-2,3,2,1,1,5,1,H
1892-01-09,1891,Accrington F.C.,Stoke City,3-0,3,0,1,1,3,3,H
1892-01-09,1891,Aston Villa,Derby County,6-0,6,0,1,1,6,6,H
1892-01-09,1891,Burnley,Darwen,9-0,9,0,1,1,9,9,H
1892-01-09,1891,Notts County,Everton,1-3,1,3,1,1,4,-2,A
1892-01-09,1891,Preston North End,West Bromwich Albion,1-0,1,0,1,1,1,1,H
1892-01-23,1891,Accrington F.C.,West Bromwich Albion,4-2,4,2,1,1,6,2,H
1892-02-06,1891,Derby County,West Bromwich Albion,1-1,1,1,1,1,2,0,D
1892-02-06,1891,Stoke City,Notts County,1-3,1,3,1,1,4,-2,A
1892-02-13,1891,Burnley,Everton,1-0,1,0,1,1,1,1,H
1892-02-20,1891,Notts County,Derby County,2-1,2,1,1,1,3,1,H
1892-02-27,1891,Accrington F.C.,Blackburn Rovers,1-0,1,0,1,1,1,1,H
1892-02-27,1891,Darwen,Notts County,2-3,2,3,1,1,5,-1,A
1892-03-01,1891,Darwen,Wolverhampton Wanderers,1-4,1,4,1,1,5,-3,A
1892-03-01,1891,Notts County,Burnley,5-1,5,1,1,1,6,4,H
1892-03-01,1891,Sunderland,Bolton Wanderers,4-1,4,1,1,1,5,3,H
1892-03-05,1891,Accrington F.C.,Sunderland,3-5,3,5,1,1,8,-2,A
1892-03-05,1891,Blackburn Rovers,Aston Villa,4-3,4,3,1,1,7,1,H
1892-03-05,1891,Burnley,Bolton Wanderers,1-2,1,2,1,1,3,-1,A
1892-03-05,1891,Everton,Stoke City,1-0,1,0,1,1,1,1,H
1892-03-05,1891,Preston North End,Derby County,3-0,3,0,1,1,3,3,H
1892-03-12,1891,Aston Villa,Accrington F.C.,12-2,12,2,1,1,14,10,H
1892-03-12,1891,Blackburn Rovers,West Bromwich Albion,3-2,3,2,1,1,5,1,H
1892-03-12,1891,Stoke City,Everton,0-1,0,1,1,1,1,-1,A
1892-03-12,1891,Sunderland,Preston North End,4-1,4,1,1,1,5,3,H
1892-03-19,1891,Blackburn Rovers,Stoke City,5-3,5,3,1,1,8,2,H
1892-03-19,1891,Derby County,Sunderland,0-1,0,1,1,1,1,-1,A
1892-03-19,1891,Everton,Accrington F.C.,3-0,3,0,1,1,3,3,H
1892-03-26,1891,Bolton Wanderers,Notts County,2-0,2,0,1,1,2,2,H
1892-03-26,1891,Burnley,Wolverhampton Wanderers,1-1,1,1,1,1,2,0,D
1892-03-26,1891,Derby County,Blackburn Rovers,1-1,1,1,1,1,2,0,D
1892-03-26,1891,Sunderland,Aston Villa,2-1,2,1,1,1,3,1,H
1892-04-02,1891,Accrington F.C.,Derby County,1-1,1,1,1,1,2,0,D
1892-04-02,1891,Bolton Wanderers,Aston Villa,1-2,1,2,1,1,3,-1,A
1892-04-02,1891,Darwen,Burnley,2-6,2,6,1,1,8,-4,A
1892-04-02,1891,Sunderland,Stoke City,4-1,4,1,1,1,5,3,H
1892-04-02,1891,Wolverhampton Wanderers,Preston North End,3-0,3,0,1,1,3,3,H
1892-04-04,1891,West Bromwich Albion,Darwen,12-0,12,0,1,1,12,12,H
1892-04-09,1891,Notts County,Sunderland,1-0,1,0,1,1,1,1,H
1892-04-11,1891,West Bromwich Albion,Stoke City,2-2,2,2,1,1,4,0,D
1892-04-15,1891,Burnley,Notts County,1-0,1,0,1,1,1,1,H
1892-04-15,1891,Everton,Derby County,1-2,1,2,1,1,3,-1,A
1892-04-15,1891,Preston North End,Accrington F.C.,4-1,4,1,1,1,5,3,H
1892-04-16,1891,Aston Villa,Preston North End,3-1,3,1,1,1,4,2,H
1892-04-16,1891,Burnley,Derby County,2-4,2,4,1,1,6,-2,A
1892-04-16,1891,Darwen,West Bromwich Albion,1-1,1,1,1,1,2,0,D
1892-04-16,1891,Everton,Notts County,4-0,4,0,1,1,4,4,H
1892-04-16,1891,Sunderland,Blackburn Rovers,6-1,6,1,1,1,7,5,H
1892-04-16,1891,Wolverhampton Wanderers,Bolton Wanderers,1-2,1,2,1,1,3,-1,A
1892-04-18,1891,Aston Villa,Wolverhampton Wanderers,3-6,3,6,1,1,9,-3,A
1892-04-18,1891,Everton,Bolton Wanderers,2-5,2,5,1,1,7,-3,A
1892-04-18,1891,Preston North End,Darwen,4-0,4,0,1,1,4,4,H
1892-04-23,1891,Darwen,Sunderland,1-7,1,7,1,1,8,-6,A
1892-04-23,1891,Stoke City,West Bromwich Albion,1-0,1,0,1,1,1,1,H
1892-04-30,1891,Burnley,Sunderland,1-2,1,2,1,1,3,-1,A
1892-09-03,1892,Accrington F.C.,Sunderland,0-6,0,6,1,1,6,-6,A
1892-09-03,1892,Blackburn Rovers,Manchester United,4-3,4,3,1,1,7,1,H
1892-09-03,1892,Everton,Nottingham Forest,2-2,2,2,1,1,4,0,D
1892-09-03,1892,Notts County,Sheffield Wednesday,0-1,0,1,1,1,1,-1,A
1892-09-03,1892,Preston North End,Bolton Wanderers,2-1,2,1,1,1,3,1,H
1892-09-03,1892,Stoke City,Derby County,1-3,1,3,1,1,4,-2,A
1892-09-03,1892,Wolverhampton Wanderers,Burnley,1-0,1,0,1,1,1,1,H
1892-09-05,1892,Burnley,Aston Villa,0-2,0,2,1,1,2,-2,A
1892-09-10,1892,Aston Villa,Everton,4-1,4,1,1,1,5,3,H
1892-09-10,1892,Bolton Wanderers,West Bromwich Albion,3-1,3,1,1,1,4,2,H
1892-09-10,1892,Derby County,Preston North End,1-2,1,2,1,1,3,-1,A
1892-09-10,1892,Manchester United,Burnley,1-1,1,1,1,1,2,0,D
1892-09-10,1892,Nottingham Forest,Stoke City,3-4,3,4,1,1,7,-1,A
1892-09-10,1892,Sheffield Wednesday,Accrington F.C.,5-2,5,2,1,1,7,3,H
1892-09-10,1892,Sunderland,Notts County,2-2,2,2,1,1,4,0,D
1892-09-10,1892,Wolverhampton Wanderers,Blackburn Rovers,4-2,4,2,1,1,6,2,H
1892-09-12,1892,Preston North End,Sheffield Wednesday,4-1,4,1,1,1,5,3,H
1892-09-12,1892,Stoke City,Aston Villa,0-1,0,1,1,1,1,-1,A
1892-09-17,1892,Aston Villa,Sunderland,1-6,1,6,1,1,7,-5,A
1892-09-17,1892,Blackburn Rovers,Everton,2-2,2,2,1,1,4,0,D
1892-09-17,1892,Bolton Wanderers,Sheffield Wednesday,1-0,1,0,1,1,1,1,H
1892-09-17,1892,Burnley,Manchester United,4-1,4,1,1,1,5,3,H
1892-09-17,1892,Notts County,Derby County,1-1,1,1,1,1,2,0,D
1892-09-17,1892,Preston North End,Nottingham Forest,1-0,1,0,1,1,1,1,H
1892-09-17,1892,Stoke City,Accrington F.C.,2-2,2,2,1,1,4,0,D
1892-09-17,1892,West Bromwich Albion,Wolverhampton Wanderers,2-1,2,1,1,1,3,1,H
1892-09-19,1892,West Bromwich Albion,Aston Villa,3-2,3,2,1,1,5,1,H
1892-09-24,1892,Accrington F.C.,Sheffield Wednesday,4-2,4,2,1,1,6,2,H
1892-09-24,1892,Bolton Wanderers,Aston Villa,5-0,5,0,1,1,5,5,H
1892-09-24,1892,Burnley,Stoke City,3-2,3,2,1,1,5,1,H
1892-09-24,1892,Derby County,West Bromwich Albion,1-1,1,1,1,1,2,0,D
1892-09-24,1892,Everton,Manchester United,6-0,6,0,1,1,6,6,H
1892-09-24,1892,Nottingham Forest,Preston North End,1-2,1,2,1,1,3,-1,A
1892-09-24,1892,Sunderland,Blackburn Rovers,5-0,5,0,1,1,5,5,H
1892-09-24,1892,Wolverhampton Wanderers,Notts County,3-0,3,0,1,1,3,3,H
1892-10-01,1892,Blackburn Rovers,Accrington F.C.,3-3,3,3,1,1,6,0,D
1892-10-01,1892,Bolton Wanderers,Wolverhampton Wanderers,3-1,3,1,1,1,4,2,H
1892-10-01,1892,Derby County,Nottingham Forest,2-3,2,3,1,1,5,-1,A
1892-10-01,1892,Everton,Aston Villa,1-0,1,0,1,1,1,1,H
1892-10-01,1892,Notts County,Preston North End,3-1,3,1,1,1,4,2,H
1892-10-01,1892,Sheffield Wednesday,Burnley,2-0,2,0,1,1,2,2,H
1892-10-01,1892,Sunderland,Stoke City,3-1,3,1,1,1,4,2,H
1892-10-01,1892,West Bromwich Albion,Manchester United,0-0,0,0,1,1,0,0,D
1892-10-03,1892,Sheffield Wednesday,Nottingham Forest,2-2,2,2,1,1,4,0,D
1892-10-06,1892,Notts County,Bolton Wanderers,2-2,2,2,1,1,4,0,D
1892-10-08,1892,Accrington F.C.,Bolton Wanderers,1-1,1,1,1,1,2,0,D
1892-10-08,1892,Burnley,Derby County,2-1,2,1,1,1,3,1,H
1892-10-08,1892,Everton,Sunderland,1-4,1,4,1,1,5,-3,A
1892-10-08,1892,Manchester United,West Bromwich Albion,2-4,2,4,1,1,6,-2,A
1892-10-08,1892,Notts County,Nottingham Forest,3-0,3,0,1,1,3,3,H
1892-10-08,1892,Preston North End,Blackburn Rovers,2-1,2,1,1,1,3,1,H
1892-10-08,1892,Wolverhampton Wanderers,Aston Villa,2-1,2,1,1,1,3,1,H
1892-10-10,1892,Aston Villa,Stoke City,3-2,3,2,1,1,5,1,H
1892-10-15,1892,Aston Villa,Nottingham Forest,1-0,1,0,1,1,1,1,H
1892-10-15,1892,Blackburn Rovers,Sheffield Wednesday,0-2,0,2,1,1,2,-2,A
1892-10-15,1892,Bolton Wanderers,Stoke City,4-4,4,4,1,1,8,0,D
1892-10-15,1892,Manchester United,Wolverhampton Wanderers,10-1,10,1,1,1,11,9,H
1892-10-15,1892,Preston North End,Burnley,2-0,2,0,1,1,2,2,H
1892-10-15,1892,Sunderland,Accrington F.C.,4-2,4,2,1,1,6,2,H
1892-10-15,1892,West Bromwich Albion,Everton,3-0,3,0,1,1,3,3,H
1892-10-19,1892,Derby County,Notts County,4-5,4,5,1,1,9,-1,A
1892-10-19,1892,Manchester United,Everton,3-4,3,4,1,1,7,-1,A
1892-10-20,1892,Nottingham Forest,Bolton Wanderers,2-0,2,0,1,1,2,2,H
1892-10-22,1892,Burnley,Notts County,3-0,3,0,1,1,3,3,H
1892-10-22,1892,Derby County,Blackburn Rovers,3-0,3,0,1,1,3,3,H
1892-10-22,1892,Everton,Accrington F.C.,1-1,1,1,1,1,2,0,D
1892-10-22,1892,Preston North End,Aston Villa,4-1,4,1,1,1,5,3,H
1892-10-22,1892,Sheffield Wednesday,Manchester United,1-0,1,0,1,1,1,1,H
1892-10-22,1892,Stoke City,Nottingham Forest,3-0,3,0,1,1,3,3,H
1892-10-22,1892,Sunderland,West Bromwich Albion,8-1,8,1,1,1,9,7,H
1892-10-22,1892,Wolverhampton Wanderers,Bolton Wanderers,1-2,1,2,1,1,3,-1,A
1892-10-29,1892,Aston Villa,Derby County,6-1,6,1,1,1,7,5,H
1892-10-29,1892,Blackburn Rovers,Preston North End,0-0,0,0,1,1,0,0,D
1892-10-29,1892,Bolton Wanderers,Everton,4-1,4,1,1,1,5,3,H
1892-10-29,1892,Burnley,Accrington F.C.,1-3,1,3,1,1,4,-2,A
1892-10-29,1892,Nottingham Forest,Manchester United,1-1,1,1,1,1,2,0,D
1892-10-29,1892,Sheffield Wednesday,Sunderland,3-2,3,2,1,1,5,1,H
1892-10-29,1892,Stoke City,Wolverhampton Wanderers,2-1,2,1,1,1,3,1,H
1892-10-29,1892,West Bromwich Albion,Notts County,4-2,4,2,1,1,6,2,H
1892-11-05,1892,Accrington F.C.,Preston North End,1-2,1,2,1,1,3,-1,A
1892-11-05,1892,Aston Villa,West Bromwich Albion,5-2,5,2,1,1,7,3,H
1892-11-05,1892,Derby County,Everton,1-6,1,6,1,1,7,-5,A
1892-11-05,1892,Manchester United,Blackburn Rovers,4-4,4,4,1,1,8,0,D
1892-11-05,1892,Notts County,Stoke City,0-1,0,1,1,1,1,-1,A
1892-11-05,1892,Sheffield Wednesday,Bolton Wanderers,4-2,4,2,1,1,6,2,H
1892-11-05,1892,Sunderland,Burnley,2-0,2,0,1,1,2,2,H
1892-11-05,1892,Wolverhampton Wanderers,Nottingham Forest,2-2,2,2,1,1,4,0,D
1892-11-07,1892,West Bromwich Albion,Bolton Wanderers,1-0,1,0,1,1,1,1,H
1892-11-12,1892,Blackburn Rovers,Wolverhampton Wanderers,3-3,3,3,1,1,6,0,D
1892-11-12,1892,Derby County,Burnley,1-0,1,0,1,1,1,1,H
1892-11-12,1892,Everton,Stoke City,2-2,2,2,1,1,4,0,D
1892-11-12,1892,Manchester United,Notts County,1-3,1,3,1,1,4,-2,A
1892-11-12,1892,Nottingham Forest,Aston Villa,4-5,4,5,1,1,9,-1,A
1892-11-12,1892,West Bromwich Albion,Accrington F.C.,4-0,4,0,1,1,4,4,H
1892-11-14,1892,Stoke City,Preston North End,2-1,2,1,1,1,3,1,H
1892-11-19,1892,Bolton Wanderers,Preston North End,2-4,2,4,1,1,6,-2,A
1892-11-19,1892,Manchester United,Aston Villa,2-0,2,0,1,1,2,2,H
1892-11-19,1892,Notts County,West Bromwich Albion,8-1,8,1,1,1,9,7,H
1892-11-19,1892,Sheffield Wednesday,Blackburn Rovers,0-3,0,3,1,1,3,-3,A
1892-11-19,1892,Stoke City,Burnley,4-1,4,1,1,1,5,3,H
1892-11-19,1892,Sunderland,Nottingham Forest,1-0,1,0,1,1,1,1,H
1892-11-19,1892,Wolverhampton Wanderers,Accrington F.C.,5-3,5,3,1,1,8,2,H
1892-11-26,1892,Accrington F.C.,Manchester United,2-2,2,2,1,1,4,0,D
1892-11-26,1892,Aston Villa,Preston North End,3-1,3,1,1,1,4,2,H
1892-11-26,1892,Blackburn Rovers,Bolton Wanderers,3-0,3,0,1,1,3,3,H
1892-11-26,1892,Burnley,Nottingham Forest,1-1,1,1,1,1,2,0,D
1892-11-26,1892,Derby County,Wolverhampton Wanderers,2-2,2,2,1,1,4,0,D
1892-11-26,1892,Everton,Sheffield Wednesday,3-5,3,5,1,1,8,-2,A
1892-11-26,1892,Notts County,Sunderland,3-1,3,1,1,1,4,2,H
1892-11-26,1892,West Bromwich Albion,Stoke City,1-2,1,2,1,1,3,-1,A
1892-12-01,1892,Nottingham Forest,Sheffield Wednesday,2-0,2,0,1,1,2,2,H
1892-12-03,1892,Bolton Wanderers,Manchester United,4-1,4,1,1,1,5,3,H
1892-12-03,1892,Burnley,Blackburn Rovers,0-0,0,0,1,1,0,0,D
1892-12-03,1892,Derby County,Accrington F.C.,3-3,3,3,1,1,6,0,D
1892-12-03,1892,Nottingham Forest,Sunderland,0-5,0,5,1,1,5,-5,A
1892-12-03,1892,Preston North End,Everton,5-0,5,0,1,1,5,5,H
1892-12-03,1892,Sheffield Wednesday,Aston Villa,5-3,5,3,1,1,8,2,H
1892-12-03,1892,Wolverhampton Wanderers,Stoke City,1-0,1,0,1,1,1,1,H
1892-12-08,1892,Notts County,Burnley,3-1,3,1,1,1,4,2,H
1892-12-10,1892,Accrington F.C.,Notts County,4-2,4,2,1,1,6,2,H
1892-12-10,1892,Aston Villa,Blackburn Rovers,4-1,4,1,1,1,5,3,H
1892-12-10,1892,Everton,Wolverhampton Wanderers,3-2,3,2,1,1,5,1,H
1892-12-10,1892,Manchester United,Bolton Wanderers,1-0,1,0,1,1,1,1,H
1892-12-10,1892,Nottingham Forest,Burnley,2-2,2,2,1,1,4,0,D
1892-12-10,1892,Sheffield Wednesday,Derby County,3-3,3,3,1,1,6,0,D
1892-12-10,1892,West Bromwich Albion,Preston North End,0-1,0,1,1,1,1,-1,A
1892-12-17,1892,Accrington F.C.,West Bromwich Albion,5-4,5,4,1,1,9,1,H
1892-12-17,1892,Blackburn Rovers,Burnley,2-0,2,0,1,1,2,2,H
1892-12-17,1892,Derby County,Aston Villa,2-1,2,1,1,1,3,1,H
1892-12-17,1892,Notts County,Everton,1-2,1,2,1,1,3,-1,A
1892-12-17,1892,Stoke City,Sheffield Wednesday,2-0,2,0,1,1,2,2,H
1892-12-17,1892,Sunderland,Preston North End,2-0,2,0,1,1,2,2,H
1892-12-17,1892,Wolverhampton Wanderers,Manchester United,2-0,2,0,1,1,2,2,H
1892-12-24,1892,Aston Villa,Bolton Wanderers,1-1,1,1,1,1,2,0,D
1892-12-24,1892,Blackburn Rovers,Notts County,1-0,1,0,1,1,1,1,H
1892-12-24,1892,Derby County,Stoke City,1-0,1,0,1,1,1,1,H
1892-12-24,1892,Everton,Burnley,0-1,0,1,1,1,1,-1,A
1892-12-24,1892,Manchester United,Sheffield Wednesday,1-5,1,5,1,1,6,-4,A
1892-12-24,1892,Nottingham Forest,Wolverhampton Wanderers,3-1,3,1,1,1,4,2,H
1892-12-24,1892,West Bromwich Albion,Sunderland,1-3,1,3,1,1,4,-2,A
1892-12-26,1892,Accrington F.C.,Stoke City,5-2,5,2,1,1,7,3,H
1892-12-26,1892,Derby County,Bolton Wanderers,1-1,1,1,1,1,2,0,D
1892-12-26,1892,Preston North End,Manchester United,2-1,2,1,1,1,3,1,H
1892-12-26,1892,West Bromwich Albion,Blackburn Rovers,1-2,1,2,1,1,3,-1,A
1892-12-26,1892,Wolverhampton Wanderers,Sunderland,2-0,2,0,1,1,2,2,H
1892-12-27,1892,Wolverhampton Wanderers,West Bromwich Albion,1-1,1,1,1,1,2,0,D
1892-12-31,1892,Accrington F.C.,Wolverhampton Wanderers,4-0,4,0,1,1,4,4,H
1892-12-31,1892,Blackburn Rovers,Nottingham Forest,0-1,0,1,1,1,1,-1,A
1892-12-31,1892,Burnley,West Bromwich Albion,5-0,5,0,1,1,5,5,H
1892-12-31,1892,Manchester United,Derby County,7-1,7,1,1,1,8,6,H
1892-12-31,1892,Notts County,Aston Villa,1-4,1,4,1,1,5,-3,A
1892-12-31,1892,Preston North End,Stoke City,2-1,2,1,1,1,3,1,H
1893-01-02,1892,Accrington F.C.,Blackburn Rovers,1-1,1,1,1,1,2,0,D
1893-01-02,1892,Bolton Wanderers,Derby County,0-3,0,3,1,1,3,-3,A
1893-01-02,1892,Sheffield Wednesday,West Bromwich Albion,6-0,6,0,1,1,6,6,H
1893-01-02,1892,Sunderland,Wolverhampton Wanderers,5-2,5,2,1,1,7,3,H
1893-01-03,1892,Sunderland,Everton,4-3,4,3,1,1,7,1,H
1893-01-07,1892,Aston Villa,Sheffield Wednesday,5-1,5,1,1,1,6,4,H
1893-01-07,1892,Blackburn Rovers,Derby County,2-2,2,2,1,1,4,0,D
1893-01-07,1892,Everton,Notts County,6-0,6,0,1,1,6,6,H
1893-01-07,1892,Nottingham Forest,Accrington F.C.,3-0,3,0,1,1,3,3,H
1893-01-07,1892,Preston North End,Sunderland,1-2,1,2,1,1,3,-1,A
1893-01-07,1892,Stoke City,Manchester United,7-1,7,1,1,1,8,6,H
1893-01-07,1892,West Bromwich Albion,Burnley,7-1,7,1,1,1,8,6,H
1893-01-12,1892,Nottingham Forest,Everton,2-1,2,1,1,1,3,1,H
1893-01-14,1892,Accrington F.C.,Burnley,0-4,0,4,1,1,4,-4,A
1893-01-14,1892,Everton,West Bromwich Albion,1-0,1,0,1,1,1,1,H
1893-01-14,1892,Manchester United,Nottingham Forest,1-3,1,3,1,1,4,-2,A
1893-01-14,1892,Notts County,Blackburn Rovers,0-0,0,0,1,1,0,0,D
1893-01-14,1892,Sheffield Wednesday,Preston North End,0-5,0,5,1,1,5,-5,A
1893-01-14,1892,Stoke City,Bolton Wanderers,6-0,6,0,1,1,6,6,H
1893-01-14,1892,Sunderland,Aston Villa,6-0,6,0,1,1,6,6,H
1893-01-26,1892,Notts County,Manchester United,4-0,4,0,1,1,4,4,H
1893-01-28,1892,Blackburn Rovers,West Bromwich Albion,2-1,2,1,1,1,3,1,H
1893-01-28,1892,Nottingham Forest,Derby County,1-0,1,0,1,1,1,1,H
1893-01-28,1892,Stoke City,Everton,0-1,0,1,1,1,1,-1,A
1893-01-28,1892,Sunderland,Sheffield Wednesday,4-2,4,2,1,1,6,2,H
1893-02-11,1892,Blackburn Rovers,Aston Villa,2-2,2,2,1,1,4,0,D
1893-02-11,1892,Burnley,Bolton Wanderers,3-0,3,0,1,1,3,3,H
1893-02-11,1892,Derby County,Manchester United,5-1,5,1,1,1,6,4,H
1893-02-11,1892,Everton,Preston North End,6-0,6,0,1,1,6,6,H
1893-02-11,1892,Notts County,Accrington F.C.,2-0,2,0,1,1,2,2,H
1893-02-11,1892,Stoke City,West Bromwich Albion,1-2,1,2,1,1,3,-1,A
1893-02-11,1892,Wolverhampton Wanderers,Sheffield Wednesday,2-0,2,0,1,1,2,2,H
1893-02-13,1892,Sheffield Wednesday,Everton,0-2,0,2,1,1,2,-2,A
1893-02-14,1892,Sunderland,Bolton Wanderers,3-3,3,3,1,1,6,0,D
1893-02-25,1892,Accrington F.C.,Everton,0-3,0,3,1,1,3,-3,A
1893-02-25,1892,Blackburn Rovers,Stoke City,3-3,3,3,1,1,6,0,D
1893-02-25,1892,Bolton Wanderers,Burnley,1-0,1,0,1,1,1,1,H
1893-02-25,1892,Nottingham Forest,Notts County,3-1,3,1,1,1,4,2,H
1893-02-25,1892,Wolverhampton Wanderers,Derby County,2-1,2,1,1,1,3,1,H
1893-03-02,1892,Nottingham Forest,West Bromwich Albion,3-4,3,4,1,1,7,-1,A
1893-03-04,1892,Bolton Wanderers,Accrington F.C.,5-2,5,2,1,1,7,3,H
1893-03-04,1892,Manchester United,Sunderland,0-5,0,5,1,1,5,-5,A
1893-03-06,1892,Aston Villa,Manchester United,2-0,2,0,1,1,2,2,H
1893-03-11,1892,Nottingham Forest,Blackburn Rovers,0-1,0,1,1,1,1,-1,A
1893-03-11,1892,Sheffield Wednesday,Wolverhampton Wanderers,0-1,0,1,1,1,1,-1,A
1893-03-11,1892,Stoke City,Notts County,1-0,1,0,1,1,1,1,H
1893-03-11,1892,Sunderland,Derby County,3-1,3,1,1,1,4,2,H
1893-03-18,1892,Accrington F.C.,Nottingham Forest,1-1,1,1,1,1,2,0,D
1893-03-18,1892,Aston Villa,Notts County,3-1,3,1,1,1,4,2,H
1893-03-18,1892,Bolton Wanderers,Blackburn Rovers,2-1,2,1,1,1,3,1,H
1893-03-18,1892,Burnley,Preston North End,4-2,4,2,1,1,6,2,H
1893-03-18,1892,Stoke City,Sunderland,0-1,0,1,1,1,1,-1,A
1893-03-18,1892,West Bromwich Albion,Sheffield Wednesday,3-0,3,0,1,1,3,3,H
1893-03-18,1892,Wolverhampton Wanderers,Everton,2-4,2,4,1,1,6,-2,A
1893-03-25,1892,Aston Villa,Accrington F.C.,6-4,6,4,1,1,10,2,H
1893-03-25,1892,Bolton Wanderers,Notts County,4-1,4,1,1,1,5,3,H
1893-03-25,1892,Derby County,Sheffield Wednesday,2-2,2,2,1,1,4,0,D
1893-03-31,1892,Accrington F.C.,Derby County,0-3,0,3,1,1,3,-3,A
1893-03-31,1892,Blackburn Rovers,Sunderland,2-2,2,2,1,1,4,0,D
1893-03-31,1892,Bolton Wanderers,Nottingham Forest,3-1,3,1,1,1,4,2,H
1893-03-31,1892,Burnley,Sheffield Wednesday,4-0,4,0,1,1,4,4,H
1893-03-31,1892,Manchester United,Stoke City,1-0,1,0,1,1,1,1,H
1893-03-31,1892,Preston North End,Notts County,4-0,4,0,1,1,4,4,H
1893-04-01,1892,Bolton Wanderers,Sunderland,2-1,2,1,1,1,3,1,H
1893-04-01,1892,Burnley,Wolverhampton Wanderers,2-0,2,0,1,1,2,2,H
1893-04-01,1892,Everton,Blackburn Rovers,4-0,4,0,1,1,4,4,H
1893-04-01,1892,Manchester United,Preston North End,2-1,2,1,1,1,3,1,H
1893-04-01,1892,Sheffield Wednesday,Stoke City,0-1,0,1,1,1,1,-1,A
1893-04-01,1892,West Bromwich Albion,Derby County,3-1,3,1,1,1,4,2,H
1893-04-03,1892,Aston Villa,Wolverhampton Wanderers,5-0,5,0,1,1,5,5,H
1893-04-03,1892,Everton,Bolton Wanderers,3-0,3,0,1,1,3,3,H
1893-04-03,1892,Preston North End,Accrington F.C.,0-0,0,0,1,1,0,0,D
1893-04-03,1892,Sheffield Wednesday,Notts County,3-2,3,2,1,1,5,1,H
1893-04-03,1892,Stoke City,Blackburn Rovers,2-2,2,2,1,1,4,0,D
1893-04-03,1892,West Bromwich Albion,Nottingham Forest,2-2,2,2,1,1,4,0,D
1893-04-04,1892,Aston Villa,Burnley,1-3,1,3,1,1,4,-2,A
1893-04-04,1892,Sunderland,Manchester United,6-0,6,0,1,1,6,6,H
1893-04-08,1892,Burnley,Everton,3-0,3,0,1,1,3,3,H
1893-04-08,1892,Derby County,Sunderland,1-1,1,1,1,1,2,0,D
1893-04-08,1892,Manchester United,Accrington F.C.,3-3,3,3,1,1,6,0,D
1893-04-08,1892,Notts County,Wolverhampton Wanderers,3-0,3,0,1,1,3,3,H
1893-04-10,1892,Preston North End,Wolverhampton Wanderers,4-0,4,0,1,1,4,4,H
1893-04-13,1892,Preston North End,West Bromwich Albion,1-1,1,1,1,1,2,0,D
1893-04-15,1892,Accrington F.C.,Aston Villa,1-1,1,1,1,1,2,0,D
1893-04-15,1892,Burnley,Sunderland,2-3,2,3,1,1,5,-1,A
1893-04-15,1892,Everton,Derby County,5-0,5,0,1,1,5,5,H
1893-04-15,1892,Wolverhampton Wanderers,Preston North End,2-1,2,1,1,1,3,1,H
1893-04-17,1892,Preston North End,Derby County,0-1,0,1,1,1,1,-1,A
1893-09-02,1893,Aston Villa,West Bromwich Albion,3-2,3,2,1,1,5,1,H
1893-09-02,1893,Bolton Wanderers,Stoke City,4-1,4,1,1,1,5,3,H
1893-09-02,1893,Darwen,Blackburn Rovers,2-3,2,3,1,1,5,-1,A
1893-09-02,1893,Everton,Sheffield United,2-3,2,3,1,1,5,-1,A
1893-09-02,1893,Manchester United,Burnley,3-2,3,2,1,1,5,1,H
1893-09-02,1893,Nottingham Forest,Wolverhampton Wanderers,7-1,7,1,1,1,8,6,H
1893-09-02,1893,Preston North End,Derby County,1-0,1,0,1,1,1,1,H
1893-09-02,1893,Sheffield Wednesday,Sunderland,2-2,2,2,1,1,4,0,D
1893-09-04,1893,Burnley,Darwen,5-1,5,1,1,1,6,4,H
1893-09-04,1893,Everton,Nottingham Forest,4-0,4,0,1,1,4,4,H
1893-09-04,1893,Sheffield United,Derby County,1-2,1,2,1,1,3,-1,A
1893-09-04,1893,Wolverhampton Wanderers,Sheffield Wednesday,3-1,3,1,1,1,4,2,H
1893-09-09,1893,Blackburn Rovers,Sheffield Wednesday,5-1,5,1,1,1,6,4,H
1893-09-09,1893,Burnley,Preston North End,4-1,4,1,1,1,5,3,H
1893-09-09,1893,Derby County,Everton,7-3,7,3,1,1,10,4,H
1893-09-09,1893,Sheffield United,Darwen,2-1,2,1,1,1,3,1,H
1893-09-09,1893,Stoke City,Nottingham Forest,2-1,2,1,1,1,3,1,H
1893-09-09,1893,Sunderland,Aston Villa,1-1,1,1,1,1,2,0,D
1893-09-09,1893,West Bromwich Albion,Manchester United,3-1,3,1,1,1,4,2,H
1893-09-09,1893,Wolverhampton Wanderers,Bolton Wanderers,2-1,2,1,1,1,3,1,H
1893-09-11,1893,Aston Villa,Stoke City,5-1,5,1,1,1,6,4,H
1893-09-16,1893,Bolton Wanderers,Blackburn Rovers,2-1,2,1,1,1,3,1,H
1893-09-16,1893,Darwen,Stoke City,3-1,3,1,1,1,4,2,H
1893-09-16,1893,Derby County,West Bromwich Albion,2-3,2,3,1,1,5,-1,A
1893-09-16,1893,Everton,Aston Villa,4-2,4,2,1,1,6,2,H
1893-09-16,1893,Nottingham Forest,Burnley,5-0,5,0,1,1,5,5,H
1893-09-16,1893,Preston North End,Sunderland,1-2,1,2,1,1,3,-1,A
1893-09-16,1893,Sheffield Wednesday,Manchester United,0-1,0,1,1,1,1,-1,A
1893-09-18,1893,Wolverhampton Wanderers,Darwen,2-1,2,1,1,1,3,1,H
1893-09-23,1893,Aston Villa,Everton,3-1,3,1,1,1,4,2,H
1893-09-23,1893,Blackburn Rovers,Wolverhampton Wanderers,3-0,3,0,1,1,3,3,H
1893-09-23,1893,Manchester United,Nottingham Forest,1-1,1,1,1,1,2,0,D
1893-09-23,1893,Preston North End,Darwen,4-1,4,1,1,1,5,3,H
1893-09-23,1893,Sheffield United,Bolton Wanderers,4-2,4,2,1,1,6,2,H
1893-09-23,1893,Stoke City,Derby County,3-1,3,1,1,1,4,2,H
1893-09-23,1893,Sunderland,Sheffield Wednesday,1-1,1,1,1,1,2,0,D
1893-09-23,1893,West Bromwich Albion,Burnley,1-1,1,1,1,1,2,0,D
1893-09-25,1893,Sheffield Wednesday,West Bromwich Albion,2-4,2,4,1,1,6,-2,A
1893-09-30,1893,Aston Villa,Derby County,1-1,1,1,1,1,2,0,D
1893-09-30,1893,Bolton Wanderers,Preston North End,0-3,0,3,1,1,3,-3,A
1893-09-30,1893,Burnley,Stoke City,4-0,4,0,1,1,4,4,H
1893-09-30,1893,Darwen,Manchester United,1-0,1,0,1,1,1,1,H
1893-09-30,1893,Everton,Sunderland,7-1,7,1,1,1,8,6,H
1893-09-30,1893,Nottingham Forest,West Bromwich Albion,2-3,2,3,1,1,5,-1,A
1893-09-30,1893,Sheffield Wednesday,Blackburn Rovers,4-2,4,2,1,1,6,2,H
1893-09-30,1893,Wolverhampton Wanderers,Sheffield United,3-4,3,4,1,1,7,-1,A
1893-10-02,1893,Sheffield United,Aston Villa,3-0,3,0,1,1,3,3,H
1893-10-05,1893,Nottingham Forest,Bolton Wanderers,1-0,1,0,1,1,1,1,H
1893-10-07,1893,Blackburn Rovers,Preston North End,1-0,1,0,1,1,1,1,H
1893-10-07,1893,Bolton Wanderers,Darwen,1-0,1,0,1,1,1,1,H
1893-10-07,1893,Burnley,Everton,2-1,2,1,1,1,3,1,H
1893-10-07,1893,Derby County,Manchester United,2-0,2,0,1,1,2,2,H
1893-10-07,1893,Nottingham Forest,Aston Villa,1-2,1,2,1,1,3,-1,A
1893-10-07,1893,Sheffield United,Sunderland,1-0,1,0,1,1,1,1,H
1893-10-07,1893,Stoke City,Sheffield Wednesday,4-1,4,1,1,1,5,3,H
1893-10-07,1893,West Bromwich Albion,Wolverhampton Wanderers,0-0,0,0,1,1,0,0,D
1893-10-14,1893,Bolton Wanderers,Sheffield United,0-1,0,1,1,1,1,-1,A
1893-10-14,1893,Darwen,Aston Villa,1-1,1,1,1,1,2,0,D
1893-10-14,1893,Everton,Blackburn Rovers,2-2,2,2,1,1,4,0,D
1893-10-14,1893,Manchester United,West Bromwich Albion,4-1,4,1,1,1,5,3,H
1893-10-14,1893,Preston North End,Burnley,1-2,1,2,1,1,3,-1,A
1893-10-14,1893,Sheffield Wednesday,Derby County,4-0,4,0,1,1,4,4,H
1893-10-14,1893,Sunderland,Stoke City,4-0,4,0,1,1,4,4,H
1893-10-14,1893,Wolverhampton Wanderers,Nottingham Forest,3-1,3,1,1,1,4,2,H
1893-10-16,1893,Sheffield United,Sheffield Wednesday,1-1,1,1,1,1,2,0,D
1893-10-16,1893,Stoke City,Aston Villa,3-3,3,3,1,1,6,0,D
1893-10-21,1893,Blackburn Rovers,Sunderland,4-3,4,3,1,1,7,1,H
1893-10-21,1893,Bolton Wanderers,Wolverhampton Wanderers,2-0,2,0,1,1,2,2,H
1893-10-21,1893,Burnley,Manchester United,4-1,4,1,1,1,5,3,H
1893-10-21,1893,Derby County,Sheffield Wednesday,3-3,3,3,1,1,6,0,D
1893-10-21,1893,Everton,Darwen,8-1,8,1,1,1,9,7,H
1893-10-21,1893,Nottingham Forest,Stoke City,2-0,2,0,1,1,2,2,H
1893-10-21,1893,West Bromwich Albion,Aston Villa,3-6,3,6,1,1,9,-3,A
1893-10-28,1893,Aston Villa,Burnley,4-0,4,0,1,1,4,4,H
1893-10-28,1893,Darwen,Bolton Wanderers,1-3,1,3,1,1,4,-2,A
1893-10-28,1893,Everton,Preston North End,2-3,2,3,1,1,5,-1,A
1893-10-28,1893,Nottingham Forest,Sheffield Wednesday,1-0,1,0,1,1,1,1,H
1893-10-28,1893,Sheffield United,West Bromwich Albion,0-2,0,2,1,1,2,-2,A
1893-10-28,1893,Stoke City,Blackburn Rovers,3-1,3,1,1,1,4,2,H
1893-10-28,1893,Sunderland,Derby County,5-0,5,0,1,1,5,5,H
1893-10-28,1893,Wolverhampton Wanderers,Manchester United,2-0,2,0,1,1,2,2,H
1893-10-30,1893,Aston Villa,Sheffield United,4-0,4,0,1,1,4,4,H
1893-11-04,1893,Blackburn Rovers,Aston Villa,2-0,2,0,1,1,2,2,H
1893-11-04,1893,Burnley,Nottingham Forest,3-1,3,1,1,1,4,2,H
1893-11-04,1893,Derby County,Sheffield United,2-1,2,1,1,1,3,1,H
1893-11-04,1893,Manchester United,Darwen,0-1,0,1,1,1,1,-1,A
1893-11-04,1893,Preston North End,Bolton Wanderers,1-0,1,0,1,1,1,1,H
1893-11-04,1893,Sheffield Wednesday,Everton,1-1,1,1,1,1,2,0,D
1893-11-04,1893,Sunderland,Wolverhampton Wanderers,6-0,6,0,1,1,6,6,H
1893-11-04,1893,West Bromwich Albion,Stoke City,4-2,4,2,1,1,6,2,H
1893-11-06,1893,West Bromwich Albion,Bolton Wanderers,5-2,5,2,1,1,7,3,H
1893-11-11,1893,Aston Villa,Sunderland,2-1,2,1,1,1,3,1,H
1893-11-11,1893,Darwen,West Bromwich Albion,2-1,2,1,1,1,3,1,H
1893-11-11,1893,Everton,Derby County,1-2,1,2,1,1,3,-1,A
1893-11-11,1893,Manchester United,Wolverhampton Wanderers,1-0,1,0,1,1,1,1,H
1893-11-11,1893,Preston North End,Blackburn Rovers,0-1,0,1,1,1,1,-1,A
1893-11-11,1893,Stoke City,Burnley,4-2,4,2,1,1,6,2,H
1893-11-13,1893,Sheffield Wednesday,Sheffield United,1-2,1,2,1,1,3,-1,A
1893-11-13,1893,Stoke City,Preston North End,2-1,2,1,1,1,3,1,H
1893-11-18,1893,Blackburn Rovers,Burnley,3-2,3,2,1,1,5,1,H
1893-11-18,1893,Bolton Wanderers,Aston Villa,0-1,0,1,1,1,1,-1,A
1893-11-18,1893,Derby County,Darwen,2-1,2,1,1,1,3,1,H
1893-11-18,1893,Nottingham Forest,Sheffield United,1-1,1,1,1,1,2,0,D
1893-11-20,1893,Sheffield United,Preston North End,1-1,1,1,1,1,2,0,D
1893-11-25,1893,Aston Villa,Preston North End,2-0,2,0,1,1,2,2,H
1893-11-25,1893,Everton,Burnley,4-3,4,3,1,1,7,1,H
1893-11-25,1893,Nottingham Forest,Blackburn Rovers,0-0,0,0,1,1,0,0,D
1893-11-25,1893,Sheffield United,Manchester United,3-1,3,1,1,1,4,2,H
1893-11-25,1893,Sunderland,West Bromwich Albion,2-1,2,1,1,1,3,1,H
1893-11-25,1893,Wolverhampton Wanderers,Stoke City,4-2,4,2,1,1,6,2,H
1893-11-27,1893,West Bromwich Albion,Sheffield Wednesday,2-2,2,2,1,1,4,0,D
1893-12-02,1893,Blackburn Rovers,Bolton Wanderers,0-1,0,1,1,1,1,-1,A
1893-12-02,1893,Burnley,Sunderland,1-0,1,0,1,1,1,1,H
1893-12-02,1893,Derby County,Aston Villa,0-3,0,3,1,1,3,-3,A
1893-12-02,1893,Manchester United,Everton,0-3,0,3,1,1,3,-3,A
1893-12-02,1893,Preston North End,Nottingham Forest,0-2,0,2,1,1,2,-2,A
1893-12-02,1893,Sheffield Wednesday,Wolverhampton Wanderers,1-4,1,4,1,1,5,-3,A
1893-12-02,1893,Stoke City,Darwen,3-1,3,1,1,1,4,2,H
1893-12-04,1893,West Bromwich Albion,Preston North End,2-0,2,0,1,1,2,2,H
1893-12-04,1893,Wolverhampton Wanderers,Everton,2-0,2,0,1,1,2,2,H
1893-12-06,1893,Sunderland,Manchester United,4-1,4,1,1,1,5,3,H
1893-12-07,1893,Sheffield Wednesday,Stoke City,4-1,4,1,1,1,5,3,H
1893-12-09,1893,Aston Villa,Sheffield Wednesday,3-0,3,0,1,1,3,3,H
1893-12-09,1893,Bolton Wanderers,Manchester United,2-0,2,0,1,1,2,2,H
1893-12-09,1893,Burnley,West Bromwich Albion,3-0,3,0,1,1,3,3,H
1893-12-09,1893,Derby County,Nottingham Forest,3-4,3,4,1,1,7,-1,A
1893-12-09,1893,Sheffield United,Everton,0-3,0,3,1,1,3,-3,A
1893-12-09,1893,Sunderland,Blackburn Rovers,2-3,2,3,1,1,5,-1,A
1893-12-09,1893,Wolverhampton Wanderers,Preston North End,0-0,0,0,1,1,0,0,D
1893-12-11,1893,Darwen,Sheffield Wednesday,2-1,2,1,1,1,3,1,H
1893-12-16,1893,Blackburn Rovers,Everton,4-3,4,3,1,1,7,1,H
1893-12-16,1893,Manchester United,Aston Villa,1-3,1,3,1,1,4,-2,A
1893-12-16,1893,Preston North End,Wolverhampton Wanderers,1-3,1,3,1,1,4,-2,A
1893-12-16,1893,Sheffield Wednesday,Bolton Wanderers,2-1,2,1,1,1,3,1,H
1893-12-16,1893,Stoke City,Sheffield United,5-0,5,0,1,1,5,5,H
1893-12-16,1893,Sunderland,Burnley,2-2,2,2,1,1,4,0,D
1893-12-16,1893,West Bromwich Albion,Darwen,2-2,2,2,1,1,4,0,D
1893-12-23,1893,Burnley,Blackburn Rovers,1-0,1,0,1,1,1,1,H
1893-12-23,1893,Darwen,Nottingham Forest,0-4,0,4,1,1,4,-4,A
1893-12-23,1893,Derby County,Stoke City,5-2,5,2,1,1,7,3,H
1893-12-23,1893,Everton,Sheffield Wednesday,8-1,8,1,1,1,9,7,H
1893-12-23,1893,Preston North End,Manchester United,2-0,2,0,1,1,2,2,H
1893-12-23,1893,West Bromwich Albion,Sunderland,2-3,2,3,1,1,5,-1,A
1893-12-23,1893,Wolverhampton Wanderers,Aston Villa,3-0,3,0,1,1,3,3,H
1893-12-25,1893,Blackburn Rovers,Darwen,4-1,4,1,1,1,5,3,H
1893-12-25,1893,Bolton Wanderers,Sheffield Wednesday,1-1,1,1,1,1,2,0,D
1893-12-25,1893,Burnley,Sheffield United,4-1,4,1,1,1,5,3,H
1893-12-25,1893,Preston North End,Stoke City,3-3,3,3,1,1,6,0,D
1893-12-26,1893,Aston Villa,Darwen,9-0,9,0,1,1,9,9,H
1893-12-26,1893,Derby County,Bolton Wanderers,6-1,6,1,1,1,7,5,H
1893-12-26,1893,Sheffield Wednesday,Burnley,0-1,0,1,1,1,1,-1,A
1893-12-26,1893,West Bromwich Albion,Sheffield United,3-1,3,1,1,1,4,2,H
1893-12-26,1893,Wolverhampton Wanderers,Blackburn Rovers,5-1,5,1,1,1,6,4,H
1893-12-27,1893,Wolverhampton Wanderers,West Bromwich Albion,0-8,0,8,1,1,8,-8,A
1893-12-30,1893,Everton,West Bromwich Albion,7-1,7,1,1,1,8,6,H
1893-12-30,1893,Nottingham Forest,Derby County,4-2,4,2,1,1,6,2,H
1893-12-30,1893,Stoke City,Wolverhampton Wanderers,0-3,0,3,1,1,3,-3,A
1893-12-30,1893,Sunderland,Bolton Wanderers,2-1,2,1,1,1,3,1,H
1894-01-01,1893,Bolton Wanderers,Derby County,1-1,1,1,1,1,2,0,D
1894-01-01,1893,Darwen,Everton,3-3,3,3,1,1,6,0,D
1894-01-01,1893,Sheffield United,Nottingham Forest,0-2,0,2,1,1,2,-2,A
1894-01-01,1893,Sunderland,Preston North End,6-3,6,3,1,1,9,3,H
1894-01-06,1893,Bolton Wanderers,Burnley,2-0,2,0,1,1,2,2,H
1894-01-06,1893,Darwen,Sheffield United,3-3,3,3,1,1,6,0,D
1894-01-06,1893,Derby County,Preston North End,2-1,2,1,1,1,3,1,H
1894-01-06,1893,Everton,Manchester United,2-0,2,0,1,1,2,2,H
1894-01-06,1893,Sheffield Wednesday,Aston Villa,2-2,2,2,1,1,4,0,D
1894-01-06,1893,West Bromwich Albion,Blackburn Rovers,2-1,2,1,1,1,3,1,H
1894-01-06,1893,Wolverhampton Wanderers,Sunderland,2-1,2,1,1,1,3,1,H
1894-01-13,1893,Blackburn Rovers,West Bromwich Albion,3-0,3,0,1,1,3,3,H
1894-01-13,1893,Manchester United,Sheffield Wednesday,1-2,1,2,1,1,3,-1,A
1894-01-13,1893,Nottingham Forest,Sunderland,1-2,1,2,1,1,3,-1,A
1894-01-13,1893,Preston North End,Everton,2-4,2,4,1,1,6,-2,A
1894-01-13,1893,Sheffield United,Wolverhampton Wanderers,3-2,3,2,1,1,5,1,H
1894-01-13,1893,Stoke City,Bolton Wanderers,5-0,5,0,1,1,5,5,H
1894-01-15,1893,Blackburn Rovers,Sheffield United,4-1,4,1,1,1,5,3,H
1894-01-15,1893,Sheffield Wednesday,Darwen,5-0,5,0,1,1,5,5,H
1894-01-18,1893,Nottingham Forest,Everton,3-2,3,2,1,1,5,1,H
1894-01-18,1893,Preston North End,Aston Villa,2-5,2,5,1,1,7,-3,A
1894-01-20,1893,Stoke City,West Bromwich Albion,3-1,3,1,1,1,4,2,H
1894-01-20,1893,Sunderland,Sheffield United,4-1,4,1,1,1,5,3,H
1894-01-20,1893,Wolverhampton Wanderers,Derby County,2-4,2,4,1,1,6,-2,A
1894-02-03,1893,Aston Villa,Manchester United,5-1,5,1,1,1,6,4,H
1894-02-03,1893,Blackburn Rovers,Nottingham Forest,6-1,6,1,1,1,7,5,H
1894-02-03,1893,Burnley,Bolton Wanderers,2-1,2,1,1,1,3,1,H
1894-02-03,1893,Darwen,Preston North End,2-1,2,1,1,1,3,1,H
1894-02-03,1893,Derby County,Wolverhampton Wanderers,4-1,4,1,1,1,5,3,H
1894-02-03,1893,Sheffield United,Stoke City,3-3,3,3,1,1,6,0,D
1894-02-03,1893,West Bromwich Albion,Everton,3-1,3,1,1,1,4,2,H
1894-02-06,1893,Darwen,Burnley,0-0,0,0,1,1,0,0,D
1894-02-06,1893,Sheffield Wednesday,Preston North End,3-0,3,0,1,1,3,3,H
1894-02-06,1893,Sunderland,Everton,1-0,1,0,1,1,1,1,H
1894-03-03,1893,Aston Villa,Bolton Wanderers,2-3,2,3,1,1,5,-1,A
1894-03-03,1893,Manchester United,Sunderland,2-4,2,4,1,1,6,-2,A
1894-03-03,1893,Preston North End,West Bromwich Albion,3-1,3,1,1,1,4,2,H
1894-03-03,1893,Sheffield United,Blackburn Rovers,3-2,3,2,1,1,5,1,H
1894-03-03,1893,Stoke City,Everton,3-1,3,1,1,1,4,2,H
1894-03-03,1893,Wolverhampton Wanderers,Burnley,1-0,1,0,1,1,1,1,H
1894-03-05,1893,Sheffield Wednesday,Nottingham Forest,1-0,1,0,1,1,1,1,H
1894-03-07,1893,Derby County,Sunderland,1-4,1,4,1,1,5,-3,A
1894-03-10,1893,Burnley,Derby County,3-1,3,1,1,1,4,2,H
1894-03-10,1893,Darwen,Wolverhampton Wanderers,3-1,3,1,1,1,4,2,H
1894-03-10,1893,Manchester United,Sheffield United,0-2,0,2,1,1,2,-2,A
1894-03-12,1893,Manchester United,Blackburn Rovers,5-1,5,1,1,1,6,4,H
1894-03-15,1893,Nottingham Forest,Darwen,4-1,4,1,1,1,5,3,H
1894-03-17,1893,Manchester United,Derby County,2-6,2,6,1,1,8,-4,A
1894-03-17,1893,Sunderland,Nottingham Forest,2-0,2,0,1,1,2,2,H
1894-03-23,1893,Blackburn Rovers,Derby County,0-2,0,2,1,1,2,-2,A
1894-03-23,1893,Bolton Wanderers,Nottingham Forest,1-1,1,1,1,1,2,0,D
1894-03-23,1893,Burnley,Sheffield Wednesday,0-1,0,1,1,1,1,-1,A
1894-03-23,1893,Manchester United,Stoke City,6-2,6,2,1,1,8,4,H
1894-03-24,1893,Aston Villa,Blackburn Rovers,2-1,2,1,1,1,3,1,H
1894-03-24,1893,Everton,Wolverhampton Wanderers,3-0,3,0,1,1,3,3,H
1894-03-24,1893,Manchester United,Bolton Wanderers,2-2,2,2,1,1,4,0,D
1894-03-24,1893,Nottingham Forest,Preston North End,4-2,4,2,1,1,6,2,H
1894-03-24,1893,Stoke City,Sunderland,2-0,2,0,1,1,2,2,H
1894-03-24,1893,West Bromwich Albion,Derby County,0-1,0,1,1,1,1,-1,A
1894-03-26,1893,Aston Villa,Wolverhampton Wanderers,1-1,1,1,1,1,2,0,D
1894-03-26,1893,Blackburn Rovers,Manchester United,4-0,4,0,1,1,4,4,H
1894-03-26,1893,Everton,Bolton Wanderers,3-2,3,2,1,1,5,1,H
1894-03-26,1893,Preston North End,Sheffield Wednesday,1-0,1,0,1,1,1,1,H
1894-03-26,1893,Sheffield United,Burnley,1-0,1,0,1,1,1,1,H
1894-03-26,1893,West Bromwich Albion,Nottingham Forest,3-0,3,0,1,1,3,3,H
1894-03-27,1893,Sunderland,Darwen,4-0,4,0,1,1,4,4,H
1894-03-31,1893,Derby County,Blackburn Rovers,5-2,5,2,1,1,7,3,H
1894-03-31,1893,Stoke City,Manchester United,3-1,3,1,1,1,4,2,H
1894-04-02,1893,Derby County,Burnley,3-3,3,3,1,1,6,0,D
1894-04-07,1893,Bolton Wanderers,West Bromwich Albion,0-3,0,3,1,1,3,-3,A
1894-04-07,1893,Burnley,Aston Villa,3-6,3,6,1,1,9,-3,A
1894-04-07,1893,Darwen,Sunderland,0-3,0,3,1,1,3,-3,A
1894-04-07,1893,Everton,Stoke City,6-2,6,2,1,1,8,4,H
1894-04-07,1893,Nottingham Forest,Manchester United,2-0,2,0,1,1,2,2,H
1894-04-07,1893,Preston North End,Sheffield United,3-0,3,0,1,1,3,3,H
1894-04-14,1893,Aston Villa,Nottingham Forest,3-1,3,1,1,1,4,2,H
1894-04-14,1893,Blackburn Rovers,Stoke City,5-0,5,0,1,1,5,5,H
1894-04-14,1893,Burnley,Wolverhampton Wanderers,4-2,4,2,1,1,6,2,H
1894-04-14,1893,Darwen,Derby County,2-3,2,3,1,1,5,-1,A
1894-04-14,1893,Manchester United,Preston North End,1-3,1,3,1,1,4,-2,A
1894-04-16,1893,Bolton Wanderers,Everton,0-1,0,1,1,1,1,-1,A
1894-04-23,1893,Bolton Wanderers,Sunderland,2-0,2,0,1,1,2,2,H
1894-09-01,1894,Aston Villa,Birmingham City,2-1,2,1,1,1,3,1,H
1894-09-01,1894,Blackburn Rovers,Liverpool,1-1,1,1,1,1,2,0,D
1894-09-01,1894,Bolton Wanderers,Stoke City,2-2,2,2,1,1,4,0,D
1894-09-01,1894,Everton,Sheffield Wednesday,3-1,3,1,1,1,4,2,H
1894-09-01,1894,Nottingham Forest,Burnley,2-1,2,1,1,1,3,1,H
1894-09-01,1894,Sheffield United,West Bromwich Albion,2-1,2,1,1,1,3,1,H
1894-09-01,1894,Sunderland,Derby County,8-0,8,0,1,1,8,8,H
1894-09-01,1894,Wolverhampton Wanderers,Preston North End,1-3,1,3,1,1,4,-2,A
1894-09-03,1894,Burnley,Liverpool,3-3,3,3,1,1,6,0,D
1894-09-03,1894,Everton,Birmingham City,5-0,5,0,1,1,5,5,H
1894-09-03,1894,Sheffield Wednesday,Preston North End,3-1,3,1,1,1,4,2,H
1894-09-03,1894,Wolverhampton Wanderers,Sheffield United,0-3,0,3,1,1,3,-3,A
1894-09-08,1894,Birmingham City,Bolton Wanderers,2-0,2,0,1,1,2,2,H
1894-09-08,1894,Derby County,Nottingham Forest,4-2,4,2,1,1,6,2,H
1894-09-08,1894,Liverpool,Aston Villa,1-2,1,2,1,1,3,-1,A
1894-09-08,1894,Preston North End,Sheffield United,2-1,2,1,1,1,3,1,H
1894-09-08,1894,Sheffield Wednesday,Blackburn Rovers,4-1,4,1,1,1,5,3,H
1894-09-08,1894,Stoke City,Everton,1-3,1,3,1,1,4,-2,A
1894-09-08,1894,Sunderland,Burnley,3-0,3,0,1,1,3,3,H
1894-09-08,1894,West Bromwich Albion,Wolverhampton Wanderers,5-1,5,1,1,1,6,4,H
1894-09-13,1894,Liverpool,Bolton Wanderers,1-2,1,2,1,1,3,-1,A
1894-09-15,1894,Aston Villa,Sunderland,1-2,1,2,1,1,3,-1,A
1894-09-15,1894,Blackburn Rovers,Stoke City,6-0,6,0,1,1,6,6,H
1894-09-15,1894,Bolton Wanderers,Preston North End,1-2,1,2,1,1,3,-1,A
1894-09-15,1894,Derby County,Sheffield Wednesday,1-2,1,2,1,1,3,-1,A
1894-09-15,1894,Everton,Nottingham Forest,6-1,6,1,1,1,7,5,H
1894-09-15,1894,Sheffield United,Burnley,2-2,2,2,1,1,4,0,D
1894-09-15,1894,West Bromwich Albion,Liverpool,5-0,5,0,1,1,5,5,H
1894-09-15,1894,Wolverhampton Wanderers,Birmingham City,2-1,2,1,1,1,3,1,H
1894-09-22,1894,Burnley,Wolverhampton Wanderers,2-1,2,1,1,1,3,1,H
1894-09-22,1894,Derby County,Aston Villa,0-2,0,2,1,1,2,-2,A
1894-09-22,1894,Liverpool,Blackburn Rovers,2-2,2,2,1,1,4,0,D
1894-09-22,1894,Nottingham Forest,Everton,2-3,2,3,1,1,5,-1,A
1894-09-22,1894,Preston North End,Birmingham City,0-1,0,1,1,1,1,-1,A
1894-09-22,1894,Sheffield Wednesday,Bolton Wanderers,2-1,2,1,1,1,3,1,H
1894-09-22,1894,Stoke City,Sheffield United,1-3,1,3,1,1,4,-2,A
1894-09-22,1894,Sunderland,West Bromwich Albion,3-0,3,0,1,1,3,3,H
1894-09-29,1894,Birmingham City,Preston North End,4-4,4,4,1,1,8,0,D
1894-09-29,1894,Blackburn Rovers,Sheffield Wednesday,3-1,3,1,1,1,4,2,H
1894-09-29,1894,Bolton Wanderers,Sunderland,4-1,4,1,1,1,5,3,H
1894-09-29,1894,Burnley,Derby County,2-0,2,0,1,1,2,2,H
1894-09-29,1894,Everton,West Bromwich Albion,4-1,4,1,1,1,5,3,H
1894-09-29,1894,Sheffield United,Nottingham Forest,3-2,3,2,1,1,5,1,H
1894-09-29,1894,Stoke City,Aston Villa,4-1,4,1,1,1,5,3,H
1894-09-29,1894,Wolverhampton Wanderers,Liverpool,3-1,3,1,1,1,4,2,H
1894-10-04,1894,Nottingham Forest,Preston North End,0-2,0,2,1,1,2,-2,A
1894-10-06,1894,Birmingham City,Wolverhampton Wanderers,4-3,4,3,1,1,7,1,H
1894-10-06,1894,Bolton Wanderers,Everton,1-3,1,3,1,1,4,-2,A
1894-10-06,1894,Liverpool,Sheffield United,2-2,2,2,1,1,4,0,D
1894-10-06,1894,Nottingham Forest,Aston Villa,2-1,2,1,1,1,3,1,H
1894-10-06,1894,Preston North End,Blackburn Rovers,1-1,1,1,1,1,2,0,D
1894-10-06,1894,Sheffield Wednesday,Burnley,4-3,4,3,1,1,7,1,H
1894-10-06,1894,Sunderland,Stoke City,3-1,3,1,1,1,4,2,H
1894-10-08,1894,Sheffield United,Blackburn Rovers,3-0,3,0,1,1,3,3,H
1894-10-13,1894,Aston Villa,West Bromwich Albion,3-1,3,1,1,1,4,2,H
1894-10-13,1894,Blackburn Rovers,Bolton Wanderers,2-1,2,1,1,1,3,1,H
1894-10-13,1894,Burnley,Birmingham City,3-1,3,1,1,1,4,2,H
1894-10-13,1894,Derby County,Sunderland,1-2,1,2,1,1,3,-1,A
1894-10-13,1894,Everton,Liverpool,3-0,3,0,1,1,3,3,H
1894-10-13,1894,Sheffield United,Preston North End,0-1,0,1,1,1,1,-1,A
1894-10-13,1894,Stoke City,Nottingham Forest,0-3,0,3,1,1,3,-3,A
1894-10-13,1894,Wolverhampton Wanderers,Sheffield Wednesday,2-0,2,0,1,1,2,2,H
1894-10-20,1894,Birmingham City,Aston Villa,2-2,2,2,1,1,4,0,D
1894-10-20,1894,Blackburn Rovers,Everton,4-3,4,3,1,1,7,1,H
1894-10-20,1894,Bolton Wanderers,Burnley,1-1,1,1,1,1,2,0,D
1894-10-20,1894,Liverpool,Stoke City,2-0,2,0,1,1,2,2,H
1894-10-20,1894,Preston North End,Wolverhampton Wanderers,2-0,2,0,1,1,2,2,H
1894-10-20,1894,West Bromwich Albion,Derby County,2-2,2,2,1,1,4,0,D
1894-10-22,1894,Sheffield United,Aston Villa,2-1,2,1,1,1,3,1,H
1894-10-27,1894,Aston Villa,Liverpool,5-0,5,0,1,1,5,5,H
1894-10-27,1894,Blackburn Rovers,Preston North End,1-1,1,1,1,1,2,0,D
1894-10-27,1894,Burnley,Nottingham Forest,0-1,0,1,1,1,1,-1,A
1894-10-27,1894,Derby County,West Bromwich Albion,1-1,1,1,1,1,2,0,D
1894-10-27,1894,Everton,Sunderland,2-2,2,2,1,1,4,0,D
1894-10-27,1894,Sheffield Wednesday,Sheffield United,2-3,2,3,1,1,5,-1,A
1894-10-27,1894,Stoke City,Birmingham City,2-2,2,2,1,1,4,0,D
1894-10-27,1894,Wolverhampton Wanderers,Bolton Wanderers,4-2,4,2,1,1,6,2,H
1894-11-03,1894,Birmingham City,Everton,4-4,4,4,1,1,8,0,D
1894-11-03,1894,Bolton Wanderers,Blackburn Rovers,1-3,1,3,1,1,4,-2,A
1894-11-03,1894,Liverpool,Burnley,0-3,0,3,1,1,3,-3,A
1894-11-03,1894,Nottingham Forest,Derby County,2-1,2,1,1,1,3,1,H
1894-11-03,1894,Sheffield Wednesday,Aston Villa,1-0,1,0,1,1,1,1,H
1894-11-03,1894,Sunderland,Wolverhampton Wanderers,2-0,2,0,1,1,2,2,H
1894-11-03,1894,West Bromwich Albion,Sheffield United,1-0,1,0,1,1,1,1,H
1894-11-05,1894,West Bromwich Albion,Bolton Wanderers,1-1,1,1,1,1,2,0,D
1894-11-10,1894,Aston Villa,Preston North End,4-1,4,1,1,1,5,3,H
1894-11-10,1894,Blackburn Rovers,Sunderland,1-1,1,1,1,1,2,0,D
1894-11-10,1894,Burnley,Sheffield Wednesday,3-0,3,0,1,1,3,3,H
1894-11-10,1894,Stoke City,Liverpool,3-1,3,1,1,1,4,2,H
1894-11-10,1894,West Bromwich Albion,Birmingham City,4-1,4,1,1,1,5,3,H
1894-11-10,1894,Wolverhampton Wanderers,Nottingham Forest,1-1,1,1,1,1,2,0,D
1894-11-12,1894,Aston Villa,Sheffield United,5-0,5,0,1,1,5,5,H
1894-11-12,1894,Stoke City,Preston North End,2-1,2,1,1,1,3,1,H
1894-11-17,1894,Birmingham City,Stoke City,4-2,4,2,1,1,6,2,H
1894-11-17,1894,Blackburn Rovers,Burnley,1-0,1,0,1,1,1,1,H
1894-11-17,1894,Liverpool,Everton,2-2,2,2,1,1,4,0,D
1894-11-17,1894,Nottingham Forest,Sheffield United,3-0,3,0,1,1,3,3,H
1894-11-17,1894,Preston North End,Derby County,3-2,3,2,1,1,5,1,H
1894-11-17,1894,Sheffield Wednesday,Wolverhampton Wanderers,3-1,3,1,1,1,4,2,H
1894-11-17,1894,Sunderland,Bolton Wanderers,4-0,4,0,1,1,4,4,H
1894-11-17,1894,West Bromwich Albion,Aston Villa,3-2,3,2,1,1,5,1,H
1894-11-24,1894,Aston Villa,Nottingham Forest,4-1,4,1,1,1,5,3,H
1894-11-24,1894,Bolton Wanderers,Birmingham City,1-2,1,2,1,1,3,-1,A
1894-11-24,1894,Burnley,West Bromwich Albion,2-0,2,0,1,1,2,2,H
1894-11-24,1894,Derby County,Preston North End,2-1,2,1,1,1,3,1,H
1894-11-24,1894,Everton,Blackburn Rovers,2-1,2,1,1,1,3,1,H
1894-11-24,1894,Sunderland,Liverpool,3-2,3,2,1,1,5,1,H
1894-11-24,1894,Wolverhampton Wanderers,Stoke City,0-0,0,0,1,1,0,0,D
1894-12-01,1894,Birmingham City,Sheffield United,4-2,4,2,1,1,6,2,H
1894-12-01,1894,Blackburn Rovers,Aston Villa,1-3,1,3,1,1,4,-2,A
1894-12-01,1894,Liverpool,Wolverhampton Wanderers,3-3,3,3,1,1,6,0,D
1894-12-01,1894,Preston North End,Bolton Wanderers,2-2,2,2,1,1,4,0,D
1894-12-01,1894,West Bromwich Albion,Everton,1-4,1,4,1,1,5,-3,A
1894-12-03,1894,Aston Villa,Sheffield Wednesday,3-1,3,1,1,1,4,2,H
1894-12-08,1894,Aston Villa,Blackburn Rovers,3-0,3,0,1,1,3,3,H
1894-12-08,1894,Burnley,Preston North End,2-1,2,1,1,1,3,1,H
1894-12-08,1894,Everton,Bolton Wanderers,3-1,3,1,1,1,4,2,H
1894-12-08,1894,Nottingham Forest,West Bromwich Albion,5-3,5,3,1,1,8,2,H
1894-12-08,1894,Sheffield United,Liverpool,2-2,2,2,1,1,4,0,D
1894-12-08,1894,Stoke City,Sheffield Wednesday,0-2,0,2,1,1,2,-2,A
1894-12-08,1894,Sunderland,Birmingham City,7-1,7,1,1,1,8,6,H
1894-12-08,1894,Wolverhampton Wanderers,Derby County,2-2,2,2,1,1,4,0,D
1894-12-12,1894,Derby County,Burnley,0-2,0,2,1,1,2,-2,A
1894-12-15,1894,Bolton Wanderers,Wolverhampton Wanderers,6-1,6,1,1,1,7,5,H
1894-12-15,1894,Derby County,Sheffield United,4-1,4,1,1,1,5,3,H
1894-12-15,1894,Liverpool,Birmingham City,3-1,3,1,1,1,4,2,H
1894-12-15,1894,Preston North End,Everton,1-2,1,2,1,1,3,-1,A
1894-12-15,1894,Sheffield Wednesday,Nottingham Forest,0-0,0,0,1,1,0,0,D
1894-12-15,1894,Sunderland,Blackburn Rovers,3-2,3,2,1,1,5,1,H
1894-12-15,1894,West Bromwich Albion,Stoke City,3-2,3,2,1,1,5,1,H
1894-12-22,1894,Birmingham City,Nottingham Forest,1-2,1,2,1,1,3,-1,A
1894-12-22,1894,Blackburn Rovers,West Bromwich Albion,3-0,3,0,1,1,3,3,H
1894-12-22,1894,Burnley,Sheffield United,2-4,2,4,1,1,6,-2,A
1894-12-22,1894,Wolverhampton Wanderers,Aston Villa,0-4,0,4,1,1,4,-4,A
1894-12-25,1894,Bolton Wanderers,Liverpool,1-0,1,0,1,1,1,1,H
1894-12-25,1894,Preston North End,Stoke City,3-0,3,0,1,1,3,3,H
1894-12-25,1894,Sheffield United,Derby County,1-4,1,4,1,1,5,-3,A
1894-12-26,1894,Aston Villa,Stoke City,6-0,6,0,1,1,6,6,H
1894-12-26,1894,Blackburn Rovers,Sheffield United,3-2,3,2,1,1,5,1,H
1894-12-26,1894,Derby County,Bolton Wanderers,2-2,2,2,1,1,4,0,D
1894-12-26,1894,Sheffield Wednesday,Birmingham City,2-0,2,0,1,1,2,2,H
1894-12-26,1894,West Bromwich Albion,Sunderland,0-2,0,2,1,1,2,-2,A
1894-12-26,1894,Wolverhampton Wanderers,Burnley,1-0,1,0,1,1,1,1,H
1894-12-27,1894,Nottingham Forest,Sunderland,2-1,2,1,1,1,3,1,H
1894-12-27,1894,Sheffield Wednesday,Derby County,1-1,1,1,1,1,2,0,D
1894-12-27,1894,Wolverhampton Wanderers,West Bromwich Albion,3-1,3,1,1,1,4,2,H
1894-12-29,1894,Birmingham City,Liverpool,3-0,3,0,1,1,3,3,H
1894-12-29,1894,Nottingham Forest,Blackburn Rovers,2-3,2,3,1,1,5,-1,A
1894-12-29,1894,Preston North End,Sunderland,1-0,1,0,1,1,1,1,H
1894-12-29,1894,West Bromwich Albion,Burnley,0-1,0,1,1,1,1,-1,A
1895-01-01,1894,Blackburn Rovers,Nottingham Forest,0-0,0,0,1,1,0,0,D
1895-01-01,1894,Bolton Wanderers,Derby County,6-0,6,0,1,1,6,6,H
1895-01-01,1894,Liverpool,West Bromwich Albion,4-0,4,0,1,1,4,4,H
1895-01-01,1894,Sheffield Wednesday,Everton,3-0,3,0,1,1,3,3,H
1895-01-01,1894,Sunderland,Preston North End,2-0,2,0,1,1,2,2,H
1895-01-02,1894,Sunderland,Aston Villa,4-4,4,4,1,1,8,0,D
1895-01-05,1894,Aston Villa,Derby County,4-0,4,0,1,1,4,4,H
1895-01-05,1894,Blackburn Rovers,Birmingham City,9-1,9,1,1,1,10,8,H
1895-01-05,1894,Burnley,Bolton Wanderers,1-0,1,0,1,1,1,1,H
1895-01-05,1894,Sheffield Wednesday,Liverpool,5-0,5,0,1,1,5,5,H
1895-01-05,1894,Sunderland,Nottingham Forest,2-2,2,2,1,1,4,0,D
1895-01-05,1894,West Bromwich Albion,Preston North End,4-5,4,5,1,1,9,-1,A
1895-01-05,1894,Wolverhampton Wanderers,Everton,1-0,1,0,1,1,1,1,H
1895-01-07,1894,Bolton Wanderers,Sheffield Wednesday,2-2,2,2,1,1,4,0,D
1895-01-07,1894,Everton,Stoke City,3-0,3,0,1,1,3,3,H
1895-01-09,1894,Derby County,Liverpool,0-1,0,1,1,1,1,-1,A
1895-01-12,1894,Burnley,Blackburn Rovers,2-1,2,1,1,1,3,1,H
1895-01-12,1894,Derby County,Everton,2-2,2,2,1,1,4,0,D
1895-01-12,1894,Liverpool,Nottingham Forest,5-0,5,0,1,1,5,5,H
1895-01-12,1894,Preston North End,Aston Villa,0-1,0,1,1,1,1,-1,A
1895-01-12,1894,Sheffield United,Sheffield Wednesday,1-0,1,0,1,1,1,1,H
1895-01-12,1894,Stoke City,Bolton Wanderers,5-0,5,0,1,1,5,5,H
1895-01-12,1894,Wolverhampton Wanderers,Sunderland,1-4,1,4,1,1,5,-3,A
1895-01-14,1894,Bolton Wanderers,Sheffield United,6-2,6,2,1,1,8,4,H
1895-01-17,1894,Everton,Aston Villa,4-2,4,2,1,1,6,2,H
1895-01-19,1894,Derby County,Stoke City,1-1,1,1,1,1,2,0,D
1895-01-19,1894,Nottingham Forest,Sheffield Wednesday,2-1,2,1,1,1,3,1,H
1895-01-19,1894,Sheffield United,Wolverhampton Wanderers,1-0,1,0,1,1,1,1,H
1895-01-26,1894,Aston Villa,Bolton Wanderers,2-1,2,1,1,1,3,1,H
1895-01-26,1894,Derby County,Wolverhampton Wanderers,1-3,1,3,1,1,4,-2,A
1895-01-26,1894,Everton,Sheffield United,1-1,1,1,1,1,2,0,D
1895-01-26,1894,Nottingham Forest,Birmingham City,2-0,2,0,1,1,2,2,H
1895-01-26,1894,Preston North End,Burnley,4-0,4,0,1,1,4,4,H
1895-01-26,1894,Stoke City,Sunderland,2-5,2,5,1,1,7,-3,A
1895-01-26,1894,West Bromwich Albion,Blackburn Rovers,2-0,2,0,1,1,2,2,H
1895-02-04,1894,Stoke City,Wolverhampton Wanderers,0-0,0,0,1,1,0,0,D
1895-02-09,1894,Birmingham City,Sunderland,1-1,1,1,1,1,2,0,D
1895-02-09,1894,Sheffield United,Stoke City,3-0,3,0,1,1,3,3,H
1895-02-23,1894,Birmingham City,West Bromwich Albion,1-2,1,2,1,1,3,-1,A
1895-02-23,1894,Burnley,Aston Villa,3-3,3,3,1,1,6,0,D
1895-02-23,1894,Everton,Preston North End,4-2,4,2,1,1,6,2,H
1895-02-23,1894,Nottingham Forest,Stoke City,3-1,3,1,1,1,4,2,H
1895-02-23,1894,Sunderland,Sheffield United,2-0,2,0,1,1,2,2,H
1895-02-23,1894,Wolverhampton Wanderers,Blackburn Rovers,3-3,3,3,1,1,6,0,D
1895-02-26,1894,Preston North End,West Bromwich Albion,5-0,5,0,1,1,5,5,H
1895-02-26,1894,Sheffield United,Everton,4-2,4,2,1,1,6,2,H
1895-02-26,1894,Sunderland,Sheffield Wednesday,3-1,3,1,1,1,4,2,H
1895-03-02,1894,Birmingham City,Blackburn Rovers,1-1,1,1,1,1,2,0,D
1895-03-02,1894,Liverpool,Derby County,5-1,5,1,1,1,6,4,H
1895-03-09,1894,Sheffield United,Sunderland,4-0,4,0,1,1,4,4,H
1895-03-16,1894,Birmingham City,Derby County,3-5,3,5,1,1,8,-2,A
1895-03-16,1894,Burnley,Everton,2-4,2,4,1,1,6,-2,A
1895-03-16,1894,Nottingham Forest,Bolton Wanderers,3-3,3,3,1,1,6,0,D
1895-03-21,1894,Everton,Burnley,3-2,3,2,1,1,5,1,H
1895-03-23,1894,Birmingham City,Burnley,1-0,1,0,1,1,1,1,H
1895-03-23,1894,Blackburn Rovers,Wolverhampton Wanderers,5-1,5,1,1,1,6,4,H
1895-03-23,1894,Bolton Wanderers,Aston Villa,4-3,4,3,1,1,7,1,H
1895-03-23,1894,Preston North End,Nottingham Forest,3-1,3,1,1,1,4,2,H
1895-03-23,1894,Sheffield Wednesday,Sunderland,1-2,1,2,1,1,3,-1,A
1895-03-23,1894,Stoke City,Derby County,4-1,4,1,1,1,5,3,H
1895-03-25,1894,Birmingham City,Sheffield Wednesday,0-0,0,0,1,1,0,0,D
1895-03-25,1894,Liverpool,Sunderland,2-3,2,3,1,1,5,-1,A
1895-03-25,1894,Stoke City,West Bromwich Albion,1-1,1,1,1,1,2,0,D
1895-03-30,1894,Derby County,Birmingham City,4-1,4,1,1,1,5,3,H
1895-03-30,1894,Liverpool,Sheffield Wednesday,4-2,4,2,1,1,6,2,H
1895-03-30,1894,Stoke City,Burnley,5-1,5,1,1,1,6,4,H
1895-04-01,1894,Sheffield Wednesday,West Bromwich Albion,3-2,3,2,1,1,5,1,H
1895-04-06,1894,Aston Villa,Burnley,5-0,5,0,1,1,5,5,H
1895-04-06,1894,Derby County,Blackburn Rovers,0-0,0,0,1,1,0,0,D
1895-04-06,1894,Nottingham Forest,Liverpool,3-0,3,0,1,1,3,3,H
1895-04-08,1894,Everton,Wolverhampton Wanderers,2-1,2,1,1,1,3,1,H
1895-04-12,1894,Blackburn Rovers,Derby County,0-0,0,0,1,1,0,0,D
1895-04-12,1894,Bolton Wanderers,Nottingham Forest,4-1,4,1,1,1,5,3,H
1895-04-12,1894,Preston North End,Liverpool,2-2,2,2,1,1,4,0,D
1895-04-13,1894,Bolton Wanderers,West Bromwich Albion,5-0,5,0,1,1,5,5,H
1895-04-13,1894,Burnley,Sunderland,0-3,0,3,1,1,3,-3,A
1895-04-13,1894,Everton,Derby County,2-3,2,3,1,1,5,-1,A
1895-04-13,1894,Nottingham Forest,Wolverhampton Wanderers,0-2,0,2,1,1,2,-2,A
1895-04-13,1894,Preston North End,Sheffield Wednesday,3-1,3,1,1,1,4,2,H
1895-04-13,1894,Sheffield United,Birmingham City,0-2,0,2,1,1,2,-2,A
1895-04-13,1894,Stoke City,Blackburn Rovers,5-1,5,1,1,1,6,4,H
1895-04-15,1894,Aston Villa,Wolverhampton Wanderers,2-2,2,2,1,1,4,0,D
1895-04-15,1894,Sheffield United,Bolton Wanderers,5-0,5,0,1,1,5,5,H
1895-04-15,1894,West Bromwich Albion,Nottingham Forest,1-0,1,0,1,1,1,1,H
1895-04-17,1894,Sheffield Wednesday,Stoke City,2-4,2,4,1,1,6,-2,A
1895-04-20,1894,Burnley,Stoke City,1-2,1,2,1,1,3,-1,A
1895-04-20,1894,Liverpool,Preston North End,2-5,2,5,1,1,7,-3,A
1895-04-20,1894,Sunderland,Everton,2-1,2,1,1,1,3,1,H
1895-04-22,1894,West Bromwich Albion,Sheffield Wednesday,6-0,6,0,1,1,6,6,H
1895-04-24,1894,Aston Villa,Everton,2-2,2,2,1,1,4,0,D
1895-09-02,1895,Aston Villa,West Bromwich Albion,1-0,1,0,1,1,1,1,H
1895-09-02,1895,Everton,Sheffield Wednesday,2-2,2,2,1,1,4,0,D
1895-09-02,1895,Sheffield United,Birmingham City,2-0,2,0,1,1,2,2,H
1895-09-02,1895,Stoke City,Bolton Wanderers,2-0,2,0,1,1,2,2,H
1895-09-02,1895,Sunderland,Preston North End,4-1,4,1,1,1,5,3,H
1895-09-02,1895,Wolverhampton Wanderers,Burnley,5-1,5,1,1,1,6,4,H
1895-09-05,1895,Nottingham Forest,Bury,5-0,5,0,1,1,5,5,H
1895-09-07,1895,Aston Villa,Birmingham City,7-3,7,3,1,1,10,4,H
1895-09-07,1895,Bury,Bolton Wanderers,0-3,0,3,1,1,3,-3,A
1895-09-07,1895,Everton,Nottingham Forest,6-2,6,2,1,1,8,4,H
1895-09-07,1895,Preston North End,Wolverhampton Wanderers,4-3,4,3,1,1,7,1,H
1895-09-07,1895,Sheffield Wednesday,Sheffield United,1-0,1,0,1,1,1,1,H
1895-09-07,1895,Stoke City,Derby County,2-1,2,1,1,1,3,1,H
1895-09-07,1895,Sunderland,Blackburn Rovers,2-1,2,1,1,1,3,1,H
1895-09-07,1895,West Bromwich Albion,Burnley,0-2,0,2,1,1,2,-2,A
1895-09-09,1895,Burnley,Sunderland,0-0,0,0,1,1,0,0,D
1895-09-09,1895,Everton,Bury,3-2,3,2,1,1,5,1,H
1895-09-14,1895,Birmingham City,Stoke City,1-2,1,2,1,1,3,-1,A
1895-09-14,1895,Blackburn Rovers,Nottingham Forest,2-0,2,0,1,1,2,2,H
1895-09-14,1895,Bolton Wanderers,Everton,3-1,3,1,1,1,4,2,H
1895-09-14,1895,Burnley,Bury,3-0,3,0,1,1,3,3,H
1895-09-14,1895,Derby County,Sunderland,2-0,2,0,1,1,2,2,H
1895-09-14,1895,Sheffield United,Aston Villa,2-1,2,1,1,1,3,1,H
1895-09-14,1895,West Bromwich Albion,Preston North End,1-2,1,2,1,1,3,-1,A
1895-09-14,1895,Wolverhampton Wanderers,Sheffield Wednesday,4-0,4,0,1,1,4,4,H
1895-09-21,1895,Aston Villa,Derby County,4-1,4,1,1,1,5,3,H
1895-09-21,1895,Bolton Wanderers,Burnley,1-0,1,0,1,1,1,1,H
1895-09-21,1895,Bury,Sheffield United,1-0,1,0,1,1,1,1,H
1895-09-21,1895,Everton,Blackburn Rovers,0-2,0,2,1,1,2,-2,A
1895-09-21,1895,Nottingham Forest,Birmingham City,3-0,3,0,1,1,3,3,H
1895-09-21,1895,Stoke City,West Bromwich Albion,3-1,3,1,1,1,4,2,H
1895-09-21,1895,Sunderland,Wolverhampton Wanderers,2-2,2,2,1,1,4,0,D
1895-09-28,1895,Birmingham City,Bolton Wanderers,1-2,1,2,1,1,3,-1,A
1895-09-28,1895,Blackburn Rovers,Aston Villa,1-1,1,1,1,1,2,0,D
1895-09-28,1895,Burnley,Preston North End,1-0,1,0,1,1,1,1,H
1895-09-28,1895,Derby County,Sheffield Wednesday,3-1,3,1,1,1,4,2,H
1895-09-28,1895,Sheffield United,Stoke City,1-0,1,0,1,1,1,1,H
1895-09-28,1895,Sunderland,Bury,0-0,0,0,1,1,0,0,D
1895-09-28,1895,West Bromwich Albion,Nottingham Forest,3-1,3,1,1,1,4,2,H
1895-09-28,1895,Wolverhampton Wanderers,Everton,2-3,2,3,1,1,5,-1,A
1895-09-30,1895,Aston Villa,Everton,4-3,4,3,1,1,7,1,H
1895-09-30,1895,Sheffield United,Preston North End,2-1,2,1,1,1,3,1,H
1895-10-05,1895,Aston Villa,Sunderland,2-1,2,1,1,1,3,1,H
1895-10-05,1895,Blackburn Rovers,Burnley,1-0,1,0,1,1,1,1,H
1895-10-05,1895,Bolton Wanderers,Bury,2-4,2,4,1,1,6,-2,A
1895-10-05,1895,Everton,Sheffield United,5-0,5,0,1,1,5,5,H
1895-10-05,1895,Nottingham Forest,Derby County,2-5,2,5,1,1,7,-3,A
1895-10-05,1895,Preston North End,Birmingham City,3-2,3,2,1,1,5,1,H
1895-10-05,1895,Sheffield Wednesday,West Bromwich Albion,5-3,5,3,1,1,8,2,H
1895-10-05,1895,Wolverhampton Wanderers,Stoke City,1-0,1,0,1,1,1,1,H
1895-10-07,1895,Sheffield United,Sunderland,1-2,1,2,1,1,3,-1,A
1895-10-12,1895,Blackburn Rovers,Preston North End,3-0,3,0,1,1,3,3,H
1895-10-12,1895,Burnley,Bolton Wanderers,1-2,1,2,1,1,3,-1,A
1895-10-12,1895,Bury,Birmingham City,4-5,4,5,1,1,9,-1,A
1895-10-12,1895,Derby County,Stoke City,2-1,2,1,1,1,3,1,H
1895-10-12,1895,Nottingham Forest,Everton,2-1,2,1,1,1,3,1,H
1895-10-12,1895,Sheffield Wednesday,Wolverhampton Wanderers,3-1,3,1,1,1,4,2,H
1895-10-12,1895,West Bromwich Albion,Aston Villa,1-1,1,1,1,1,2,0,D
1895-10-19,1895,Aston Villa,Blackburn Rovers,3-1,3,1,1,1,4,2,H
1895-10-19,1895,Bolton Wanderers,Nottingham Forest,2-1,2,1,1,1,3,1,H
1895-10-19,1895,Derby County,Bury,2-1,2,1,1,1,3,1,H
1895-10-19,1895,Everton,West Bromwich Albion,1-1,1,1,1,1,2,0,D
1895-10-19,1895,Preston North End,Burnley,1-1,1,1,1,1,2,0,D
1895-10-19,1895,Sheffield Wednesday,Sunderland,3-0,3,0,1,1,3,3,H
1895-10-19,1895,Stoke City,Birmingham City,6-1,6,1,1,1,7,5,H
1895-10-19,1895,Wolverhampton Wanderers,Sheffield United,4-1,4,1,1,1,5,3,H
1895-10-26,1895,Birmingham City,Aston Villa,1-4,1,4,1,1,5,-3,A
1895-10-26,1895,Blackburn Rovers,Sunderland,2-4,2,4,1,1,6,-2,A
1895-10-26,1895,Bolton Wanderers,Stoke City,3-1,3,1,1,1,4,2,H
1895-10-26,1895,Burnley,Everton,1-1,1,1,1,1,2,0,D
1895-10-26,1895,Derby County,Wolverhampton Wanderers,5-2,5,2,1,1,7,3,H
1895-10-26,1895,Nottingham Forest,Preston North End,0-1,0,1,1,1,1,-1,A
1895-10-26,1895,West Bromwich Albion,Sheffield Wednesday,2-3,2,3,1,1,5,-1,A
1895-11-02,1895,Aston Villa,Burnley,5-1,5,1,1,1,6,4,H
1895-11-02,1895,Bury,West Bromwich Albion,3-0,3,0,1,1,3,3,H
1895-11-02,1895,Everton,Wolverhampton Wanderers,2-0,2,0,1,1,2,2,H
1895-11-02,1895,Preston North End,Blackburn Rovers,1-1,1,1,1,1,2,0,D
1895-11-02,1895,Sheffield Wednesday,Bolton Wanderers,1-1,1,1,1,1,2,0,D
1895-11-02,1895,Stoke City,Sheffield United,4-0,4,0,1,1,4,4,H
1895-11-02,1895,Sunderland,Derby County,2-2,2,2,1,1,4,0,D
1895-11-04,1895,West Bromwich Albion,Bolton Wanderers,2-3,2,3,1,1,5,-1,A
1895-11-09,1895,Birmingham City,Nottingham Forest,1-0,1,0,1,1,1,1,H
1895-11-09,1895,Blackburn Rovers,Wolverhampton Wanderers,3-1,3,1,1,1,4,2,H
1895-11-09,1895,Bury,Sheffield Wednesday,6-1,6,1,1,1,7,5,H
1895-11-09,1895,Derby County,Burnley,5-1,5,1,1,1,6,4,H
1895-11-09,1895,Preston North End,Bolton Wanderers,1-0,1,0,1,1,1,1,H
1895-11-09,1895,Sheffield United,Everton,1-2,1,2,1,1,3,-1,A
1895-11-09,1895,Sunderland,Aston Villa,2-1,2,1,1,1,3,1,H
1895-11-09,1895,West Bromwich Albion,Stoke City,1-0,1,0,1,1,1,1,H
1895-11-11,1895,Stoke City,Preston North End,4-0,4,0,1,1,4,4,H
1895-11-16,1895,Aston Villa,Sheffield United,2-2,2,2,1,1,4,0,D
1895-11-16,1895,Everton,Sunderland,1-0,1,0,1,1,1,1,H
1895-11-16,1895,Nottingham Forest,West Bromwich Albion,2-0,2,0,1,1,2,2,H
1895-11-16,1895,Sheffield Wednesday,Stoke City,2-1,2,1,1,1,3,1,H
1895-11-16,1895,Wolverhampton Wanderers,Derby County,2-0,2,0,1,1,2,2,H
1895-11-23,1895,Birmingham City,Preston North End,5-2,5,2,1,1,7,3,H
1895-11-23,1895,Blackburn Rovers,Sheffield Wednesday,2-1,2,1,1,1,3,1,H
1895-11-23,1895,Burnley,Aston Villa,3-4,3,4,1,1,7,-1,A
1895-11-23,1895,Bury,Derby County,1-2,1,2,1,1,3,-1,A
1895-11-23,1895,Sheffield United,Nottingham Forest,2-1,2,1,1,1,3,1,H
1895-11-23,1895,Stoke City,Wolverhampton Wanderers,4-1,4,1,1,1,5,3,H
1895-11-23,1895,Sunderland,Bolton Wanderers,1-0,1,0,1,1,1,1,H
1895-11-23,1895,West Bromwich Albion,Everton,0-3,0,3,1,1,3,-3,A
1895-11-28,1895,Nottingham Forest,Stoke City,4-0,4,0,1,1,4,4,H
1895-11-30,1895,Bolton Wanderers,Blackburn Rovers,1-1,1,1,1,1,2,0,D
1895-11-30,1895,Bury,Stoke City,0-1,0,1,1,1,1,-1,A
1895-11-30,1895,Derby County,Birmingham City,8-0,8,0,1,1,8,8,H
1895-11-30,1895,Everton,Burnley,2-1,2,1,1,1,3,1,H
1895-11-30,1895,Preston North End,Sheffield United,4-3,4,3,1,1,7,1,H
1895-11-30,1895,Sheffield Wednesday,Nottingham Forest,3-0,3,0,1,1,3,3,H
1895-11-30,1895,West Bromwich Albion,Wolverhampton Wanderers,2-1,2,1,1,1,3,1,H
1895-12-07,1895,Birmingham City,Everton,0-3,0,3,1,1,3,-3,A
1895-12-07,1895,Blackburn Rovers,Bolton Wanderers,3-2,3,2,1,1,5,1,H
1895-12-07,1895,Derby County,Nottingham Forest,4-0,4,0,1,1,4,4,H
1895-12-07,1895,Preston North End,Aston Villa,4-3,4,3,1,1,7,1,H
1895-12-07,1895,Stoke City,Burnley,2-1,2,1,1,1,3,1,H
1895-12-14,1895,Aston Villa,Bolton Wanderers,2-0,2,0,1,1,2,2,H
1895-12-14,1895,Bury,Preston North End,1-2,1,2,1,1,3,-1,A
1895-12-14,1895,Derby County,West Bromwich Albion,4-1,4,1,1,1,5,3,H
1895-12-14,1895,Everton,Stoke City,7-2,7,2,1,1,9,5,H
1895-12-14,1895,Nottingham Forest,Sheffield United,3-1,3,1,1,1,4,2,H
1895-12-14,1895,Sheffield Wednesday,Burnley,1-0,1,0,1,1,1,1,H
1895-12-14,1895,Sunderland,Birmingham City,2-1,2,1,1,1,3,1,H
1895-12-14,1895,Wolverhampton Wanderers,Blackburn Rovers,1-2,1,2,1,1,3,-1,A
1895-12-21,1895,Birmingham City,West Bromwich Albion,2-2,2,2,1,1,4,0,D
1895-12-21,1895,Bolton Wanderers,Sunderland,1-0,1,0,1,1,1,1,H
1895-12-21,1895,Burnley,Nottingham Forest,0-0,0,0,1,1,0,0,D
1895-12-21,1895,Everton,Aston Villa,2-0,2,0,1,1,2,2,H
1895-12-21,1895,Sheffield United,Derby County,1-1,1,1,1,1,2,0,D
1895-12-21,1895,Stoke City,Sheffield Wednesday,5-0,5,0,1,1,5,5,H
1895-12-21,1895,Wolverhampton Wanderers,Preston North End,2-1,2,1,1,1,3,1,H
1895-12-25,1895,Preston North End,Stoke City,0-1,0,1,1,1,1,-1,A
1895-12-26,1895,Birmingham City,Burnley,1-0,1,0,1,1,1,1,H
1895-12-26,1895,Derby County,Bolton Wanderers,2-1,2,1,1,1,3,1,H
1895-12-26,1895,Sheffield United,Sheffield Wednesday,1-1,1,1,1,1,2,0,D
1895-12-26,1895,Stoke City,Bury,0-2,0,2,1,1,2,-2,A
1895-12-26,1895,West Bromwich Albion,Sunderland,1-1,1,1,1,1,2,0,D
1895-12-26,1895,Wolverhampton Wanderers,Aston Villa,1-2,1,2,1,1,3,-1,A
1895-12-27,1895,Wolverhampton Wanderers,Sunderland,1-3,1,3,1,1,4,-2,A
1895-12-28,1895,Aston Villa,Bury,2-0,2,0,1,1,2,2,H
1895-12-28,1895,Nottingham Forest,Blackburn Rovers,4-2,4,2,1,1,6,2,H
1895-12-28,1895,Sheffield Wednesday,Derby County,0-4,0,4,1,1,4,-4,A
1895-12-30,1895,Sheffield United,Bolton Wanderers,1-0,1,0,1,1,1,1,H
1896-01-01,1895,Blackburn Rovers,Everton,2-3,2,3,1,1,5,-1,A
1896-01-01,1895,Bolton Wanderers,Derby County,2-1,2,1,1,1,3,1,H
1896-01-01,1895,Bury,Burnley,3-4,3,4,1,1,7,-1,A
1896-01-01,1895,Sheffield Wednesday,Preston North End,1-1,1,1,1,1,2,0,D
1896-01-04,1895,Birmingham City,Derby County,1-3,1,3,1,1,4,-2,A
1896-01-04,1895,Blackburn Rovers,Bury,0-2,0,2,1,1,2,-2,A
1896-01-04,1895,Bolton Wanderers,Wolverhampton Wanderers,4-0,4,0,1,1,4,4,H
1896-01-04,1895,Burnley,Sheffield Wednesday,2-0,2,0,1,1,2,2,H
1896-01-04,1895,Preston North End,Sunderland,4-1,4,1,1,1,5,3,H
1896-01-04,1895,Sheffield United,West Bromwich Albion,2-0,2,0,1,1,2,2,H
1896-01-04,1895,Stoke City,Aston Villa,1-2,1,2,1,1,3,-1,A
1896-01-11,1895,Aston Villa,Preston North End,1-0,1,0,1,1,1,1,H
1896-01-11,1895,Burnley,West Bromwich Albion,3-0,3,0,1,1,3,3,H
1896-01-11,1895,Bury,Everton,1-1,1,1,1,1,2,0,D
1896-01-11,1895,Nottingham Forest,Bolton Wanderers,0-0,0,0,1,1,0,0,D
1896-01-11,1895,Sheffield Wednesday,Blackburn Rovers,3-0,3,0,1,1,3,3,H
1896-01-11,1895,Sunderland,Sheffield United,1-1,1,1,1,1,2,0,D
1896-01-18,1895,Birmingham City,Wolverhampton Wanderers,3-2,3,2,1,1,5,1,H
1896-01-18,1895,Nottingham Forest,Sunderland,3-1,3,1,1,1,4,2,H
1896-01-18,1895,Sheffield Wednesday,Aston Villa,1-3,1,3,1,1,4,-2,A
1896-01-18,1895,West Bromwich Albion,Derby County,0-0,0,0,1,1,0,0,D
1896-01-25,1895,Aston Villa,Nottingham Forest,3-1,3,1,1,1,4,2,H
1896-01-25,1895,Blackburn Rovers,Sheffield United,1-0,1,0,1,1,1,1,H
1896-01-25,1895,Preston North End,Everton,1-1,1,1,1,1,2,0,D
1896-01-25,1895,Sunderland,West Bromwich Albion,7-1,7,1,1,1,8,6,H
1896-01-25,1895,Wolverhampton Wanderers,Birmingham City,7-2,7,2,1,1,9,5,H
1896-02-03,1895,Burnley,Sheffield United,5-0,5,0,1,1,5,5,H
1896-02-03,1895,Everton,Birmingham City,3-0,3,0,1,1,3,3,H
1896-02-08,1895,Birmingham City,Sheffield Wednesday,1-1,1,1,1,1,2,0,D
1896-02-08,1895,Derby County,Aston Villa,2-2,2,2,1,1,4,0,D
1896-02-08,1895,Sheffield United,Wolverhampton Wanderers,2-1,2,1,1,1,3,1,H
1896-02-08,1895,Sunderland,Nottingham Forest,1-1,1,1,1,1,2,0,D
1896-02-17,1895,Blackburn Rovers,West Bromwich Albion,1-0,1,0,1,1,1,1,H
1896-02-18,1895,Bury,Wolverhampton Wanderers,3-0,3,0,1,1,3,3,H
1896-02-18,1895,Sheffield Wednesday,Everton,3-1,3,1,1,1,4,2,H
1896-02-18,1895,Sunderland,Burnley,3-1,3,1,1,1,4,2,H
1896-02-22,1895,Aston Villa,Stoke City,5-2,5,2,1,1,7,3,H
1896-02-22,1895,Blackburn Rovers,Derby County,0-2,0,2,1,1,2,-2,A
1896-02-22,1895,Bolton Wanderers,Birmingham City,4-1,4,1,1,1,5,3,H
1896-02-22,1895,Burnley,Wolverhampton Wanderers,3-1,3,1,1,1,4,2,H
1896-02-22,1895,Preston North End,Nottingham Forest,6-0,6,0,1,1,6,6,H
1896-02-22,1895,Sheffield Wednesday,Bury,1-3,1,3,1,1,4,-2,A
1896-02-22,1895,Sunderland,Everton,3-0,3,0,1,1,3,3,H
1896-02-22,1895,West Bromwich Albion,Sheffield United,1-0,1,0,1,1,1,1,H
1896-02-29,1895,Birmingham City,Blackburn Rovers,2-1,2,1,1,1,3,1,H
1896-03-04,1895,Derby County,Preston North End,1-0,1,0,1,1,1,1,H
1896-03-07,1895,Birmingham City,Bury,1-0,1,0,1,1,1,1,H
1896-03-07,1895,Bolton Wanderers,Aston Villa,2-2,2,2,1,1,4,0,D
1896-03-07,1895,Everton,Preston North End,3-2,3,2,1,1,5,1,H
1896-03-07,1895,Nottingham Forest,Burnley,2-1,2,1,1,1,3,1,H
1896-03-07,1895,Sheffield United,Blackburn Rovers,1-1,1,1,1,1,2,0,D
1896-03-07,1895,Sunderland,Sheffield Wednesday,2-1,2,1,1,1,3,1,H
1896-03-07,1895,Wolverhampton Wanderers,West Bromwich Albion,1-2,1,2,1,1,3,-1,A
1896-03-09,1895,West Bromwich Albion,Bury,1-3,1,3,1,1,4,-2,A
1896-03-14,1895,Aston Villa,Sheffield Wednesday,2-1,2,1,1,1,3,1,H
1896-03-14,1895,Bolton Wanderers,Preston North End,1-0,1,0,1,1,1,1,H
1896-03-14,1895,Derby County,Sheffield United,0-2,0,2,1,1,2,-2,A
1896-03-14,1895,Stoke City,Sunderland,5-0,5,0,1,1,5,5,H
1896-03-16,1895,Burnley,Stoke City,2-0,2,0,1,1,2,2,H
1896-03-21,1895,Blackburn Rovers,Birmingham City,2-1,2,1,1,1,3,1,H
1896-03-21,1895,Bury,Aston Villa,5-3,5,3,1,1,8,2,H
1896-03-21,1895,Stoke City,Nottingham Forest,1-0,1,0,1,1,1,1,H
1896-03-24,1895,Bury,Nottingham Forest,1-0,1,0,1,1,1,1,H
1896-03-28,1895,Preston North End,Derby County,1-0,1,0,1,1,1,1,H
1896-03-28,1895,Sunderland,Stoke City,4-1,4,1,1,1,5,3,H
1896-03-28,1895,Wolverhampton Wanderers,Nottingham Forest,6-1,6,1,1,1,7,5,H
1896-03-30,1895,Sheffield United,Burnley,1-1,1,1,1,1,2,0,D
1896-04-03,1895,Blackburn Rovers,Stoke City,3-1,3,1,1,1,4,2,H
1896-04-03,1895,Bolton Wanderers,Sheffield United,4-1,4,1,1,1,5,3,H
1896-04-03,1895,Burnley,Birmingham City,1-1,1,1,1,1,2,0,D
1896-04-03,1895,Bury,Sunderland,1-2,1,2,1,1,3,-1,A
1896-04-03,1895,Everton,Derby County,2-2,2,2,1,1,4,0,D
1896-04-03,1895,Nottingham Forest,Aston Villa,0-2,0,2,1,1,2,-2,A
1896-04-03,1895,Preston North End,West Bromwich Albion,0-0,0,0,1,1,0,0,D
1896-04-04,1895,Bolton Wanderers,West Bromwich Albion,2-1,2,1,1,1,3,1,H
1896-04-04,1895,Burnley,Derby County,2-2,2,2,1,1,4,0,D
1896-04-04,1895,Nottingham Forest,Wolverhampton Wanderers,3-2,3,2,1,1,5,1,H
1896-04-04,1895,Preston North End,Bury,1-1,1,1,1,1,2,0,D
1896-04-04,1895,Sheffield Wednesday,Birmingham City,3-0,3,0,1,1,3,3,H
1896-04-04,1895,Stoke City,Blackburn Rovers,3-0,3,0,1,1,3,3,H
1896-04-06,1895,Aston Villa,Wolverhampton Wanderers,4-1,4,1,1,1,5,3,H
1896-04-06,1895,Everton,Bolton Wanderers,1-1,1,1,1,1,2,0,D
1896-04-06,1895,Preston North End,Sheffield Wednesday,0-1,0,1,1,1,1,-1,A
1896-04-06,1895,Sheffield United,Bury,8-0,8,0,1,1,8,8,H
1896-04-06,1895,West Bromwich Albion,Birmingham City,0-0,0,0,1,1,0,0,D
1896-04-07,1895,Birmingham City,Sheffield United,2-1,2,1,1,1,3,1,H
1896-04-07,1895,Derby County,Everton,2-1,2,1,1,1,3,1,H
1896-04-07,1895,Nottingham Forest,Sheffield Wednesday,1-0,1,0,1,1,1,1,H
1896-04-07,1895,Wolverhampton Wanderers,Bury,1-0,1,0,1,1,1,1,H
1896-04-11,1895,Birmingham City,Sunderland,0-1,0,1,1,1,1,-1,A
1896-04-11,1895,Derby County,Blackburn Rovers,0-0,0,0,1,1,0,0,D
1896-04-11,1895,Stoke City,Everton,1-2,1,2,1,1,3,-1,A
1896-04-11,1895,Wolverhampton Wanderers,Bolton Wanderers,5-0,5,0,1,1,5,5,H
1896-04-18,1895,Burnley,Blackburn Rovers,6-0,6,0,1,1,6,6,H
1896-04-25,1895,Bolton Wanderers,Sheffield Wednesday,2-0,2,0,1,1,2,2,H
1896-04-25,1895,Bury,Blackburn Rovers,2-0,2,0,1,1,2,2,H
1896-04-29,1895,West Bromwich Albion,Blackburn Rovers,3-2,3,2,1,1,5,1,H
1896-09-01,1896,Blackburn Rovers,West Bromwich Albion,1-2,1,2,1,1,3,-1,A
1896-09-01,1896,Sheffield Wednesday,Liverpool,1-2,1,2,1,1,3,-1,A
1896-09-01,1896,Sunderland,Bury,0-1,0,1,1,1,1,-1,A
1896-09-01,1896,Wolverhampton Wanderers,Derby County,1-0,1,0,1,1,1,1,H
1896-09-02,1896,Aston Villa,Stoke City,2-1,2,1,1,1,3,1,H
1896-09-05,1896,Blackburn Rovers,Liverpool,1-0,1,0,1,1,1,1,H
1896-09-05,1896,Bury,Preston North End,0-0,0,0,1,1,0,0,D
1896-09-05,1896,Derby County,Nottingham Forest,1-1,1,1,1,1,2,0,D
1896-09-05,1896,Everton,Sheffield Wednesday,2-1,2,1,1,1,3,1,H
1896-09-05,1896,Sheffield United,Burnley,1-0,1,0,1,1,1,1,H
1896-09-05,1896,Stoke City,Wolverhampton Wanderers,2-1,2,1,1,1,3,1,H
1896-09-05,1896,Sunderland,Bolton Wanderers,1-1,1,1,1,1,2,0,D
1896-09-05,1896,West Bromwich Albion,Aston Villa,3-1,3,1,1,1,4,2,H
1896-09-07,1896,Burnley,Sunderland,1-1,1,1,1,1,2,0,D
1896-09-07,1896,Liverpool,Bolton Wanderers,0-2,0,2,1,1,2,-2,A
1896-09-12,1896,Aston Villa,Sheffield United,2-2,2,2,1,1,4,0,D
1896-09-12,1896,Bolton Wanderers,Blackburn Rovers,0-0,0,0,1,1,0,0,D
1896-09-12,1896,Burnley,Bury,1-0,1,0,1,1,1,1,H
1896-09-12,1896,Liverpool,Derby County,2-0,2,0,1,1,2,2,H
1896-09-12,1896,Nottingham Forest,Stoke City,4-0,4,0,1,1,4,4,H
1896-09-12,1896,Preston North End,Sunderland,5-3,5,3,1,1,8,2,H
1896-09-12,1896,Sheffield Wednesday,West Bromwich Albion,3-1,3,1,1,1,4,2,H
1896-09-12,1896,Wolverhampton Wanderers,Everton,0-1,0,1,1,1,1,-1,A
1896-09-19,1896,Blackburn Rovers,Sheffield Wednesday,4-0,4,0,1,1,4,4,H
1896-09-19,1896,Burnley,Nottingham Forest,2-2,2,2,1,1,4,0,D
1896-09-19,1896,Bury,Liverpool,1-2,1,2,1,1,3,-1,A
1896-09-19,1896,Derby County,Wolverhampton Wanderers,4-3,4,3,1,1,7,1,H
1896-09-19,1896,Everton,Aston Villa,2-3,2,3,1,1,5,-1,A
1896-09-19,1896,Sheffield United,Sunderland,3-0,3,0,1,1,3,3,H
1896-09-19,1896,Stoke City,Bolton Wanderers,2-3,2,3,1,1,5,-1,A
1896-09-19,1896,West Bromwich Albion,Preston North End,1-1,1,1,1,1,2,0,D
1896-09-26,1896,Aston Villa,Everton,1-2,1,2,1,1,3,-1,A
1896-09-26,1896,Bolton Wanderers,Sunderland,1-0,1,0,1,1,1,1,H
1896-09-26,1896,Derby County,Bury,7-2,7,2,1,1,9,5,H
1896-09-26,1896,Liverpool,West Bromwich Albion,0-0,0,0,1,1,0,0,D
1896-09-26,1896,Nottingham Forest,Sheffield United,2-2,2,2,1,1,4,0,D
1896-09-26,1896,Preston North End,Burnley,5-3,5,3,1,1,8,2,H
1896-09-26,1896,Sheffield Wednesday,Stoke City,4-3,4,3,1,1,7,1,H
1896-09-26,1896,Wolverhampton Wanderers,Blackburn Rovers,1-1,1,1,1,1,2,0,D
1896-10-03,1896,Blackburn Rovers,Burnley,3-2,3,2,1,1,5,1,H
1896-10-03,1896,Bolton Wanderers,Preston North End,3-1,3,1,1,1,4,2,H
1896-10-03,1896,Everton,Liverpool,2-1,2,1,1,1,3,1,H
1896-10-03,1896,Sheffield United,Aston Villa,0-0,0,0,1,1,0,0,D
1896-10-03,1896,Sunderland,Wolverhampton Wanderers,0-3,0,3,1,1,3,-3,A
1896-10-03,1896,West Bromwich Albion,Sheffield Wednesday,0-2,0,2,1,1,2,-2,A
1896-10-10,1896,Aston Villa,West Bromwich Albion,2-0,2,0,1,1,2,2,H
1896-10-10,1896,Bolton Wanderers,Bury,2-0,2,0,1,1,2,2,H
1896-10-10,1896,Burnley,Everton,2-1,2,1,1,1,3,1,H
1896-10-10,1896,Derby County,Sheffield United,1-3,1,3,1,1,4,-2,A
1896-10-10,1896,Liverpool,Nottingham Forest,3-0,3,0,1,1,3,3,H
1896-10-10,1896,Preston North End,Blackburn Rovers,3-1,3,1,1,1,4,2,H
1896-10-10,1896,Sheffield Wednesday,Sunderland,0-0,0,0,1,1,0,0,D
1896-10-10,1896,Wolverhampton Wanderers,Stoke City,1-2,1,2,1,1,3,-1,A
1896-10-17,1896,Blackburn Rovers,Bolton Wanderers,1-0,1,0,1,1,1,1,H
1896-10-17,1896,Burnley,Preston North End,2-2,2,2,1,1,4,0,D
1896-10-17,1896,Bury,Sheffield Wednesday,1-1,1,1,1,1,2,0,D
1896-10-17,1896,Derby County,Aston Villa,1-3,1,3,1,1,4,-2,A
1896-10-17,1896,Everton,Sheffield United,1-2,1,2,1,1,3,-1,A
1896-10-17,1896,Stoke City,Nottingham Forest,3-0,3,0,1,1,3,3,H
1896-10-17,1896,Sunderland,Liverpool,4-3,4,3,1,1,7,1,H
1896-10-17,1896,West Bromwich Albion,Wolverhampton Wanderers,1-0,1,0,1,1,1,1,H
1896-10-19,1896,Sheffield United,Liverpool,1-1,1,1,1,1,2,0,D
1896-10-24,1896,Aston Villa,Derby County,2-1,2,1,1,1,3,1,H
1896-10-24,1896,Bolton Wanderers,Stoke City,4-0,4,0,1,1,4,4,H
1896-10-24,1896,Liverpool,Blackburn Rovers,4-0,4,0,1,1,4,4,H
1896-10-24,1896,Nottingham Forest,Burnley,4-1,4,1,1,1,5,3,H
1896-10-24,1896,Preston North End,Sheffield United,1-0,1,0,1,1,1,1,H
1896-10-24,1896,Sheffield Wednesday,Everton,4-1,4,1,1,1,5,3,H
1896-10-24,1896,West Bromwich Albion,Bury,0-0,0,0,1,1,0,0,D
1896-10-24,1896,Wolverhampton Wanderers,Sunderland,0-1,0,1,1,1,1,-1,A
1896-10-31,1896,Blackburn Rovers,Preston North End,0-4,0,4,1,1,4,-4,A
1896-10-31,1896,Bury,Bolton Wanderers,2-2,2,2,1,1,4,0,D
1896-10-31,1896,Everton,Wolverhampton Wanderers,0-0,0,0,1,1,0,0,D
1896-10-31,1896,Nottingham Forest,Sheffield Wednesday,2-2,2,2,1,1,4,0,D
1896-10-31,1896,Sheffield United,Derby County,2-2,2,2,1,1,4,0,D
1896-10-31,1896,Stoke City,Aston Villa,0-2,0,2,1,1,2,-2,A
1896-10-31,1896,West Bromwich Albion,Liverpool,0-1,0,1,1,1,1,-1,A
1896-11-02,1896,West Bromwich Albion,Bolton Wanderers,1-0,1,0,1,1,1,1,H
1896-11-07,1896,Aston Villa,Bury,1-1,1,1,1,1,2,0,D
1896-11-07,1896,Burnley,Blackburn Rovers,0-1,0,1,1,1,1,-1,A
1896-11-07,1896,Derby County,Stoke City,5-1,5,1,1,1,6,4,H
1896-11-07,1896,Liverpool,Sunderland,3-0,3,0,1,1,3,3,H
1896-11-07,1896,Preston North End,Nottingham Forest,3-2,3,2,1,1,5,1,H
1896-11-09,1896,Stoke City,Preston North End,2-1,2,1,1,1,3,1,H
1896-11-14,1896,Blackburn Rovers,Nottingham Forest,0-0,0,0,1,1,0,0,D
1896-11-14,1896,Bury,Stoke City,4-2,4,2,1,1,6,2,H
1896-11-14,1896,Derby County,Burnley,3-2,3,2,1,1,5,1,H
1896-11-14,1896,Everton,Bolton Wanderers,2-3,2,3,1,1,5,-1,A
1896-11-14,1896,Preston North End,Liverpool,1-1,1,1,1,1,2,0,D
1896-11-14,1896,Sheffield Wednesday,Aston Villa,1-3,1,3,1,1,4,-2,A
1896-11-14,1896,West Bromwich Albion,Sheffield United,0-1,0,1,1,1,1,-1,A
1896-11-18,1896,Nottingham Forest,Derby County,1-2,1,2,1,1,3,-1,A
1896-11-21,1896,Aston Villa,Sheffield Wednesday,4-0,4,0,1,1,4,4,H
1896-11-21,1896,Derby County,Blackburn Rovers,6-0,6,0,1,1,6,6,H
1896-11-21,1896,Liverpool,Everton,0-0,0,0,1,1,0,0,D
1896-11-21,1896,Nottingham Forest,Sunderland,2-1,2,1,1,1,3,1,H
1896-11-21,1896,Preston North End,Bolton Wanderers,2-3,2,3,1,1,5,-1,A
1896-11-21,1896,Sheffield United,Bury,2-2,2,2,1,1,4,0,D
1896-11-21,1896,Stoke City,West Bromwich Albion,2-2,2,2,1,1,4,0,D
1896-11-21,1896,Wolverhampton Wanderers,Burnley,2-0,2,0,1,1,2,2,H
1896-11-28,1896,Blackburn Rovers,Aston Villa,1-5,1,5,1,1,6,-4,A
1896-11-28,1896,Bury,Wolverhampton Wanderers,3-2,3,2,1,1,5,1,H
1896-11-28,1896,Everton,Burnley,6-0,6,0,1,1,6,6,H
1896-11-28,1896,Nottingham Forest,Liverpool,2-0,2,0,1,1,2,2,H
1896-11-28,1896,Preston North End,Stoke City,3-0,3,0,1,1,3,3,H
1896-11-28,1896,Sheffield Wednesday,Derby County,2-0,2,0,1,1,2,2,H
1896-11-28,1896,West Bromwich Albion,Sunderland,1-0,1,0,1,1,1,1,H
1896-12-05,1896,Sheffield United,West Bromwich Albion,0-1,0,1,1,1,1,-1,A
1896-12-05,1896,Stoke City,Derby County,2-2,2,2,1,1,4,0,D
1896-12-05,1896,Sunderland,Sheffield Wednesday,0-0,0,0,1,1,0,0,D
1896-12-05,1896,Wolverhampton Wanderers,Nottingham Forest,4-1,4,1,1,1,5,3,H
1896-12-07,1896,Bolton Wanderers,Everton,2-0,2,0,1,1,2,2,H
1896-12-12,1896,Liverpool,Bury,3-1,3,1,1,1,4,2,H
1896-12-12,1896,Nottingham Forest,Blackburn Rovers,2-1,2,1,1,1,3,1,H
1896-12-12,1896,Sheffield Wednesday,Wolverhampton Wanderers,0-0,0,0,1,1,0,0,D
1896-12-12,1896,Sunderland,Everton,1-1,1,1,1,1,2,0,D
1896-12-12,1896,West Bromwich Albion,Stoke City,1-2,1,2,1,1,3,-1,A
1896-12-19,1896,Aston Villa,Nottingham Forest,3-2,3,2,1,1,5,1,H
1896-12-19,1896,Bolton Wanderers,West Bromwich Albion,2-2,2,2,1,1,4,0,D
1896-12-19,1896,Burnley,Sheffield Wednesday,1-1,1,1,1,1,2,0,D
1896-12-19,1896,Derby County,Liverpool,3-2,3,2,1,1,5,1,H
1896-12-19,1896,Everton,Stoke City,4-2,4,2,1,1,6,2,H
1896-12-19,1896,Sunderland,Blackburn Rovers,0-1,0,1,1,1,1,-1,A
1896-12-19,1896,Wolverhampton Wanderers,Preston North End,1-1,1,1,1,1,2,0,D
1896-12-25,1896,Blackburn Rovers,Sunderland,1-2,1,2,1,1,3,-1,A
1896-12-25,1896,Bury,Nottingham Forest,2-0,2,0,1,1,2,2,H
1896-12-25,1896,Derby County,West Bromwich Albion,8-1,8,1,1,1,9,7,H
1896-12-25,1896,Liverpool,Aston Villa,3-3,3,3,1,1,6,0,D
1896-12-26,1896,Burnley,Liverpool,4-1,4,1,1,1,5,3,H
1896-12-26,1896,Derby County,Bolton Wanderers,1-0,1,0,1,1,1,1,H
1896-12-26,1896,Everton,Sunderland,5-2,5,2,1,1,7,3,H
1896-12-26,1896,Preston North End,Bury,2-2,2,2,1,1,4,0,D
1896-12-26,1896,Sheffield United,Sheffield Wednesday,2-0,2,0,1,1,2,2,H
1896-12-26,1896,West Bromwich Albion,Blackburn Rovers,1-0,1,0,1,1,1,1,H
1896-12-26,1896,Wolverhampton Wanderers,Aston Villa,1-2,1,2,1,1,3,-1,A
1896-12-28,1896,Nottingham Forest,Bury,3-0,3,0,1,1,3,3,H
1896-12-28,1896,Sheffield Wednesday,Blackburn Rovers,6-0,6,0,1,1,6,6,H
1896-12-28,1896,Wolverhampton Wanderers,West Bromwich Albion,6-1,6,1,1,1,7,5,H
1896-12-29,1896,Sheffield United,Bolton Wanderers,1-0,1,0,1,1,1,1,H
1897-01-01,1896,Bolton Wanderers,Liverpool,1-4,1,4,1,1,5,-3,A
1897-01-01,1896,Bury,Burnley,1-1,1,1,1,1,2,0,D
1897-01-01,1896,Sheffield United,Everton,1-2,1,2,1,1,3,-1,A
1897-01-01,1896,Sunderland,Preston North End,1-1,1,1,1,1,2,0,D
1897-01-02,1896,Aston Villa,Burnley,0-3,0,3,1,1,3,-3,A
1897-01-02,1896,Blackburn Rovers,Wolverhampton Wanderers,2-0,2,0,1,1,2,2,H
1897-01-02,1896,Liverpool,Sheffield United,0-0,0,0,1,1,0,0,D
1897-01-02,1896,Nottingham Forest,West Bromwich Albion,0-1,0,1,1,1,1,-1,A
1897-01-02,1896,Sheffield Wednesday,Preston North End,1-0,1,0,1,1,1,1,H
1897-01-02,1896,Stoke City,Everton,2-3,2,3,1,1,5,-1,A
1897-01-02,1896,Sunderland,Derby County,1-2,1,2,1,1,3,-1,A
1897-01-09,1896,Burnley,Stoke City,1-3,1,3,1,1,4,-2,A
1897-01-09,1896,Derby County,Sheffield Wednesday,2-1,2,1,1,1,3,1,H
1897-01-09,1896,Everton,Nottingham Forest,3-1,3,1,1,1,4,2,H
1897-01-09,1896,Sheffield United,Blackburn Rovers,7-0,7,0,1,1,7,7,H
1897-01-09,1896,Sunderland,Aston Villa,4-2,4,2,1,1,6,2,H
1897-01-09,1896,Wolverhampton Wanderers,Liverpool,1-2,1,2,1,1,3,-1,A
1897-01-16,1896,Aston Villa,Sunderland,2-1,2,1,1,1,3,1,H
1897-01-16,1896,Blackburn Rovers,Derby County,5-2,5,2,1,1,7,3,H
1897-01-16,1896,Burnley,Sheffield United,1-1,1,1,1,1,2,0,D
1897-01-16,1896,Liverpool,Stoke City,1-0,1,0,1,1,1,1,H
1897-01-16,1896,Nottingham Forest,Bolton Wanderers,2-0,2,0,1,1,2,2,H
1897-01-16,1896,Preston North End,Wolverhampton Wanderers,4-0,4,0,1,1,4,4,H
1897-01-16,1896,West Bromwich Albion,Everton,1-4,1,4,1,1,5,-3,A
1897-01-23,1896,Derby County,Sunderland,1-0,1,0,1,1,1,1,H
1897-01-23,1896,Sheffield United,Wolverhampton Wanderers,1-3,1,3,1,1,4,-2,A
1897-01-23,1896,Stoke City,Sheffield Wednesday,0-0,0,0,1,1,0,0,D
1897-01-23,1896,West Bromwich Albion,Nottingham Forest,4-0,4,0,1,1,4,4,H
1897-02-06,1896,Blackburn Rovers,Sheffield United,1-3,1,3,1,1,4,-2,A
1897-02-06,1896,Burnley,Bolton Wanderers,0-2,0,2,1,1,2,-2,A
1897-02-06,1896,Bury,Aston Villa,0-2,0,2,1,1,2,-2,A
1897-02-06,1896,Everton,Preston North End,3-4,3,4,1,1,7,-1,A
1897-02-06,1896,Stoke City,Liverpool,6-1,6,1,1,1,7,5,H
1897-02-06,1896,West Bromwich Albion,Derby County,1-4,1,4,1,1,5,-3,A
1897-02-08,1896,Burnley,Aston Villa,3-4,3,4,1,1,7,-1,A
1897-02-20,1896,Blackburn Rovers,Bury,1-2,1,2,1,1,3,-1,A
1897-02-20,1896,Preston North End,Sheffield Wednesday,2-2,2,2,1,1,4,0,D
1897-02-20,1896,Sheffield United,Nottingham Forest,0-3,0,3,1,1,3,-3,A
1897-02-20,1896,Sunderland,Stoke City,4-1,4,1,1,1,5,3,H
1897-02-22,1896,Aston Villa,Preston North End,3-1,3,1,1,1,4,2,H
1897-02-27,1896,Sheffield Wednesday,Bolton Wanderers,0-0,0,0,1,1,0,0,D
1897-02-27,1896,Stoke City,Burnley,3-2,3,2,1,1,5,1,H
1897-02-27,1896,Sunderland,Sheffield United,0-1,0,1,1,1,1,-1,A
1897-02-27,1896,Wolverhampton Wanderers,Bury,1-1,1,1,1,1,2,0,D
1897-03-02,1896,Bury,Everton,3-1,3,1,1,1,4,2,H
1897-03-02,1896,Sheffield Wednesday,Sheffield United,1-1,1,1,1,1,2,0,D
1897-03-02,1896,Sunderland,Burnley,1-1,1,1,1,1,2,0,D
1897-03-04,1896,Liverpool,Wolverhampton Wanderers,3-0,3,0,1,1,3,3,H
1897-03-06,1896,Blackburn Rovers,Everton,4-2,4,2,1,1,6,2,H
1897-03-06,1896,Bolton Wanderers,Derby County,1-3,1,3,1,1,4,-2,A
1897-03-06,1896,Nottingham Forest,Aston Villa,2-4,2,4,1,1,6,-2,A
1897-03-06,1896,Sheffield Wednesday,Burnley,1-0,1,0,1,1,1,1,H
1897-03-06,1896,Sunderland,West Bromwich Albion,2-1,2,1,1,1,3,1,H
1897-03-06,1896,Wolverhampton Wanderers,Sheffield United,1-1,1,1,1,1,2,0,D
1897-03-10,1896,Nottingham Forest,Everton,3-0,3,0,1,1,3,3,H
1897-03-13,1896,Aston Villa,Liverpool,0-0,0,0,1,1,0,0,D
1897-03-13,1896,Bolton Wanderers,Burnley,2-1,2,1,1,1,3,1,H
1897-03-13,1896,Bury,West Bromwich Albion,3-0,3,0,1,1,3,3,H
1897-03-13,1896,Everton,Blackburn Rovers,0-3,0,3,1,1,3,-3,A
1897-03-13,1896,Sheffield United,Preston North End,0-2,0,2,1,1,2,-2,A
1897-03-13,1896,Sunderland,Nottingham Forest,2-2,2,2,1,1,4,0,D
1897-03-13,1896,Wolverhampton Wanderers,Sheffield Wednesday,2-0,2,0,1,1,2,2,H
1897-03-20,1896,Blackburn Rovers,Stoke City,2-1,2,1,1,1,3,1,H
1897-03-20,1896,Bolton Wanderers,Nottingham Forest,0-0,0,0,1,1,0,0,D
1897-03-20,1896,Burnley,Wolverhampton Wanderers,0-3,0,3,1,1,3,-3,A
1897-03-20,1896,Bury,Sheffield United,0-1,0,1,1,1,1,-1,A
1897-03-22,1896,Aston Villa,Bolton Wanderers,6-2,6,2,1,1,8,4,H
1897-03-27,1896,Bolton Wanderers,Aston Villa,1-2,1,2,1,1,3,-1,A
1897-03-27,1896,Bury,Blackburn Rovers,3-0,3,0,1,1,3,3,H
1897-03-27,1896,Derby County,Preston North End,2-2,2,2,1,1,4,0,D
1897-03-27,1896,Liverpool,Burnley,1-2,1,2,1,1,3,-1,A
1897-03-27,1896,Sheffield United,Stoke City,1-0,1,0,1,1,1,1,H
1897-04-03,1896,Liverpool,Sheffield Wednesday,2-2,2,2,1,1,4,0,D
1897-04-03,1896,Preston North End,Everton,4-1,4,1,1,1,5,3,H
1897-04-03,1896,Stoke City,Sunderland,0-1,0,1,1,1,1,-1,A
1897-04-03,1896,West Bromwich Albion,Burnley,3-0,3,0,1,1,3,3,H
1897-04-05,1896,Bolton Wanderers,Wolverhampton Wanderers,1-2,1,2,1,1,3,-1,A
1897-04-05,1896,Burnley,Derby County,2-3,2,3,1,1,5,-1,A
1897-04-05,1896,Sheffield Wednesday,Nottingham Forest,3-0,3,0,1,1,3,3,H
1897-04-08,1896,Nottingham Forest,Preston North End,0-0,0,0,1,1,0,0,D
1897-04-10,1896,Bolton Wanderers,Sheffield Wednesday,2-1,2,1,1,1,3,1,H
1897-04-10,1896,Burnley,West Bromwich Albion,5-0,5,0,1,1,5,5,H
1897-04-10,1896,Bury,Derby County,1-0,1,0,1,1,1,1,H
1897-04-10,1896,Liverpool,Preston North End,0-0,0,0,1,1,0,0,D
1897-04-10,1896,Nottingham Forest,Wolverhampton Wanderers,1-2,1,2,1,1,3,-1,A
1897-04-10,1896,Stoke City,Blackburn Rovers,1-0,1,0,1,1,1,1,H
1897-04-12,1896,Stoke City,Bury,3-0,3,0,1,1,3,3,H
1897-04-15,1896,Stoke City,Sheffield United,2-0,2,0,1,1,2,2,H
1897-04-16,1896,Bolton Wanderers,Sheffield United,0-2,0,2,1,1,2,-2,A
1897-04-16,1896,Bury,Sunderland,1-1,1,1,1,1,2,0,D
1897-04-16,1896,Everton,Derby County,5-2,5,2,1,1,7,3,H
1897-04-16,1896,Preston North End,West Bromwich Albion,0-0,0,0,1,1,0,0,D
1897-04-17,1896,Aston Villa,Blackburn Rovers,3-0,3,0,1,1,3,3,H
1897-04-17,1896,Everton,West Bromwich Albion,6-3,6,3,1,1,9,3,H
1897-04-17,1896,Sheffield Wednesday,Bury,2-0,2,0,1,1,2,2,H
1897-04-19,1896,Aston Villa,Wolverhampton Wanderers,5-0,5,0,1,1,5,5,H
1897-04-19,1896,Preston North End,Derby County,0-2,0,2,1,1,2,-2,A
1897-04-20,1896,Derby County,Everton,0-1,0,1,1,1,1,-1,A
1897-04-20,1896,Wolverhampton Wanderers,Bolton Wanderers,4-0,4,0,1,1,4,4,H
1897-04-24,1896,Everton,Bury,1-2,1,2,1,1,3,-1,A
1897-04-26,1896,Preston North End,Aston Villa,0-1,0,1,1,1,1,-1,A
1897-09-01,1897,Aston Villa,Sheffield Wednesday,5-2,5,2,1,1,7,3,H
1897-09-01,1897,Sheffield United,Derby County,2-1,2,1,1,1,3,1,H
1897-09-01,1897,Wolverhampton Wanderers,Preston North End,3-0,3,0,1,1,3,3,H
1897-09-02,1897,Stoke City,Notts County,2-0,2,0,1,1,2,2,H
1897-09-04,1897,Aston Villa,West Bromwich Albion,4-3,4,3,1,1,7,1,H
1897-09-04,1897,Derby County,Blackburn Rovers,3-1,3,1,1,1,4,2,H
1897-09-04,1897,Everton,Bolton Wanderers,2-1,2,1,1,1,3,1,H
1897-09-04,1897,Nottingham Forest,Notts County,1-1,1,1,1,1,2,0,D
1897-09-04,1897,Preston North End,Sheffield United,1-3,1,3,1,1,4,-2,A
1897-09-04,1897,Sheffield Wednesday,Sunderland,0-1,0,1,1,1,1,-1,A
1897-09-04,1897,Stoke City,Liverpool,2-2,2,2,1,1,4,0,D
1897-09-04,1897,Wolverhampton Wanderers,Bury,3-0,3,0,1,1,3,3,H
1897-09-11,1897,Blackburn Rovers,Bolton Wanderers,1-3,1,3,1,1,4,-2,A
1897-09-11,1897,Bury,Sheffield Wednesday,3-0,3,0,1,1,3,3,H
1897-09-11,1897,Derby County,Everton,5-1,5,1,1,1,6,4,H
1897-09-11,1897,Liverpool,Preston North End,0-0,0,0,1,1,0,0,D
1897-09-11,1897,Notts County,Aston Villa,2-3,2,3,1,1,5,-1,A
1897-09-11,1897,Sheffield United,Stoke City,4-3,4,3,1,1,7,1,H
1897-09-11,1897,Sunderland,Wolverhampton Wanderers,3-2,3,2,1,1,5,1,H
1897-09-11,1897,West Bromwich Albion,Nottingham Forest,2-0,2,0,1,1,2,2,H
1897-09-18,1897,Aston Villa,Bury,3-1,3,1,1,1,4,2,H
1897-09-18,1897,Bolton Wanderers,Notts County,1-0,1,0,1,1,1,1,H
1897-09-18,1897,Derby County,West Bromwich Albion,3-2,3,2,1,1,5,1,H
1897-09-18,1897,Everton,Wolverhampton Wanderers,3-0,3,0,1,1,3,3,H
1897-09-18,1897,Nottingham Forest,Sheffield United,1-1,1,1,1,1,2,0,D
1897-09-18,1897,Preston North End,Sunderland,2-0,2,0,1,1,2,2,H
1897-09-18,1897,Sheffield Wednesday,Liverpool,4-2,4,2,1,1,6,2,H
1897-09-18,1897,Stoke City,Blackburn Rovers,2-1,2,1,1,1,3,1,H
1897-09-25,1897,Blackburn Rovers,Aston Villa,4-3,4,3,1,1,7,1,H
1897-09-25,1897,Bolton Wanderers,Preston North End,1-0,1,0,1,1,1,1,H
1897-09-25,1897,Liverpool,Everton,3-1,3,1,1,1,4,2,H
1897-09-25,1897,Notts County,Derby County,1-1,1,1,1,1,2,0,D
1897-09-25,1897,Sheffield United,Bury,1-1,1,1,1,1,2,0,D
1897-09-25,1897,Sunderland,Sheffield Wednesday,1-0,1,0,1,1,1,1,H
1897-09-25,1897,West Bromwich Albion,Stoke City,2-0,2,0,1,1,2,2,H
1897-09-25,1897,Wolverhampton Wanderers,Nottingham Forest,0-0,0,0,1,1,0,0,D
1897-09-27,1897,Sheffield Wednesday,Aston Villa,3-0,3,0,1,1,3,3,H
1897-10-02,1897,Aston Villa,Bolton Wanderers,3-2,3,2,1,1,5,1,H
1897-10-02,1897,Bury,West Bromwich Albion,3-2,3,2,1,1,5,1,H
1897-10-02,1897,Everton,Blackburn Rovers,1-1,1,1,1,1,2,0,D
1897-10-02,1897,Nottingham Forest,Sunderland,1-1,1,1,1,1,2,0,D
1897-10-02,1897,Preston North End,Liverpool,1-1,1,1,1,1,2,0,D
1897-10-02,1897,Sheffield Wednesday,Notts County,3-1,3,1,1,1,4,2,H
1897-10-02,1897,Stoke City,Derby County,2-1,2,1,1,1,3,1,H
1897-10-02,1897,Wolverhampton Wanderers,Sheffield United,1-1,1,1,1,1,2,0,D
1897-10-04,1897,Sheffield United,Blackburn Rovers,5-2,5,2,1,1,7,3,H
1897-10-07,1897,Notts County,Preston North End,1-1,1,1,1,1,2,0,D
1897-10-09,1897,Blackburn Rovers,Preston North End,1-0,1,0,1,1,1,1,H
1897-10-09,1897,Bolton Wanderers,Sheffield Wednesday,0-3,0,3,1,1,3,-3,A
1897-10-09,1897,Bury,Sheffield United,2-5,2,5,1,1,7,-3,A
1897-10-09,1897,Liverpool,Stoke City,4-0,4,0,1,1,4,4,H
1897-10-09,1897,Notts County,Nottingham Forest,1-3,1,3,1,1,4,-2,A
1897-10-09,1897,Sunderland,Derby County,2-1,2,1,1,1,3,1,H
1897-10-09,1897,West Bromwich Albion,Aston Villa,1-1,1,1,1,1,2,0,D
1897-10-09,1897,Wolverhampton Wanderers,Everton,2-3,2,3,1,1,5,-1,A
1897-10-16,1897,Aston Villa,Notts County,4-2,4,2,1,1,6,2,H
1897-10-16,1897,Derby County,Bury,2-2,2,2,1,1,4,0,D
1897-10-16,1897,Everton,Liverpool,3-0,3,0,1,1,3,3,H
1897-10-16,1897,Nottingham Forest,Blackburn Rovers,3-1,3,1,1,1,4,2,H
1897-10-16,1897,Preston North End,Bolton Wanderers,0-0,0,0,1,1,0,0,D
1897-10-16,1897,Sheffield Wednesday,Sheffield United,0-1,0,1,1,1,1,-1,A
1897-10-16,1897,Stoke City,Wolverhampton Wanderers,0-2,0,2,1,1,2,-2,A
1897-10-16,1897,Sunderland,West Bromwich Albion,0-2,0,2,1,1,2,-2,A
1897-10-23,1897,Blackburn Rovers,Sheffield Wednesday,1-1,1,1,1,1,2,0,D
1897-10-23,1897,Bolton Wanderers,Nottingham Forest,2-0,2,0,1,1,2,2,H
1897-10-23,1897,Bury,Everton,0-1,0,1,1,1,1,-1,A
1897-10-23,1897,Liverpool,Derby County,4-2,4,2,1,1,6,2,H
1897-10-23,1897,Notts County,Stoke City,4-0,4,0,1,1,4,4,H
1897-10-23,1897,Sheffield United,Preston North End,2-1,2,1,1,1,3,1,H
1897-10-23,1897,Sunderland,Aston Villa,0-0,0,0,1,1,0,0,D
1897-10-23,1897,West Bromwich Albion,Wolverhampton Wanderers,2-2,2,2,1,1,4,0,D
1897-10-30,1897,Aston Villa,Liverpool,3-1,3,1,1,1,4,2,H
1897-10-30,1897,Bolton Wanderers,Sunderland,1-0,1,0,1,1,1,1,H
1897-10-30,1897,Everton,Sheffield United,1-4,1,4,1,1,5,-3,A
1897-10-30,1897,Nottingham Forest,Derby County,3-4,3,4,1,1,7,-1,A
1897-10-30,1897,Preston North End,Blackburn Rovers,1-4,1,4,1,1,5,-3,A
1897-10-30,1897,Stoke City,West Bromwich Albion,0-0,0,0,1,1,0,0,D
1897-10-30,1897,Wolverhampton Wanderers,Notts County,3-1,3,1,1,1,4,2,H
1897-11-01,1897,West Bromwich Albion,Bolton Wanderers,2-0,2,0,1,1,2,2,H
1897-11-06,1897,Bury,Wolverhampton Wanderers,2-1,2,1,1,1,3,1,H
1897-11-06,1897,Derby County,Stoke City,4-1,4,1,1,1,5,3,H
1897-11-06,1897,Liverpool,Nottingham Forest,1-2,1,2,1,1,3,-1,A
1897-11-06,1897,Notts County,Bolton Wanderers,1-2,1,2,1,1,3,-1,A
1897-11-06,1897,Preston North End,Aston Villa,3-1,3,1,1,1,4,2,H
1897-11-06,1897,West Bromwich Albion,Everton,2-2,2,2,1,1,4,0,D
1897-11-08,1897,Stoke City,Preston North End,1-2,1,2,1,1,3,-1,A
1897-11-13,1897,Aston Villa,Everton,3-0,3,0,1,1,3,3,H
1897-11-13,1897,Bolton Wanderers,Stoke City,2-1,2,1,1,1,3,1,H
1897-11-13,1897,Derby County,Sheffield United,1-1,1,1,1,1,2,0,D
1897-11-13,1897,Nottingham Forest,Preston North End,4-1,4,1,1,1,5,3,H
1897-11-13,1897,Sheffield Wednesday,Blackburn Rovers,4-1,4,1,1,1,5,3,H
1897-11-13,1897,West Bromwich Albion,Liverpool,2-1,2,1,1,1,3,1,H
1897-11-13,1897,Wolverhampton Wanderers,Sunderland,4-2,4,2,1,1,6,2,H
1897-11-20,1897,Blackburn Rovers,Sheffield United,1-1,1,1,1,1,2,0,D
1897-11-20,1897,Bolton Wanderers,Aston Villa,2-0,2,0,1,1,2,2,H
1897-11-20,1897,Liverpool,Wolverhampton Wanderers,1-0,1,0,1,1,1,1,H
1897-11-20,1897,Preston North End,Everton,1-1,1,1,1,1,2,0,D
1897-11-20,1897,Sheffield Wednesday,Bury,3-0,3,0,1,1,3,3,H
1897-11-20,1897,Stoke City,Nottingham Forest,1-2,1,2,1,1,3,-1,A
1897-11-20,1897,West Bromwich Albion,Derby County,3-1,3,1,1,1,4,2,H
1897-11-27,1897,Aston Villa,Sunderland,4-3,4,3,1,1,7,1,H
1897-11-27,1897,Blackburn Rovers,Derby County,1-1,1,1,1,1,2,0,D
1897-11-27,1897,Bury,Notts County,0-0,0,0,1,1,0,0,D
1897-11-27,1897,Everton,West Bromwich Albion,6-1,6,1,1,1,7,5,H
1897-11-27,1897,Nottingham Forest,Liverpool,2-3,2,3,1,1,5,-1,A
1897-11-27,1897,Preston North End,Wolverhampton Wanderers,1-2,1,2,1,1,3,-1,A
1897-11-27,1897,Sheffield Wednesday,Bolton Wanderers,3-0,3,0,1,1,3,3,H
1897-12-04,1897,Notts County,Sheffield Wednesday,0-0,0,0,1,1,0,0,D
1897-12-04,1897,Sheffield United,Nottingham Forest,1-1,1,1,1,1,2,0,D
1897-12-04,1897,Sunderland,Stoke City,4-0,4,0,1,1,4,4,H
1897-12-04,1897,Wolverhampton Wanderers,Derby County,2-0,2,0,1,1,2,2,H
1897-12-11,1897,Aston Villa,Blackburn Rovers,5-1,5,1,1,1,6,4,H
1897-12-11,1897,Bury,Bolton Wanderers,2-1,2,1,1,1,3,1,H
1897-12-11,1897,Derby County,Sunderland,2-2,2,2,1,1,4,0,D
1897-12-11,1897,Everton,Notts County,1-0,1,0,1,1,1,1,H
1897-12-11,1897,Nottingham Forest,West Bromwich Albion,0-1,0,1,1,1,1,-1,A
1897-12-11,1897,Sheffield Wednesday,Preston North End,2-1,2,1,1,1,3,1,H
1897-12-11,1897,Stoke City,Sheffield United,2-1,2,1,1,1,3,1,H
1897-12-11,1897,Wolverhampton Wanderers,Liverpool,2-1,2,1,1,1,3,1,H
1897-12-18,1897,Liverpool,Blackburn Rovers,0-1,0,1,1,1,1,-1,A
1897-12-18,1897,Notts County,Wolverhampton Wanderers,2-2,2,2,1,1,4,0,D
1897-12-18,1897,Preston North End,Sheffield Wednesday,2-0,2,0,1,1,2,2,H
1897-12-18,1897,Stoke City,Aston Villa,0-0,0,0,1,1,0,0,D
1897-12-18,1897,Sunderland,Everton,0-0,0,0,1,1,0,0,D
1897-12-18,1897,West Bromwich Albion,Bury,1-0,1,0,1,1,1,1,H
1897-12-25,1897,Blackburn Rovers,Sunderland,2-1,2,1,1,1,3,1,H
1897-12-25,1897,Bolton Wanderers,Liverpool,0-2,0,2,1,1,2,-2,A
1897-12-25,1897,Derby County,Notts County,1-2,1,2,1,1,3,-1,A
1897-12-25,1897,Everton,Aston Villa,2-1,2,1,1,1,3,1,H
1897-12-25,1897,Preston North End,Nottingham Forest,3-0,3,0,1,1,3,3,H
1897-12-25,1897,Sheffield Wednesday,Stoke City,4-0,4,0,1,1,4,4,H
1897-12-27,1897,Derby County,Bolton Wanderers,1-0,1,0,1,1,1,1,H
1897-12-27,1897,Liverpool,Sunderland,0-2,0,2,1,1,2,-2,A
1897-12-27,1897,Sheffield United,Sheffield Wednesday,1-1,1,1,1,1,2,0,D
1897-12-27,1897,Stoke City,Bury,3-1,3,1,1,1,4,2,H
1897-12-27,1897,West Bromwich Albion,Blackburn Rovers,1-1,1,1,1,1,2,0,D
1897-12-27,1897,Wolverhampton Wanderers,Aston Villa,1-1,1,1,1,1,2,0,D
1897-12-28,1897,Wolverhampton Wanderers,West Bromwich Albion,1-1,1,1,1,1,2,0,D
1897-12-29,1897,Sheffield United,Liverpool,1-2,1,2,1,1,3,-1,A
1898-01-01,1897,Blackburn Rovers,Everton,1-1,1,1,1,1,2,0,D
1898-01-01,1897,Bolton Wanderers,Derby County,3-3,3,3,1,1,6,0,D
1898-01-01,1897,Bury,Stoke City,3-3,3,3,1,1,6,0,D
1898-01-01,1897,Liverpool,West Bromwich Albion,1-1,1,1,1,1,2,0,D
1898-01-01,1897,Notts County,Sheffield United,1-3,1,3,1,1,4,-2,A
1898-01-01,1897,Sheffield Wednesday,Nottingham Forest,3-6,3,6,1,1,9,-3,A
1898-01-01,1897,Sunderland,Preston North End,1-0,1,0,1,1,1,1,H
1898-01-03,1897,Bolton Wanderers,Bury,0-0,0,0,1,1,0,0,D
1898-01-03,1897,Sunderland,Notts County,2-0,2,0,1,1,2,2,H
1898-01-08,1897,Blackburn Rovers,Liverpool,2-1,2,1,1,1,3,1,H
1898-01-08,1897,Derby County,Wolverhampton Wanderers,3-2,3,2,1,1,5,1,H
1898-01-08,1897,Everton,Sheffield Wednesday,1-0,1,0,1,1,1,1,H
1898-01-08,1897,Nottingham Forest,Bolton Wanderers,2-0,2,0,1,1,2,2,H
1898-01-08,1897,Preston North End,Bury,2-1,2,1,1,1,3,1,H
1898-01-08,1897,Sheffield United,Aston Villa,1-0,1,0,1,1,1,1,H
1898-01-08,1897,Stoke City,Sunderland,0-1,0,1,1,1,1,-1,A
1898-01-15,1897,Aston Villa,Sheffield United,1-2,1,2,1,1,3,-1,A
1898-01-15,1897,Blackburn Rovers,Nottingham Forest,1-1,1,1,1,1,2,0,D
1898-01-15,1897,Notts County,Everton,3-2,3,2,1,1,5,1,H
1898-01-15,1897,Sheffield Wednesday,Derby County,3-1,3,1,1,1,4,2,H
1898-01-15,1897,Stoke City,Bolton Wanderers,2-0,2,0,1,1,2,2,H
1898-01-15,1897,Sunderland,Bury,2-1,2,1,1,1,3,1,H
1898-01-15,1897,West Bromwich Albion,Preston North End,3-1,3,1,1,1,4,2,H
1898-01-17,1897,Everton,Stoke City,1-1,1,1,1,1,2,0,D
1898-01-22,1897,Derby County,Aston Villa,3-1,3,1,1,1,4,2,H
1898-01-22,1897,Nottingham Forest,Sheffield Wednesday,1-0,1,0,1,1,1,1,H
1898-01-22,1897,Sheffield United,Wolverhampton Wanderers,2-1,2,1,1,1,3,1,H
1898-01-22,1897,Sunderland,Liverpool,1-0,1,0,1,1,1,1,H
1898-02-05,1897,Aston Villa,Preston North End,4-0,4,0,1,1,4,4,H
1898-02-05,1897,Blackburn Rovers,West Bromwich Albion,1-3,1,3,1,1,4,-2,A
1898-02-05,1897,Liverpool,Sheffield United,0-4,0,4,1,1,4,-4,A
1898-02-05,1897,Notts County,Sunderland,0-1,0,1,1,1,1,-1,A
1898-02-05,1897,Sheffield Wednesday,Everton,2-1,2,1,1,1,3,1,H
1898-02-05,1897,Wolverhampton Wanderers,Stoke City,4-2,4,2,1,1,6,2,H
1898-02-07,1897,Sheffield United,Bolton Wanderers,4-0,4,0,1,1,4,4,H
1898-02-12,1897,Bury,Preston North End,1-0,1,0,1,1,1,1,H
1898-02-19,1897,Derby County,Sheffield Wednesday,1-2,1,2,1,1,3,-1,A
1898-02-19,1897,Nottingham Forest,Stoke City,3-1,3,1,1,1,4,2,H
1898-02-19,1897,Sheffield United,Notts County,0-1,0,1,1,1,1,-1,A
1898-02-19,1897,West Bromwich Albion,Sunderland,2-2,2,2,1,1,4,0,D
1898-02-22,1897,Sheffield United,Everton,0-0,0,0,1,1,0,0,D
1898-02-22,1897,Sunderland,Bolton Wanderers,2-0,2,0,1,1,2,2,H
1898-02-26,1897,Blackburn Rovers,Wolverhampton Wanderers,2-3,2,3,1,1,5,-1,A
1898-02-26,1897,Notts County,Bury,2-1,2,1,1,1,3,1,H
1898-03-05,1897,Aston Villa,Derby County,4-1,4,1,1,1,5,3,H
1898-03-05,1897,Everton,Bury,4-2,4,2,1,1,6,2,H
1898-03-05,1897,Notts County,Blackburn Rovers,0-0,0,0,1,1,0,0,D
1898-03-05,1897,Preston North End,Stoke City,0-0,0,0,1,1,0,0,D
1898-03-05,1897,Sheffield Wednesday,Wolverhampton Wanderers,2-0,2,0,1,1,2,2,H
1898-03-05,1897,Sunderland,Sheffield United,3-1,3,1,1,1,4,2,H
1898-03-12,1897,Bolton Wanderers,Wolverhampton Wanderers,2-1,2,1,1,1,3,1,H
1898-03-12,1897,Bury,Aston Villa,1-2,1,2,1,1,3,-1,A
1898-03-12,1897,Derby County,Preston North End,3-1,3,1,1,1,4,2,H
1898-03-12,1897,Liverpool,Notts County,2-0,2,0,1,1,2,2,H
1898-03-12,1897,Nottingham Forest,Everton,2-2,2,2,1,1,4,0,D
1898-03-12,1897,Sunderland,Blackburn Rovers,2-1,2,1,1,1,3,1,H
1898-03-12,1897,West Bromwich Albion,Sheffield Wednesday,0-2,0,2,1,1,2,-2,A
1898-03-19,1897,Blackburn Rovers,Bury,1-1,1,1,1,1,2,0,D
1898-03-19,1897,Liverpool,Bolton Wanderers,1-1,1,1,1,1,2,0,D
1898-03-19,1897,Notts County,West Bromwich Albion,2-2,2,2,1,1,4,0,D
1898-03-21,1897,Everton,Preston North End,1-1,1,1,1,1,2,0,D
1898-03-26,1897,Bolton Wanderers,Everton,1-0,1,0,1,1,1,1,H
1898-03-26,1897,Bury,Liverpool,0-2,0,2,1,1,2,-2,A
1898-03-26,1897,Nottingham Forest,Aston Villa,3-1,3,1,1,1,4,2,H
1898-03-26,1897,Stoke City,Sheffield Wednesday,2-1,2,1,1,1,3,1,H
1898-03-26,1897,West Bromwich Albion,Sheffield United,2-0,2,0,1,1,2,2,H
1898-03-29,1897,Bury,Derby County,4-0,4,0,1,1,4,4,H
1898-03-31,1897,Liverpool,Bury,2-2,2,2,1,1,4,0,D
1898-03-31,1897,Preston North End,West Bromwich Albion,1-1,1,1,1,1,2,0,D
1898-04-02,1897,Aston Villa,Stoke City,1-1,1,1,1,1,2,0,D
1898-04-02,1897,Bolton Wanderers,West Bromwich Albion,2-0,2,0,1,1,2,2,H
1898-04-02,1897,Everton,Nottingham Forest,2-0,2,0,1,1,2,2,H
1898-04-02,1897,Notts County,Liverpool,3-2,3,2,1,1,5,1,H
1898-04-02,1897,Sheffield United,Sunderland,1-0,1,0,1,1,1,1,H
1898-04-02,1897,Wolverhampton Wanderers,Blackburn Rovers,3-2,3,2,1,1,5,1,H
1898-04-04,1897,Bury,Nottingham Forest,2-2,2,2,1,1,4,0,D
1898-04-04,1897,West Bromwich Albion,Notts County,0-3,0,3,1,1,3,-3,A
1898-04-08,1897,Blackburn Rovers,Stoke City,1-1,1,1,1,1,2,0,D
1898-04-08,1897,Bolton Wanderers,Sheffield United,0-1,0,1,1,1,1,-1,A
1898-04-08,1897,Bury,Sunderland,1-0,1,0,1,1,1,1,H
1898-04-08,1897,Everton,Derby County,3-0,3,0,1,1,3,3,H
1898-04-08,1897,Nottingham Forest,Wolverhampton Wanderers,1-1,1,1,1,1,2,0,D
1898-04-08,1897,Preston North End,Notts County,3-1,3,1,1,1,4,2,H
1898-04-09,1897,Blackburn Rovers,Notts County,0-1,0,1,1,1,1,-1,A
1898-04-09,1897,Nottingham Forest,Bury,3-1,3,1,1,1,4,2,H
1898-04-09,1897,Preston North End,Derby County,5-0,5,0,1,1,5,5,H
1898-04-09,1897,Sheffield Wednesday,West Bromwich Albion,3-0,3,0,1,1,3,3,H
1898-04-09,1897,Stoke City,Everton,2-0,2,0,1,1,2,2,H
1898-04-09,1897,Wolverhampton Wanderers,Bolton Wanderers,2-0,2,0,1,1,2,2,H
1898-04-11,1897,Aston Villa,Wolverhampton Wanderers,1-2,1,2,1,1,3,-1,A
1898-04-11,1897,Derby County,Nottingham Forest,5-0,5,0,1,1,5,5,H
1898-04-11,1897,Everton,Sunderland,2-0,2,0,1,1,2,2,H
1898-04-11,1897,Liverpool,Sheffield Wednesday,4-0,4,0,1,1,4,4,H
1898-04-11,1897,Sheffield United,West Bromwich Albion,2-0,2,0,1,1,2,2,H
1898-04-12,1897,Derby County,Liverpool,3-1,3,1,1,1,4,2,H
1898-04-14,1897,Bolton Wanderers,Blackburn Rovers,1-2,1,2,1,1,3,-1,A
1898-04-16,1897,Bury,Blackburn Rovers,1-0,1,0,1,1,1,1,H
1898-04-16,1897,Liverpool,Aston Villa,4-0,4,0,1,1,4,4,H
1898-04-16,1897,Wolverhampton Wanderers,Sheffield Wednesday,5-0,5,0,1,1,5,5,H
1898-04-23,1897,Sunderland,Nottingham Forest,4-0,4,0,1,1,4,4,H
1898-04-30,1897,Aston Villa,Nottingham Forest,2-0,2,0,1,1,2,2,H
1898-09-01,1898,Everton,Blackburn Rovers,2-1,2,1,1,1,3,1,H
1898-09-01,1898,Stoke City,Derby County,0-0,0,0,1,1,0,0,D
1898-09-03,1898,Aston Villa,Stoke City,3-1,3,1,1,1,4,2,H
1898-09-03,1898,Bolton Wanderers,West Bromwich Albion,3-3,3,3,1,1,6,0,D
1898-09-03,1898,Burnley,Notts County,1-1,1,1,1,1,2,0,D
1898-09-03,1898,Derby County,Bury,1-2,1,2,1,1,3,-1,A
1898-09-03,1898,Liverpool,Sheffield Wednesday,4-0,4,0,1,1,4,4,H
1898-09-03,1898,Newcastle United,Wolverhampton Wanderers,2-4,2,4,1,1,6,-2,A
1898-09-03,1898,Nottingham Forest,Blackburn Rovers,0-1,0,1,1,1,1,-1,A
1898-09-03,1898,Preston North End,Sunderland,2-3,2,3,1,1,5,-1,A
1898-09-03,1898,Sheffield United,Everton,1-1,1,1,1,1,2,0,D
1898-09-05,1898,Burnley,Preston North End,3-1,3,1,1,1,4,2,H
1898-09-10,1898,Blackburn Rovers,Bolton Wanderers,4-1,4,1,1,1,5,3,H
1898-09-10,1898,Bury,Aston Villa,2-1,2,1,1,1,3,1,H
1898-09-10,1898,Everton,Newcastle United,3-0,3,0,1,1,3,3,H
1898-09-10,1898,Notts County,Sheffield United,2-2,2,2,1,1,4,0,D
1898-09-10,1898,Sheffield Wednesday,Nottingham Forest,2-1,2,1,1,1,3,1,H
1898-09-10,1898,Stoke City,Burnley,4-1,4,1,1,1,5,3,H
1898-09-10,1898,Sunderland,Liverpool,1-0,1,0,1,1,1,1,H
1898-09-10,1898,West Bromwich Albion,Derby County,1-1,1,1,1,1,2,0,D
1898-09-10,1898,Wolverhampton Wanderers,Preston North End,0-0,0,0,1,1,0,0,D
1898-09-12,1898,Sheffield United,Wolverhampton Wanderers,1-0,1,0,1,1,1,1,H
1898-09-17,1898,Bolton Wanderers,Sheffield Wednesday,0-0,0,0,1,1,0,0,D
1898-09-17,1898,Burnley,Aston Villa,2-4,2,4,1,1,6,-2,A
1898-09-17,1898,Derby County,Blackburn Rovers,0-0,0,0,1,1,0,0,D
1898-09-17,1898,Liverpool,Wolverhampton Wanderers,1-0,1,0,1,1,1,1,H
1898-09-17,1898,Newcastle United,Notts County,1-2,1,2,1,1,3,-1,A
1898-09-17,1898,Nottingham Forest,Sunderland,1-1,1,1,1,1,2,0,D
1898-09-17,1898,Preston North End,Everton,0-0,0,0,1,1,0,0,D
1898-09-17,1898,Sheffield United,Stoke City,1-1,1,1,1,1,2,0,D
1898-09-17,1898,West Bromwich Albion,Bury,2-0,2,0,1,1,2,2,H
1898-09-19,1898,Sheffield Wednesday,Preston North End,2-1,2,1,1,1,3,1,H
1898-09-24,1898,Aston Villa,Sheffield United,1-1,1,1,1,1,2,0,D
1898-09-24,1898,Blackburn Rovers,West Bromwich Albion,4-1,4,1,1,1,5,3,H
1898-09-24,1898,Bury,Burnley,1-1,1,1,1,1,2,0,D
1898-09-24,1898,Everton,Liverpool,1-2,1,2,1,1,3,-1,A
1898-09-24,1898,Notts County,Preston North End,1-0,1,0,1,1,1,1,H
1898-09-24,1898,Sheffield Wednesday,Derby County,3-1,3,1,1,1,4,2,H
1898-09-24,1898,Stoke City,Newcastle United,0-0,0,0,1,1,0,0,D
1898-09-24,1898,Sunderland,Bolton Wanderers,0-0,0,0,1,1,0,0,D
1898-09-24,1898,Wolverhampton Wanderers,Nottingham Forest,0-2,0,2,1,1,2,-2,A
1898-09-26,1898,Sheffield United,Newcastle United,2-2,2,2,1,1,4,0,D
1898-10-01,1898,Blackburn Rovers,Bury,0-0,0,0,1,1,0,0,D
1898-10-01,1898,Bolton Wanderers,Wolverhampton Wanderers,2-1,2,1,1,1,3,1,H
1898-10-01,1898,Derby County,Sunderland,4-2,4,2,1,1,6,2,H
1898-10-01,1898,Liverpool,Notts County,0-0,0,0,1,1,0,0,D
1898-10-01,1898,Newcastle United,Aston Villa,1-1,1,1,1,1,2,0,D
1898-10-01,1898,Nottingham Forest,Everton,0-0,0,0,1,1,0,0,D
1898-10-01,1898,Preston North End,Stoke City,4-2,4,2,1,1,6,2,H
1898-10-01,1898,Sheffield United,Burnley,1-1,1,1,1,1,2,0,D
1898-10-01,1898,West Bromwich Albion,Sheffield Wednesday,2-0,2,0,1,1,2,2,H
1898-10-03,1898,Sheffield Wednesday,Sheffield United,1-1,1,1,1,1,2,0,D
1898-10-06,1898,Nottingham Forest,Preston North End,2-2,2,2,1,1,4,0,D
1898-10-08,1898,Aston Villa,Preston North End,4-2,4,2,1,1,6,2,H
1898-10-08,1898,Burnley,Newcastle United,2-1,2,1,1,1,3,1,H
1898-10-08,1898,Bury,Sheffield United,1-3,1,3,1,1,4,-2,A
1898-10-08,1898,Everton,Bolton Wanderers,1-0,1,0,1,1,1,1,H
1898-10-08,1898,Notts County,Nottingham Forest,2-2,2,2,1,1,4,0,D
1898-10-08,1898,Sheffield Wednesday,Blackburn Rovers,1-2,1,2,1,1,3,-1,A
1898-10-08,1898,Stoke City,Liverpool,2-1,2,1,1,1,3,1,H
1898-10-08,1898,Sunderland,West Bromwich Albion,2-0,2,0,1,1,2,2,H
1898-10-08,1898,Wolverhampton Wanderers,Derby County,2-2,2,2,1,1,4,0,D
1898-10-15,1898,Blackburn Rovers,Sunderland,3-2,3,2,1,1,5,1,H
1898-10-15,1898,Bolton Wanderers,Notts County,0-1,0,1,1,1,1,-1,A
1898-10-15,1898,Derby County,Everton,5-5,5,5,1,1,10,0,D
1898-10-15,1898,Liverpool,Aston Villa,0-3,0,3,1,1,3,-3,A
1898-10-15,1898,Newcastle United,Sheffield United,1-2,1,2,1,1,3,-1,A
1898-10-15,1898,Nottingham Forest,Stoke City,2-1,2,1,1,1,3,1,H
1898-10-15,1898,Preston North End,Burnley,1-1,1,1,1,1,2,0,D
1898-10-15,1898,Sheffield Wednesday,Bury,3-2,3,2,1,1,5,1,H
1898-10-15,1898,West Bromwich Albion,Wolverhampton Wanderers,1-2,1,2,1,1,3,-1,A
1898-10-22,1898,Aston Villa,Nottingham Forest,3-0,3,0,1,1,3,3,H
1898-10-22,1898,Burnley,Liverpool,2-1,2,1,1,1,3,1,H
1898-10-22,1898,Bury,Newcastle United,1-1,1,1,1,1,2,0,D
1898-10-22,1898,Everton,West Bromwich Albion,1-0,1,0,1,1,1,1,H
1898-10-22,1898,Notts County,Derby County,2-2,2,2,1,1,4,0,D
1898-10-22,1898,Sheffield United,Preston North End,1-1,1,1,1,1,2,0,D
1898-10-22,1898,Stoke City,Bolton Wanderers,2-3,2,3,1,1,5,-1,A
1898-10-22,1898,Sunderland,Sheffield Wednesday,2-0,2,0,1,1,2,2,H
1898-10-22,1898,Wolverhampton Wanderers,Blackburn Rovers,2-1,2,1,1,1,3,1,H
1898-10-29,1898,Aston Villa,Bolton Wanderers,2-1,2,1,1,1,3,1,H
1898-10-29,1898,Blackburn Rovers,Everton,1-3,1,3,1,1,4,-2,A
1898-10-29,1898,Derby County,Stoke City,1-1,1,1,1,1,2,0,D
1898-10-29,1898,Liverpool,Sheffield United,2-1,2,1,1,1,3,1,H
1898-10-29,1898,Nottingham Forest,Burnley,0-1,0,1,1,1,1,-1,A
1898-10-29,1898,Preston North End,Newcastle United,1-0,1,0,1,1,1,1,H
1898-10-29,1898,Sheffield Wednesday,Wolverhampton Wanderers,3-0,3,0,1,1,3,3,H
1898-10-29,1898,Sunderland,Bury,3-0,3,0,1,1,3,3,H
1898-10-29,1898,West Bromwich Albion,Notts County,2-0,2,0,1,1,2,2,H
1898-11-05,1898,Aston Villa,Derby County,7-1,7,1,1,1,8,6,H
1898-11-05,1898,Burnley,Bolton Wanderers,2-0,2,0,1,1,2,2,H
1898-11-05,1898,Bury,Preston North End,3-1,3,1,1,1,4,2,H
1898-11-05,1898,Everton,Sheffield Wednesday,2-0,2,0,1,1,2,2,H
1898-11-05,1898,Newcastle United,Liverpool,3-0,3,0,1,1,3,3,H
1898-11-05,1898,Notts County,Blackburn Rovers,5-3,5,3,1,1,8,2,H
1898-11-05,1898,Sheffield United,Nottingham Forest,2-2,2,2,1,1,4,0,D
1898-11-05,1898,Stoke City,West Bromwich Albion,2-1,2,1,1,1,3,1,H
1898-11-05,1898,Wolverhampton Wanderers,Sunderland,2-0,2,0,1,1,2,2,H
1898-11-07,1898,West Bromwich Albion,Everton,3-0,3,0,1,1,3,3,H
1898-11-12,1898,Blackburn Rovers,Stoke City,4-1,4,1,1,1,5,3,H
1898-11-12,1898,Bolton Wanderers,Sheffield United,3-0,3,0,1,1,3,3,H
1898-11-12,1898,Derby County,Burnley,2-1,2,1,1,1,3,1,H
1898-11-12,1898,Liverpool,Preston North End,3-1,3,1,1,1,4,2,H
1898-11-12,1898,Nottingham Forest,Newcastle United,2-0,2,0,1,1,2,2,H
1898-11-12,1898,Sheffield Wednesday,Notts County,1-1,1,1,1,1,2,0,D
1898-11-12,1898,Sunderland,Everton,2-1,2,1,1,1,3,1,H
1898-11-12,1898,West Bromwich Albion,Aston Villa,0-1,0,1,1,1,1,-1,A
1898-11-12,1898,Wolverhampton Wanderers,Bury,1-2,1,2,1,1,3,-1,A
1898-11-14,1898,Stoke City,Preston North End,2-1,2,1,1,1,3,1,H
1898-11-19,1898,Aston Villa,Blackburn Rovers,3-1,3,1,1,1,4,2,H
1898-11-19,1898,Burnley,West Bromwich Albion,1-1,1,1,1,1,2,0,D
1898-11-19,1898,Bury,Liverpool,3-0,3,0,1,1,3,3,H
1898-11-19,1898,Everton,Wolverhampton Wanderers,2-1,2,1,1,1,3,1,H
1898-11-19,1898,Newcastle United,Bolton Wanderers,4-1,4,1,1,1,5,3,H
1898-11-19,1898,Notts County,Sunderland,5-2,5,2,1,1,7,3,H
1898-11-19,1898,Preston North End,Nottingham Forest,1-0,1,0,1,1,1,1,H
1898-11-19,1898,Sheffield United,Derby County,2-1,2,1,1,1,3,1,H
1898-11-19,1898,Stoke City,Sheffield Wednesday,1-0,1,0,1,1,1,1,H
1898-11-26,1898,Bolton Wanderers,Preston North End,2-2,2,2,1,1,4,0,D
1898-11-26,1898,Burnley,Blackburn Rovers,2-0,2,0,1,1,2,2,H
1898-11-26,1898,Derby County,Newcastle United,3-1,3,1,1,1,4,2,H
1898-11-26,1898,Everton,Bury,0-1,0,1,1,1,1,-1,A
1898-11-26,1898,Nottingham Forest,Liverpool,0-3,0,3,1,1,3,-3,A
1898-11-26,1898,Sunderland,Stoke City,2-0,2,0,1,1,2,2,H
1898-11-26,1898,West Bromwich Albion,Sheffield United,3-0,3,0,1,1,3,3,H
1898-11-26,1898,Wolverhampton Wanderers,Notts County,1-0,1,0,1,1,1,1,H
1898-12-03,1898,Aston Villa,Sunderland,2-0,2,0,1,1,2,2,H
1898-12-03,1898,Burnley,Sheffield Wednesday,5-0,5,0,1,1,5,5,H
1898-12-03,1898,Bury,Nottingham Forest,2-0,2,0,1,1,2,2,H
1898-12-03,1898,Liverpool,Bolton Wanderers,2-0,2,0,1,1,2,2,H
1898-12-03,1898,Newcastle United,West Bromwich Albion,3-0,3,0,1,1,3,3,H
1898-12-03,1898,Notts County,Everton,0-1,0,1,1,1,1,-1,A
1898-12-03,1898,Preston North End,Derby County,3-1,3,1,1,1,4,2,H
1898-12-03,1898,Sheffield United,Blackburn Rovers,1-1,1,1,1,1,2,0,D
1898-12-03,1898,Stoke City,Wolverhampton Wanderers,2-4,2,4,1,1,6,-2,A
1898-12-10,1898,Aston Villa,Wolverhampton Wanderers,1-1,1,1,1,1,2,0,D
1898-12-10,1898,Blackburn Rovers,Newcastle United,4-2,4,2,1,1,6,2,H
1898-12-10,1898,Bolton Wanderers,Nottingham Forest,0-2,0,2,1,1,2,-2,A
1898-12-10,1898,Derby County,Liverpool,1-0,1,0,1,1,1,1,H
1898-12-10,1898,Everton,Stoke City,2-0,2,0,1,1,2,2,H
1898-12-10,1898,Notts County,Bury,4-1,4,1,1,1,5,3,H
1898-12-10,1898,Sunderland,Burnley,0-1,0,1,1,1,1,-1,A
1898-12-10,1898,West Bromwich Albion,Preston North End,2-0,2,0,1,1,2,2,H
1898-12-17,1898,Aston Villa,Everton,3-0,3,0,1,1,3,3,H
1898-12-17,1898,Bolton Wanderers,Bury,0-1,0,1,1,1,1,-1,A
1898-12-17,1898,Burnley,Wolverhampton Wanderers,4-2,4,2,1,1,6,2,H
1898-12-17,1898,Liverpool,West Bromwich Albion,2-2,2,2,1,1,4,0,D
1898-12-17,1898,Newcastle United,Sheffield Wednesday,2-2,2,2,1,1,4,0,D
1898-12-17,1898,Nottingham Forest,Derby County,3-3,3,3,1,1,6,0,D
1898-12-17,1898,Preston North End,Blackburn Rovers,1-1,1,1,1,1,2,0,D
1898-12-17,1898,Sheffield United,Sunderland,2-0,2,0,1,1,2,2,H
1898-12-17,1898,Stoke City,Notts County,1-1,1,1,1,1,2,0,D
1898-12-24,1898,Blackburn Rovers,Liverpool,1-3,1,3,1,1,4,-2,A
1898-12-24,1898,Bury,Stoke City,5-2,5,2,1,1,7,3,H
1898-12-24,1898,Everton,Burnley,4-0,4,0,1,1,4,4,H
1898-12-24,1898,Notts County,Aston Villa,1-0,1,0,1,1,1,1,H
1898-12-24,1898,Sunderland,Newcastle United,2-3,2,3,1,1,5,-1,A
1898-12-24,1898,West Bromwich Albion,Nottingham Forest,2-0,2,0,1,1,2,2,H
1898-12-24,1898,Wolverhampton Wanderers,Sheffield United,4-1,4,1,1,1,5,3,H
1898-12-26,1898,Aston Villa,Newcastle United,1-0,1,0,1,1,1,1,H
1898-12-26,1898,Blackburn Rovers,Burnley,0-2,0,2,1,1,2,-2,A
1898-12-26,1898,Derby County,Bolton Wanderers,1-1,1,1,1,1,2,0,D
1898-12-26,1898,Preston North End,Bury,3-1,3,1,1,1,4,2,H
1898-12-26,1898,Sheffield United,Sheffield Wednesday,2-1,2,1,1,1,3,1,H
1898-12-26,1898,Stoke City,Nottingham Forest,2-1,2,1,1,1,3,1,H
1898-12-26,1898,West Bromwich Albion,Liverpool,0-1,0,1,1,1,1,-1,A
1898-12-27,1898,Notts County,Liverpool,1-1,1,1,1,1,2,0,D
1898-12-27,1898,Wolverhampton Wanderers,West Bromwich Albion,5-1,5,1,1,1,6,4,H
1898-12-31,1898,Blackburn Rovers,Nottingham Forest,3-3,3,3,1,1,6,0,D
1898-12-31,1898,Bury,Derby County,0-0,0,0,1,1,0,0,D
1898-12-31,1898,Everton,Sheffield United,1-0,1,0,1,1,1,1,H
1898-12-31,1898,Notts County,Burnley,2-2,2,2,1,1,4,0,D
1898-12-31,1898,Sheffield Wednesday,Liverpool,0-3,0,3,1,1,3,-3,A
1898-12-31,1898,Stoke City,Aston Villa,3-0,3,0,1,1,3,3,H
1898-12-31,1898,Sunderland,Preston North End,1-0,1,0,1,1,1,1,H
1898-12-31,1898,West Bromwich Albion,Bolton Wanderers,1-0,1,0,1,1,1,1,H
1898-12-31,1898,Wolverhampton Wanderers,Newcastle United,0-0,0,0,1,1,0,0,D
1899-01-02,1898,Blackburn Rovers,Notts County,6-0,6,0,1,1,6,6,H
1899-01-02,1898,Bury,Sheffield Wednesday,0-0,0,0,1,1,0,0,D
1899-01-02,1898,Everton,Nottingham Forest,1-3,1,3,1,1,4,-2,A
1899-01-02,1898,Sheffield United,Liverpool,0-2,0,2,1,1,2,-2,A
1899-01-02,1898,Sunderland,Derby County,1-0,1,0,1,1,1,1,H
1899-01-03,1898,Bolton Wanderers,Burnley,2-0,2,0,1,1,2,2,H
1899-01-07,1898,Aston Villa,Bury,3-2,3,2,1,1,5,1,H
1899-01-07,1898,Bolton Wanderers,Blackburn Rovers,0-2,0,2,1,1,2,-2,A
1899-01-07,1898,Derby County,West Bromwich Albion,4-1,4,1,1,1,5,3,H
1899-01-07,1898,Liverpool,Sunderland,0-0,0,0,1,1,0,0,D
1899-01-07,1898,Newcastle United,Everton,2-2,2,2,1,1,4,0,D
1899-01-07,1898,Nottingham Forest,Sheffield Wednesday,1-1,1,1,1,1,2,0,D
1899-01-07,1898,Preston North End,Wolverhampton Wanderers,2-1,2,1,1,1,3,1,H
1899-01-07,1898,Sheffield United,Notts County,2-2,2,2,1,1,4,0,D
1899-01-14,1898,Aston Villa,Burnley,4-0,4,0,1,1,4,4,H
1899-01-14,1898,Blackburn Rovers,Derby County,3-0,3,0,1,1,3,3,H
1899-01-14,1898,Bury,West Bromwich Albion,1-1,1,1,1,1,2,0,D
1899-01-14,1898,Everton,Preston North End,2-0,2,0,1,1,2,2,H
1899-01-14,1898,Notts County,Newcastle United,3-1,3,1,1,1,4,2,H
1899-01-14,1898,Sheffield Wednesday,Bolton Wanderers,1-0,1,0,1,1,1,1,H
1899-01-14,1898,Stoke City,Sheffield United,4-1,4,1,1,1,5,3,H
1899-01-14,1898,Sunderland,Nottingham Forest,1-1,1,1,1,1,2,0,D
1899-01-14,1898,Wolverhampton Wanderers,Liverpool,0-0,0,0,1,1,0,0,D
1899-01-21,1898,Bolton Wanderers,Sunderland,6-1,6,1,1,1,7,5,H
1899-01-21,1898,Burnley,Bury,2-1,2,1,1,1,3,1,H
1899-01-21,1898,Derby County,Sheffield Wednesday,9-0,9,0,1,1,9,9,H
1899-01-21,1898,Liverpool,Everton,2-0,2,0,1,1,2,2,H
1899-01-21,1898,Newcastle United,Stoke City,3-0,3,0,1,1,3,3,H
1899-01-21,1898,Nottingham Forest,Wolverhampton Wanderers,3-0,3,0,1,1,3,3,H
1899-01-21,1898,Sheffield United,Aston Villa,1-3,1,3,1,1,4,-2,A
1899-01-21,1898,West Bromwich Albion,Blackburn Rovers,6-2,6,2,1,1,8,4,H
1899-02-04,1898,Blackburn Rovers,Sheffield Wednesday,2-0,2,0,1,1,2,2,H
1899-02-04,1898,Derby County,Wolverhampton Wanderers,6-2,6,2,1,1,8,4,H
1899-02-04,1898,Liverpool,Stoke City,1-0,1,0,1,1,1,1,H
1899-02-04,1898,Newcastle United,Burnley,4-1,4,1,1,1,5,3,H
1899-02-04,1898,Nottingham Forest,Notts County,0-0,0,0,1,1,0,0,D
1899-02-04,1898,Preston North End,Aston Villa,2-0,2,0,1,1,2,2,H
1899-02-04,1898,Sheffield United,Bury,4-1,4,1,1,1,5,3,H
1899-02-04,1898,West Bromwich Albion,Sunderland,1-0,1,0,1,1,1,1,H
1899-02-14,1898,Bury,Blackburn Rovers,3-2,3,2,1,1,5,1,H
1899-02-14,1898,Sheffield Wednesday,West Bromwich Albion,1-2,1,2,1,1,3,-1,A
1899-02-18,1898,Blackburn Rovers,Wolverhampton Wanderers,2-2,2,2,1,1,4,0,D
1899-02-18,1898,Bolton Wanderers,Stoke City,0-2,0,2,1,1,2,-2,A
1899-02-18,1898,Derby County,Notts County,4-2,4,2,1,1,6,2,H
1899-02-18,1898,Liverpool,Burnley,2-0,2,0,1,1,2,2,H
1899-02-18,1898,Newcastle United,Bury,2-0,2,0,1,1,2,2,H
1899-02-18,1898,Nottingham Forest,Aston Villa,1-0,1,0,1,1,1,1,H
1899-02-18,1898,Preston North End,Sheffield United,1-0,1,0,1,1,1,1,H
1899-02-18,1898,Sheffield Wednesday,Sunderland,0-1,0,1,1,1,1,-1,A
1899-02-25,1898,Bolton Wanderers,Everton,2-4,2,4,1,1,6,-2,A
1899-02-25,1898,Newcastle United,Preston North End,2-1,2,1,1,1,3,1,H
1899-02-25,1898,Wolverhampton Wanderers,Sheffield Wednesday,0-0,0,0,1,1,0,0,D
1899-03-04,1898,Derby County,Aston Villa,1-1,1,1,1,1,2,0,D
1899-03-04,1898,Nottingham Forest,Sheffield United,2-1,2,1,1,1,3,1,H
1899-03-04,1898,Sheffield Wednesday,Everton,1-2,1,2,1,1,3,-1,A
1899-03-04,1898,Sunderland,Wolverhampton Wanderers,3-0,3,0,1,1,3,3,H
1899-03-04,1898,West Bromwich Albion,Stoke City,0-1,0,1,1,1,1,-1,A
1899-03-06,1898,Burnley,Nottingham Forest,1-1,1,1,1,1,2,0,D
1899-03-09,1898,Notts County,West Bromwich Albion,0-0,0,0,1,1,0,0,D
1899-03-11,1898,Burnley,Derby County,2-1,2,1,1,1,3,1,H
1899-03-11,1898,Everton,Sunderland,0-0,0,0,1,1,0,0,D
1899-03-11,1898,Newcastle United,Nottingham Forest,0-1,0,1,1,1,1,-1,A
1899-03-11,1898,Notts County,Sheffield Wednesday,1-0,1,0,1,1,1,1,H
1899-03-11,1898,Preston North End,Liverpool,1-2,1,2,1,1,3,-1,A
1899-03-11,1898,Sheffield United,Bolton Wanderers,3-1,3,1,1,1,4,2,H
1899-03-11,1898,Stoke City,Blackburn Rovers,0-1,0,1,1,1,1,-1,A
1899-03-13,1898,Sheffield Wednesday,Aston Villa,4-1,4,1,1,1,5,3,H
1899-03-14,1898,Bury,Wolverhampton Wanderers,0-2,0,2,1,1,2,-2,A
1899-03-18,1898,Blackburn Rovers,Aston Villa,0-0,0,0,1,1,0,0,D
1899-03-18,1898,Bolton Wanderers,Newcastle United,0-0,0,0,1,1,0,0,D
1899-03-18,1898,Bury,Everton,3-1,3,1,1,1,4,2,H
1899-03-18,1898,Sunderland,Notts County,1-1,1,1,1,1,2,0,D
1899-03-18,1898,West Bromwich Albion,Burnley,0-1,0,1,1,1,1,-1,A
1899-03-20,1898,Preston North End,Notts County,2-0,2,0,1,1,2,2,H
1899-03-25,1898,Aston Villa,Sheffield Wednesday,3-1,3,1,1,1,4,2,H
1899-03-25,1898,Liverpool,Nottingham Forest,0-1,0,1,1,1,1,-1,A
1899-03-25,1898,Newcastle United,Derby County,2-0,2,0,1,1,2,2,H
1899-03-25,1898,Notts County,Wolverhampton Wanderers,0-2,0,2,1,1,2,-2,A
1899-03-25,1898,Sheffield United,West Bromwich Albion,5-0,5,0,1,1,5,5,H
1899-03-25,1898,Stoke City,Sunderland,1-0,1,0,1,1,1,1,H
1899-03-27,1898,Sheffield Wednesday,Stoke City,1-3,1,3,1,1,4,-2,A
1899-03-31,1898,Bolton Wanderers,Derby County,2-1,2,1,1,1,3,1,H
1899-03-31,1898,Burnley,Sheffield United,1-0,1,0,1,1,1,1,H
1899-03-31,1898,Bury,Sunderland,1-2,1,2,1,1,3,-1,A
1899-04-01,1898,Blackburn Rovers,Sheffield United,2-1,2,1,1,1,3,1,H
1899-04-01,1898,Bolton Wanderers,Liverpool,2-1,2,1,1,1,3,1,H
1899-04-01,1898,Derby County,Preston North End,1-0,1,0,1,1,1,1,H
1899-04-01,1898,Everton,Notts County,1-2,1,2,1,1,3,-1,A
1899-04-01,1898,Nottingham Forest,Bury,1-2,1,2,1,1,3,-1,A
1899-04-01,1898,Sheffield Wednesday,Burnley,1-0,1,0,1,1,1,1,H
1899-04-01,1898,Sunderland,Aston Villa,4-2,4,2,1,1,6,2,H
1899-04-01,1898,West Bromwich Albion,Newcastle United,2-0,2,0,1,1,2,2,H
1899-04-01,1898,Wolverhampton Wanderers,Stoke City,3-2,3,2,1,1,5,1,H
1899-04-03,1898,Everton,Derby County,1-2,1,2,1,1,3,-1,A
1899-04-03,1898,Liverpool,Newcastle United,3-2,3,2,1,1,5,1,H
1899-04-03,1898,Notts County,Bolton Wanderers,2-1,2,1,1,1,3,1,H
1899-04-03,1898,Sunderland,Blackburn Rovers,0-1,0,1,1,1,1,-1,A
1899-04-03,1898,Wolverhampton Wanderers,Aston Villa,4-0,4,0,1,1,4,4,H
1899-04-04,1898,Wolverhampton Wanderers,Bolton Wanderers,1-0,1,0,1,1,1,1,H
1899-04-08,1898,Burnley,Sunderland,1-0,1,0,1,1,1,1,H
1899-04-08,1898,Bury,Notts County,2-0,2,0,1,1,2,2,H
1899-04-08,1898,Liverpool,Derby County,4-0,4,0,1,1,4,4,H
1899-04-08,1898,Newcastle United,Blackburn Rovers,1-0,1,0,1,1,1,1,H
1899-04-08,1898,Nottingham Forest,Bolton Wanderers,1-2,1,2,1,1,3,-1,A
1899-04-08,1898,Preston North End,West Bromwich Albion,4-0,4,0,1,1,4,4,H
1899-04-08,1898,Stoke City,Everton,2-1,2,1,1,1,3,1,H
1899-04-15,1898,Blackburn Rovers,Preston North End,2-2,2,2,1,1,4,0,D
1899-04-15,1898,Bury,Bolton Wanderers,3-1,3,1,1,1,4,2,H
1899-04-15,1898,Everton,Aston Villa,1-1,1,1,1,1,2,0,D
1899-04-15,1898,Notts County,Stoke City,2-0,2,0,1,1,2,2,H
1899-04-15,1898,Sheffield Wednesday,Newcastle United,1-3,1,3,1,1,4,-2,A
1899-04-15,1898,Wolverhampton Wanderers,Burnley,4-0,4,0,1,1,4,4,H
1899-04-17,1898,Bolton Wanderers,Aston Villa,0-0,0,0,1,1,0,0,D
1899-04-17,1898,Burnley,Stoke City,1-1,1,1,1,1,2,0,D
1899-04-20,1898,Derby County,Nottingham Forest,2-0,2,0,1,1,2,2,H
1899-04-20,1898,Liverpool,Bury,1-0,1,0,1,1,1,1,H
1899-04-22,1898,Aston Villa,Notts County,6-1,6,1,1,1,7,5,H
1899-04-22,1898,Burnley,Everton,0-0,0,0,1,1,0,0,D
1899-04-22,1898,Derby County,Sheffield United,1-0,1,0,1,1,1,1,H
1899-04-22,1898,Liverpool,Blackburn Rovers,2-0,2,0,1,1,2,2,H
1899-04-22,1898,Newcastle United,Sunderland,0-1,0,1,1,1,1,-1,A
1899-04-22,1898,Nottingham Forest,West Bromwich Albion,3-0,3,0,1,1,3,3,H
1899-04-22,1898,Preston North End,Sheffield Wednesday,1-1,1,1,1,1,2,0,D
1899-04-22,1898,Stoke City,Bury,1-1,1,1,1,1,2,0,D
1899-04-24,1898,Aston Villa,West Bromwich Albion,7-1,7,1,1,1,8,6,H
1899-04-29,1898,Aston Villa,Liverpool,5-0,5,0,1,1,5,5,H
1899-04-29,1898,Preston North End,Bolton Wanderers,0-1,0,1,1,1,1,-1,A
1899-04-29,1898,Sunderland,Sheffield United,1-0,1,0,1,1,1,1,H
1899-04-29,1898,Wolverhampton Wanderers,Everton,1-2,1,2,1,1,3,-1,A
1899-09-02,1899,Blackburn Rovers,Manchester City,4-3,4,3,1,1,7,1,H
1899-09-02,1899,Bury,Wolverhampton Wanderers,3-0,3,0,1,1,3,3,H
1899-09-02,1899,Derby County,Notts County,0-1,0,1,1,1,1,-1,A
1899-09-02,1899,Everton,Sheffield United,1-2,1,2,1,1,3,-1,A
1899-09-02,1899,Glossop North End,Burnley,2-0,2,0,1,1,2,2,H
1899-09-02,1899,Nottingham Forest,Preston North End,3-1,3,1,1,1,4,2,H
1899-09-02,1899,Stoke City,Liverpool,3-2,3,2,1,1,5,1,H
1899-09-02,1899,Sunderland,Aston Villa,0-1,0,1,1,1,1,-1,A
1899-09-02,1899,West Bromwich Albion,Newcastle United,1-1,1,1,1,1,2,0,D
1899-09-04,1899,Aston Villa,Glossop North End,9-0,9,0,1,1,9,9,H
1899-09-09,1899,Aston Villa,West Bromwich Albion,0-2,0,2,1,1,2,-2,A
1899-09-09,1899,Burnley,Stoke City,2-2,2,2,1,1,4,0,D
1899-09-09,1899,Liverpool,Sunderland,0-2,0,2,1,1,2,-2,A
1899-09-09,1899,Manchester City,Derby County,4-0,4,0,1,1,4,4,H
1899-09-09,1899,Newcastle United,Everton,2-0,2,0,1,1,2,2,H
1899-09-09,1899,Notts County,Bury,2-2,2,2,1,1,4,0,D
1899-09-09,1899,Preston North End,Glossop North End,1-0,1,0,1,1,1,1,H
1899-09-09,1899,Sheffield United,Blackburn Rovers,3-0,3,0,1,1,3,3,H
1899-09-09,1899,Wolverhampton Wanderers,Nottingham Forest,2-2,2,2,1,1,4,0,D
1899-09-16,1899,Blackburn Rovers,Newcastle United,2-3,2,3,1,1,5,-1,A
1899-09-16,1899,Bury,Manchester City,1-4,1,4,1,1,5,-3,A
1899-09-16,1899,Derby County,Sheffield United,0-1,0,1,1,1,1,-1,A
1899-09-16,1899,Everton,Aston Villa,1-2,1,2,1,1,3,-1,A
1899-09-16,1899,Glossop North End,Nottingham Forest,3-0,3,0,1,1,3,3,H
1899-09-16,1899,Notts County,Wolverhampton Wanderers,0-0,0,0,1,1,0,0,D
1899-09-16,1899,Stoke City,Preston North End,3-1,3,1,1,1,4,2,H
1899-09-16,1899,Sunderland,Burnley,2-1,2,1,1,1,3,1,H
1899-09-16,1899,West Bromwich Albion,Liverpool,2-0,2,0,1,1,2,2,H
1899-09-18,1899,Stoke City,Wolverhampton Wanderers,1-3,1,3,1,1,4,-2,A
1899-09-23,1899,Aston Villa,Blackburn Rovers,3-1,3,1,1,1,4,2,H
1899-09-23,1899,Burnley,West Bromwich Albion,2-0,2,0,1,1,2,2,H
1899-09-23,1899,Liverpool,Everton,1-2,1,2,1,1,3,-1,A
1899-09-23,1899,Manchester City,Notts County,5-1,5,1,1,1,6,4,H
1899-09-23,1899,Newcastle United,Derby County,2-0,2,0,1,1,2,2,H
1899-09-23,1899,Nottingham Forest,Stoke City,1-0,1,0,1,1,1,1,H
1899-09-23,1899,Preston North End,Sunderland,0-1,0,1,1,1,1,-1,A
1899-09-23,1899,Sheffield United,Bury,4-0,4,0,1,1,4,4,H
1899-09-23,1899,Wolverhampton Wanderers,Glossop North End,4-0,4,0,1,1,4,4,H
1899-09-30,1899,Blackburn Rovers,Liverpool,2-0,2,0,1,1,2,2,H
1899-09-30,1899,Bury,Newcastle United,2-1,2,1,1,1,3,1,H
1899-09-30,1899,Derby County,Aston Villa,2-0,2,0,1,1,2,2,H
1899-09-30,1899,Everton,Burnley,2-0,2,0,1,1,2,2,H
1899-09-30,1899,Manchester City,Wolverhampton Wanderers,1-1,1,1,1,1,2,0,D
1899-09-30,1899,Notts County,Sheffield United,1-2,1,2,1,1,3,-1,A
1899-09-30,1899,Stoke City,Glossop North End,1-0,1,0,1,1,1,1,H
1899-09-30,1899,Sunderland,Nottingham Forest,1-0,1,0,1,1,1,1,H
1899-09-30,1899,West Bromwich Albion,Preston North End,1-0,1,0,1,1,1,1,H
1899-10-02,1899,Sheffield United,Sunderland,2-2,2,2,1,1,4,0,D
1899-10-05,1899,Notts County,Liverpool,2-1,2,1,1,1,3,1,H
1899-10-07,1899,Aston Villa,Bury,2-1,2,1,1,1,3,1,H
1899-10-07,1899,Burnley,Blackburn Rovers,1-0,1,0,1,1,1,1,H
1899-10-07,1899,Glossop North End,Sunderland,0-2,0,2,1,1,2,-2,A
1899-10-07,1899,Liverpool,Derby County,0-2,0,2,1,1,2,-2,A
1899-10-07,1899,Newcastle United,Notts County,6-0,6,0,1,1,6,6,H
1899-10-07,1899,Nottingham Forest,West Bromwich Albion,6-1,6,1,1,1,7,5,H
1899-10-07,1899,Preston North End,Everton,1-1,1,1,1,1,2,0,D
1899-10-07,1899,Sheffield United,Manchester City,3-0,3,0,1,1,3,3,H
1899-10-07,1899,Wolverhampton Wanderers,Stoke City,0-2,0,2,1,1,2,-2,A
1899-10-14,1899,Blackburn Rovers,Preston North End,3-0,3,0,1,1,3,3,H
1899-10-14,1899,Bury,Liverpool,2-1,2,1,1,1,3,1,H
1899-10-14,1899,Derby County,Burnley,4-1,4,1,1,1,5,3,H
1899-10-14,1899,Everton,Nottingham Forest,2-1,2,1,1,1,3,1,H
1899-10-14,1899,Manchester City,Newcastle United,1-0,1,0,1,1,1,1,H
1899-10-14,1899,Notts County,Aston Villa,1-4,1,4,1,1,5,-3,A
1899-10-14,1899,Sheffield United,Wolverhampton Wanderers,5-2,5,2,1,1,7,3,H
1899-10-14,1899,Sunderland,Stoke City,3-0,3,0,1,1,3,3,H
1899-10-14,1899,West Bromwich Albion,Glossop North End,3-3,3,3,1,1,6,0,D
1899-10-21,1899,Aston Villa,Manchester City,2-1,2,1,1,1,3,1,H
1899-10-21,1899,Burnley,Bury,1-0,1,0,1,1,1,1,H
1899-10-21,1899,Glossop North End,Everton,1-1,1,1,1,1,2,0,D
1899-10-21,1899,Liverpool,Notts County,3-1,3,1,1,1,4,2,H
1899-10-21,1899,Newcastle United,Sheffield United,0-0,0,0,1,1,0,0,D
1899-10-21,1899,Nottingham Forest,Blackburn Rovers,3-2,3,2,1,1,5,1,H
1899-10-21,1899,Preston North End,Derby County,0-0,0,0,1,1,0,0,D
1899-10-21,1899,Stoke City,West Bromwich Albion,1-0,1,0,1,1,1,1,H
1899-10-28,1899,Bury,Preston North End,2-0,2,0,1,1,2,2,H
1899-10-28,1899,Derby County,Nottingham Forest,2-2,2,2,1,1,4,0,D
1899-10-28,1899,Manchester City,Liverpool,0-1,0,1,1,1,1,-1,A
1899-10-28,1899,Newcastle United,Wolverhampton Wanderers,0-1,0,1,1,1,1,-1,A
1899-10-28,1899,Notts County,Burnley,6-1,6,1,1,1,7,5,H
1899-10-28,1899,Sheffield United,Aston Villa,2-1,2,1,1,1,3,1,H
1899-10-28,1899,Stoke City,Everton,1-1,1,1,1,1,2,0,D
1899-10-28,1899,West Bromwich Albion,Sunderland,1-0,1,0,1,1,1,1,H
1899-11-04,1899,Aston Villa,Newcastle United,2-1,2,1,1,1,3,1,H
1899-11-04,1899,Burnley,Manchester City,2-0,2,0,1,1,2,2,H
1899-11-04,1899,Liverpool,Sheffield United,2-2,2,2,1,1,4,0,D
1899-11-04,1899,Nottingham Forest,Bury,2-2,2,2,1,1,4,0,D
1899-11-04,1899,Preston North End,Notts County,4-3,4,3,1,1,7,1,H
1899-11-04,1899,Stoke City,Blackburn Rovers,2-0,2,0,1,1,2,2,H
1899-11-04,1899,Sunderland,Everton,1-0,1,0,1,1,1,1,H
1899-11-04,1899,Wolverhampton Wanderers,West Bromwich Albion,2-0,2,0,1,1,2,2,H
1899-11-06,1899,West Bromwich Albion,Sheffield United,1-2,1,2,1,1,3,-1,A
1899-11-11,1899,Aston Villa,Wolverhampton Wanderers,0-0,0,0,1,1,0,0,D
1899-11-11,1899,Blackburn Rovers,Sunderland,1-2,1,2,1,1,3,-1,A
1899-11-11,1899,Bury,Glossop North End,2-1,2,1,1,1,3,1,H
1899-11-11,1899,Derby County,Stoke City,2-0,2,0,1,1,2,2,H
1899-11-11,1899,Everton,West Bromwich Albion,1-3,1,3,1,1,4,-2,A
1899-11-11,1899,Manchester City,Preston North End,3-1,3,1,1,1,4,2,H
1899-11-11,1899,Newcastle United,Liverpool,1-1,1,1,1,1,2,0,D
1899-11-11,1899,Notts County,Nottingham Forest,1-2,1,2,1,1,3,-1,A
1899-11-11,1899,Sheffield United,Burnley,0-0,0,0,1,1,0,0,D
1899-11-13,1899,Stoke City,Aston Villa,0-2,0,2,1,1,2,-2,A
1899-11-18,1899,Burnley,Newcastle United,1-3,1,3,1,1,4,-2,A
1899-11-18,1899,Glossop North End,Notts County,0-0,0,0,1,1,0,0,D
1899-11-18,1899,Liverpool,Aston Villa,3-3,3,3,1,1,6,0,D
1899-11-18,1899,Preston North End,Sheffield United,0-1,0,1,1,1,1,-1,A
1899-11-25,1899,Aston Villa,Burnley,2-0,2,0,1,1,2,2,H
1899-11-25,1899,Blackburn Rovers,Everton,3-1,3,1,1,1,4,2,H
1899-11-25,1899,Bury,Sunderland,2-0,2,0,1,1,2,2,H
1899-11-25,1899,Derby County,West Bromwich Albion,4-1,4,1,1,1,5,3,H
1899-11-25,1899,Liverpool,Wolverhampton Wanderers,1-1,1,1,1,1,2,0,D
1899-11-25,1899,Manchester City,Glossop North End,4-1,4,1,1,1,5,3,H
1899-11-25,1899,Newcastle United,Preston North End,0-0,0,0,1,1,0,0,D
1899-11-25,1899,Notts County,Stoke City,1-3,1,3,1,1,4,-2,A
1899-11-25,1899,Sheffield United,Nottingham Forest,3-0,3,0,1,1,3,3,H
1899-12-02,1899,Burnley,Liverpool,2-1,2,1,1,1,3,1,H
1899-12-02,1899,Everton,Derby County,3-0,3,0,1,1,3,3,H
1899-12-02,1899,Glossop North End,Sheffield United,2-2,2,2,1,1,4,0,D
1899-12-02,1899,Nottingham Forest,Newcastle United,1-0,1,0,1,1,1,1,H
1899-12-02,1899,Preston North End,Aston Villa,0-5,0,5,1,1,5,-5,A
1899-12-02,1899,Stoke City,Manchester City,1-0,1,0,1,1,1,1,H
1899-12-02,1899,Sunderland,Notts County,5-0,5,0,1,1,5,5,H
1899-12-02,1899,West Bromwich Albion,Bury,0-1,0,1,1,1,1,-1,A
1899-12-02,1899,Wolverhampton Wanderers,Blackburn Rovers,4-0,4,0,1,1,4,4,H
1899-12-09,1899,Aston Villa,Nottingham Forest,2-2,2,2,1,1,4,0,D
1899-12-09,1899,Burnley,Wolverhampton Wanderers,0-1,0,1,1,1,1,-1,A
1899-12-09,1899,Bury,Everton,4-1,4,1,1,1,5,3,H
1899-12-09,1899,Derby County,Blackburn Rovers,0-2,0,2,1,1,2,-2,A
1899-12-09,1899,Liverpool,Preston North End,1-0,1,0,1,1,1,1,H
1899-12-09,1899,Manchester City,Sunderland,2-1,2,1,1,1,3,1,H
1899-12-09,1899,Notts County,West Bromwich Albion,1-2,1,2,1,1,3,-1,A
1899-12-09,1899,Sheffield United,Stoke City,1-0,1,0,1,1,1,1,H
1899-12-16,1899,Blackburn Rovers,Bury,3-2,3,2,1,1,5,1,H
1899-12-16,1899,Derby County,Wolverhampton Wanderers,0-2,0,2,1,1,2,-2,A
1899-12-16,1899,Everton,Notts County,0-2,0,2,1,1,2,-2,A
1899-12-16,1899,Glossop North End,Aston Villa,1-0,1,0,1,1,1,1,H
1899-12-16,1899,Nottingham Forest,Liverpool,1-0,1,0,1,1,1,1,H
1899-12-16,1899,Preston North End,Burnley,1-1,1,1,1,1,2,0,D
1899-12-16,1899,Stoke City,Newcastle United,2-2,2,2,1,1,4,0,D
1899-12-16,1899,Sunderland,Sheffield United,1-1,1,1,1,1,2,0,D
1899-12-16,1899,West Bromwich Albion,Manchester City,0-0,0,0,1,1,0,0,D
1899-12-23,1899,Aston Villa,Stoke City,4-1,4,1,1,1,5,3,H
1899-12-23,1899,Burnley,Nottingham Forest,2-2,2,2,1,1,4,0,D
1899-12-23,1899,Bury,Derby County,1-1,1,1,1,1,2,0,D
1899-12-23,1899,Liverpool,Glossop North End,5-2,5,2,1,1,7,3,H
1899-12-23,1899,Manchester City,Everton,1-2,1,2,1,1,3,-1,A
1899-12-23,1899,Newcastle United,Sunderland,2-4,2,4,1,1,6,-2,A
1899-12-23,1899,Notts County,Blackburn Rovers,5-1,5,1,1,1,6,4,H
1899-12-23,1899,Sheffield United,West Bromwich Albion,1-1,1,1,1,1,2,0,D
1899-12-23,1899,Wolverhampton Wanderers,Preston North End,1-3,1,3,1,1,4,-2,A
1899-12-25,1899,Bury,Nottingham Forest,2-1,2,1,1,1,3,1,H
1899-12-25,1899,Derby County,Liverpool,3-2,3,2,1,1,5,1,H
1899-12-25,1899,Everton,Stoke City,2-0,2,0,1,1,2,2,H
1899-12-25,1899,Manchester City,Sheffield United,1-2,1,2,1,1,3,-1,A
1899-12-26,1899,Derby County,Glossop North End,4-1,4,1,1,1,5,3,H
1899-12-26,1899,Stoke City,Burnley,3-0,3,0,1,1,3,3,H
1899-12-26,1899,West Bromwich Albion,Everton,0-0,0,0,1,1,0,0,D
1899-12-26,1899,Wolverhampton Wanderers,Sunderland,1-0,1,0,1,1,1,1,H
1899-12-27,1899,Nottingham Forest,Manchester City,2-0,2,0,1,1,2,2,H
1899-12-29,1899,Aston Villa,Sunderland,4-2,4,2,1,1,6,2,H
1899-12-29,1899,Burnley,Glossop North End,3-1,3,1,1,1,4,2,H
1899-12-29,1899,Liverpool,Stoke City,0-0,0,0,1,1,0,0,D
1899-12-29,1899,Manchester City,Blackburn Rovers,1-1,1,1,1,1,2,0,D
1899-12-29,1899,Newcastle United,West Bromwich Albion,4-2,4,2,1,1,6,2,H
1899-12-29,1899,Notts County,Derby County,0-0,0,0,1,1,0,0,D
1899-12-29,1899,Preston North End,Nottingham Forest,3-0,3,0,1,1,3,3,H
1899-12-29,1899,Sheffield United,Everton,5-0,5,0,1,1,5,5,H
1899-12-29,1899,Wolverhampton Wanderers,Bury,1-0,1,0,1,1,1,1,H
1900-01-01,1899,Blackburn Rovers,Burnley,2-0,2,0,1,1,2,2,H
1900-01-01,1899,Bury,Aston Villa,2-0,2,0,1,1,2,2,H
1900-01-01,1899,Everton,Preston North End,1-0,1,0,1,1,1,1,H
1900-01-01,1899,Sunderland,Wolverhampton Wanderers,1-2,1,2,1,1,3,-1,A
1900-01-06,1899,Bury,Notts County,0-1,0,1,1,1,1,-1,A
1900-01-06,1899,Derby County,Manchester City,0-0,0,0,1,1,0,0,D
1900-01-06,1899,Everton,Newcastle United,3-2,3,2,1,1,5,1,H
1900-01-06,1899,Glossop North End,Preston North End,0-2,0,2,1,1,2,-2,A
1900-01-06,1899,Nottingham Forest,Wolverhampton Wanderers,0-0,0,0,1,1,0,0,D
1900-01-06,1899,Sunderland,Liverpool,1-0,1,0,1,1,1,1,H
1900-01-06,1899,West Bromwich Albion,Aston Villa,0-2,0,2,1,1,2,-2,A
1900-01-13,1899,Aston Villa,Everton,1-1,1,1,1,1,2,0,D
1900-01-13,1899,Burnley,Sunderland,3-1,3,1,1,1,4,2,H
1900-01-13,1899,Liverpool,West Bromwich Albion,2-0,2,0,1,1,2,2,H
1900-01-13,1899,Manchester City,Bury,2-2,2,2,1,1,4,0,D
1900-01-13,1899,Newcastle United,Blackburn Rovers,4-1,4,1,1,1,5,3,H
1900-01-13,1899,Nottingham Forest,Glossop North End,5-0,5,0,1,1,5,5,H
1900-01-13,1899,Preston North End,Stoke City,3-0,3,0,1,1,3,3,H
1900-01-13,1899,Sheffield United,Derby County,1-1,1,1,1,1,2,0,D
1900-01-13,1899,Wolverhampton Wanderers,Notts County,2-2,2,2,1,1,4,0,D
1900-01-20,1899,Blackburn Rovers,Aston Villa,0-4,0,4,1,1,4,-4,A
1900-01-20,1899,Bury,Sheffield United,2-1,2,1,1,1,3,1,H
1900-01-20,1899,Derby County,Newcastle United,2-1,2,1,1,1,3,1,H
1900-01-20,1899,Everton,Liverpool,3-1,3,1,1,1,4,2,H
1900-01-20,1899,Glossop North End,Wolverhampton Wanderers,2-3,2,3,1,1,5,-1,A
1900-01-20,1899,Notts County,Manchester City,1-1,1,1,1,1,2,0,D
1900-01-20,1899,Stoke City,Nottingham Forest,0-0,0,0,1,1,0,0,D
1900-01-20,1899,Sunderland,Preston North End,1-0,1,0,1,1,1,1,H
1900-01-20,1899,West Bromwich Albion,Burnley,2-0,2,0,1,1,2,2,H
1900-02-03,1899,Aston Villa,Derby County,3-2,3,2,1,1,5,1,H
1900-02-03,1899,Burnley,Everton,3-1,3,1,1,1,4,2,H
1900-02-03,1899,Glossop North End,Stoke City,1-2,1,2,1,1,3,-1,A
1900-02-03,1899,Liverpool,Blackburn Rovers,3-1,3,1,1,1,4,2,H
1900-02-03,1899,Newcastle United,Bury,2-1,2,1,1,1,3,1,H
1900-02-03,1899,Preston North End,West Bromwich Albion,5-2,5,2,1,1,7,3,H
1900-02-03,1899,Sheffield United,Notts County,1-1,1,1,1,1,2,0,D
1900-02-03,1899,Wolverhampton Wanderers,Manchester City,1-1,1,1,1,1,2,0,D
1900-02-17,1899,Aston Villa,Notts County,6-2,6,2,1,1,8,4,H
1900-02-17,1899,Burnley,Derby County,1-2,1,2,1,1,3,-1,A
1900-02-17,1899,Nottingham Forest,Everton,4-2,4,2,1,1,6,2,H
1900-02-24,1899,Sunderland,Glossop North End,0-0,0,0,1,1,0,0,D
1900-02-27,1899,Glossop North End,Blackburn Rovers,4-2,4,2,1,1,6,2,H
1900-03-03,1899,Aston Villa,Sheffield United,1-1,1,1,1,1,2,0,D
1900-03-03,1899,Blackburn Rovers,Glossop North End,2-2,2,2,1,1,4,0,D
1900-03-03,1899,Burnley,Notts County,3-0,3,0,1,1,3,3,H
1900-03-03,1899,Liverpool,Manchester City,5-2,5,2,1,1,7,3,H
1900-03-03,1899,Nottingham Forest,Derby County,4-1,4,1,1,1,5,3,H
1900-03-03,1899,Preston North End,Bury,1-0,1,0,1,1,1,1,H
1900-03-03,1899,Sunderland,West Bromwich Albion,3-1,3,1,1,1,4,2,H
1900-03-03,1899,Wolverhampton Wanderers,Newcastle United,1-1,1,1,1,1,2,0,D
1900-03-05,1899,Blackburn Rovers,Nottingham Forest,2-1,2,1,1,1,3,1,H
1900-03-10,1899,Blackburn Rovers,Stoke City,3-0,3,0,1,1,3,3,H
1900-03-10,1899,Everton,Sunderland,1-0,1,0,1,1,1,1,H
1900-03-10,1899,Manchester City,Burnley,1-0,1,0,1,1,1,1,H
1900-03-10,1899,Newcastle United,Aston Villa,3-2,3,2,1,1,5,1,H
1900-03-10,1899,Notts County,Preston North End,3-0,3,0,1,1,3,3,H
1900-03-10,1899,Sheffield United,Liverpool,1-2,1,2,1,1,3,-1,A
1900-03-10,1899,West Bromwich Albion,Wolverhampton Wanderers,3-2,3,2,1,1,5,1,H
1900-03-14,1899,Bury,Burnley,1-1,1,1,1,1,2,0,D
1900-03-14,1899,Newcastle United,Glossop North End,1-0,1,0,1,1,1,1,H
1900-03-17,1899,Glossop North End,Bury,0-0,0,0,1,1,0,0,D
1900-03-17,1899,Liverpool,Newcastle United,2-0,2,0,1,1,2,2,H
1900-03-17,1899,Nottingham Forest,Notts County,0-3,0,3,1,1,3,-3,A
1900-03-17,1899,Stoke City,Derby County,1-1,1,1,1,1,2,0,D
1900-03-17,1899,Wolverhampton Wanderers,Everton,2-1,2,1,1,1,3,1,H
1900-03-19,1899,Manchester City,Aston Villa,0-2,0,2,1,1,2,-2,A
1900-03-19,1899,West Bromwich Albion,Stoke City,4-0,4,0,1,1,4,4,H
1900-03-21,1899,Sunderland,Derby County,2-0,2,0,1,1,2,2,H
1900-03-24,1899,Aston Villa,Liverpool,1-0,1,0,1,1,1,1,H
1900-03-24,1899,Blackburn Rovers,West Bromwich Albion,2-0,2,0,1,1,2,2,H
1900-03-24,1899,Derby County,Sunderland,2-0,2,0,1,1,2,2,H
1900-03-24,1899,Everton,Wolverhampton Wanderers,0-1,0,1,1,1,1,-1,A
1900-03-24,1899,Newcastle United,Burnley,2-0,2,0,1,1,2,2,H
1900-03-24,1899,Notts County,Glossop North End,0-0,0,0,1,1,0,0,D
1900-03-24,1899,Sheffield United,Preston North End,1-0,1,0,1,1,1,1,H
1900-03-26,1899,Sheffield United,Newcastle United,3-1,3,1,1,1,4,2,H
1900-03-26,1899,Stoke City,Sunderland,1-2,1,2,1,1,3,-1,A
1900-03-31,1899,Burnley,Aston Villa,1-2,1,2,1,1,3,-1,A
1900-03-31,1899,Everton,Blackburn Rovers,0-0,0,0,1,1,0,0,D
1900-03-31,1899,Glossop North End,Manchester City,0-2,0,2,1,1,2,-2,A
1900-03-31,1899,Nottingham Forest,Sheffield United,4-0,4,0,1,1,4,4,H
1900-03-31,1899,Preston North End,Newcastle United,4-1,4,1,1,1,5,3,H
1900-03-31,1899,Stoke City,Notts County,1-0,1,0,1,1,1,1,H
1900-03-31,1899,Sunderland,Bury,1-0,1,0,1,1,1,1,H
1900-03-31,1899,West Bromwich Albion,Derby County,0-0,0,0,1,1,0,0,D
1900-03-31,1899,Wolverhampton Wanderers,Liverpool,0-1,0,1,1,1,1,-1,A
1900-04-02,1899,West Bromwich Albion,Blackburn Rovers,1-0,1,0,1,1,1,1,H
1900-04-04,1899,Derby County,Preston North End,2-0,2,0,1,1,2,2,H
1900-04-07,1899,Aston Villa,Preston North End,3-1,3,1,1,1,4,2,H
1900-04-07,1899,Blackburn Rovers,Wolverhampton Wanderers,2-1,2,1,1,1,3,1,H
1900-04-07,1899,Bury,West Bromwich Albion,1-0,1,0,1,1,1,1,H
1900-04-07,1899,Derby County,Everton,2-1,2,1,1,1,3,1,H
1900-04-07,1899,Liverpool,Burnley,0-1,0,1,1,1,1,-1,A
1900-04-07,1899,Manchester City,Stoke City,1-0,1,0,1,1,1,1,H
1900-04-07,1899,Newcastle United,Nottingham Forest,3-1,3,1,1,1,4,2,H
1900-04-07,1899,Notts County,Sunderland,3-1,3,1,1,1,4,2,H
1900-04-07,1899,Sheffield United,Glossop North End,4-0,4,0,1,1,4,4,H
1900-04-09,1899,Liverpool,Bury,2-0,2,0,1,1,2,2,H
1900-04-09,1899,Manchester City,Nottingham Forest,2-0,2,0,1,1,2,2,H
1900-04-13,1899,Blackburn Rovers,Sheffield United,3-3,3,3,1,1,6,0,D
1900-04-13,1899,Bury,Stoke City,0-1,0,1,1,1,1,-1,A
1900-04-13,1899,Glossop North End,Derby County,1-3,1,3,1,1,4,-2,A
1900-04-13,1899,Newcastle United,Manchester City,0-0,0,0,1,1,0,0,D
1900-04-14,1899,Blackburn Rovers,Derby County,2-0,2,0,1,1,2,2,H
1900-04-14,1899,Everton,Bury,2-0,2,0,1,1,2,2,H
1900-04-14,1899,Glossop North End,Newcastle United,0-0,0,0,1,1,0,0,D
1900-04-14,1899,Nottingham Forest,Aston Villa,1-1,1,1,1,1,2,0,D
1900-04-14,1899,Preston North End,Liverpool,1-3,1,3,1,1,4,-2,A
1900-04-14,1899,Stoke City,Sheffield United,1-1,1,1,1,1,2,0,D
1900-04-14,1899,Sunderland,Manchester City,3-1,3,1,1,1,4,2,H
1900-04-14,1899,West Bromwich Albion,Notts County,0-0,0,0,1,1,0,0,D
1900-04-14,1899,Wolverhampton Wanderers,Burnley,3-0,3,0,1,1,3,3,H
1900-04-16,1899,Everton,Glossop North End,4-1,4,1,1,1,5,3,H
1900-04-16,1899,Notts County,Newcastle United,0-0,0,0,1,1,0,0,D
1900-04-16,1899,Preston North End,Manchester City,0-2,0,2,1,1,2,-2,A
1900-04-16,1899,Stoke City,Bury,2-0,2,0,1,1,2,2,H
1900-04-16,1899,Sunderland,Blackburn Rovers,1-0,1,0,1,1,1,1,H
1900-04-16,1899,West Bromwich Albion,Nottingham Forest,8-0,8,0,1,1,8,8,H
1900-04-16,1899,Wolverhampton Wanderers,Aston Villa,0-1,0,1,1,1,1,-1,A
1900-04-17,1899,Nottingham Forest,Sunderland,1-3,1,3,1,1,4,-2,A
1900-04-17,1899,Wolverhampton Wanderers,Sheffield United,1-2,1,2,1,1,3,-1,A
1900-04-21,1899,Burnley,Preston North End,0-1,0,1,1,1,1,-1,A
1900-04-21,1899,Liverpool,Nottingham Forest,1-0,1,0,1,1,1,1,H
1900-04-21,1899,Manchester City,West Bromwich Albion,4-0,4,0,1,1,4,4,H
1900-04-21,1899,Newcastle United,Stoke City,2-2,2,2,1,1,4,0,D
1900-04-21,1899,Notts County,Everton,2-2,2,2,1,1,4,0,D
1900-04-21,1899,Wolverhampton Wanderers,Derby County,3-0,3,0,1,1,3,3,H
1900-04-23,1899,Burnley,Sheffield United,1-0,1,0,1,1,1,1,H
1900-04-24,1899,Glossop North End,West Bromwich Albion,1-1,1,1,1,1,2,0,D
1900-04-25,1899,Bury,Blackburn Rovers,2-0,2,0,1,1,2,2,H
1900-04-28,1899,Blackburn Rovers,Notts County,2-0,2,0,1,1,2,2,H
1900-04-28,1899,Derby County,Bury,3-0,3,0,1,1,3,3,H
1900-04-28,1899,Everton,Manchester City,4-0,4,0,1,1,4,4,H
1900-04-28,1899,Glossop North End,Liverpool,1-2,1,2,1,1,3,-1,A
1900-04-28,1899,Nottingham Forest,Burnley,4-0,4,0,1,1,4,4,H
1900-04-28,1899,Preston North End,Wolverhampton Wanderers,2-0,2,0,1,1,2,2,H
1900-04-28,1899,Sunderland,Newcastle United,1-2,1,2,1,1,3,-1,A
1900-04-30,1899,Preston North End,Blackburn Rovers,2-0,2,0,1,1,2,2,H
1900-09-01,1900,Aston Villa,Stoke City,2-0,2,0,1,1,2,2,H
1900-09-01,1900,Bolton Wanderers,Derby County,0-1,0,1,1,1,1,-1,A
1900-09-01,1900,Liverpool,Blackburn Rovers,3-0,3,0,1,1,3,3,H
1900-09-01,1900,Manchester City,Sheffield Wednesday,2-2,2,2,1,1,4,0,D
1900-09-01,1900,Newcastle United,Nottingham Forest,0-0,0,0,1,1,0,0,D
1900-09-01,1900,Notts County,Sunderland,2-2,2,2,1,1,4,0,D
1900-09-01,1900,Preston North End,Everton,1-2,1,2,1,1,3,-1,A
1900-09-01,1900,Sheffield United,Bury,0-3,0,3,1,1,3,-3,A
1900-09-01,1900,Wolverhampton Wanderers,West Bromwich Albion,0-0,0,0,1,1,0,0,D
1900-09-03,1900,Aston Villa,Preston North End,4-0,4,0,1,1,4,4,H
1900-09-03,1900,West Bromwich Albion,Derby County,1-1,1,1,1,1,2,0,D
1900-09-03,1900,Wolverhampton Wanderers,Notts County,3-2,3,2,1,1,5,1,H
1900-09-08,1900,Blackburn Rovers,Newcastle United,0-0,0,0,1,1,0,0,D
1900-09-08,1900,Bury,Manchester City,4-0,4,0,1,1,4,4,H
1900-09-08,1900,Derby County,Notts County,2-1,2,1,1,1,3,1,H
1900-09-08,1900,Everton,Wolverhampton Wanderers,5-1,5,1,1,1,6,4,H
1900-09-08,1900,Nottingham Forest,Sheffield United,2-0,2,0,1,1,2,2,H
1900-09-08,1900,Sheffield Wednesday,Bolton Wanderers,1-0,1,0,1,1,1,1,H
1900-09-08,1900,Stoke City,Liverpool,1-2,1,2,1,1,3,-1,A
1900-09-08,1900,Sunderland,Preston North End,3-1,3,1,1,1,4,2,H
1900-09-08,1900,West Bromwich Albion,Aston Villa,0-1,0,1,1,1,1,-1,A
1900-09-10,1900,Aston Villa,Bury,1-0,1,0,1,1,1,1,H
1900-09-10,1900,Stoke City,Notts County,1-1,1,1,1,1,2,0,D
1900-09-15,1900,Aston Villa,Everton,1-2,1,2,1,1,3,-1,A
1900-09-15,1900,Bury,Sheffield Wednesday,2-0,2,0,1,1,2,2,H
1900-09-15,1900,Liverpool,West Bromwich Albion,5-0,5,0,1,1,5,5,H
1900-09-15,1900,Manchester City,Nottingham Forest,1-0,1,0,1,1,1,1,H
1900-09-15,1900,Newcastle United,Stoke City,2-1,2,1,1,1,3,1,H
1900-09-15,1900,Notts County,Bolton Wanderers,3-1,3,1,1,1,4,2,H
1900-09-15,1900,Preston North End,Derby County,3-2,3,2,1,1,5,1,H
1900-09-15,1900,Sheffield United,Blackburn Rovers,2-1,2,1,1,1,3,1,H
1900-09-15,1900,Wolverhampton Wanderers,Sunderland,2-2,2,2,1,1,4,0,D
1900-09-22,1900,Blackburn Rovers,Manchester City,1-0,1,0,1,1,1,1,H
1900-09-22,1900,Bolton Wanderers,Preston North End,1-1,1,1,1,1,2,0,D
1900-09-22,1900,Derby County,Wolverhampton Wanderers,4-5,4,5,1,1,9,-1,A
1900-09-22,1900,Everton,Liverpool,1-1,1,1,1,1,2,0,D
1900-09-22,1900,Nottingham Forest,Bury,1-1,1,1,1,1,2,0,D
1900-09-22,1900,Sheffield Wednesday,Notts County,4-1,4,1,1,1,5,3,H
1900-09-22,1900,Stoke City,Sheffield United,0-1,0,1,1,1,1,-1,A
1900-09-22,1900,Sunderland,Aston Villa,0-0,0,0,1,1,0,0,D
1900-09-22,1900,West Bromwich Albion,Newcastle United,0-1,0,1,1,1,1,-1,A
1900-09-29,1900,Aston Villa,Derby County,2-1,2,1,1,1,3,1,H
1900-09-29,1900,Bury,Blackburn Rovers,0-1,0,1,1,1,1,-1,A
1900-09-29,1900,Liverpool,Sunderland,1-2,1,2,1,1,3,-1,A
1900-09-29,1900,Manchester City,Stoke City,2-0,2,0,1,1,2,2,H
1900-09-29,1900,Newcastle United,Everton,1-0,1,0,1,1,1,1,H
1900-09-29,1900,Nottingham Forest,Sheffield Wednesday,1-0,1,0,1,1,1,1,H
1900-09-29,1900,Preston North End,Notts County,0-1,0,1,1,1,1,-1,A
1900-09-29,1900,Sheffield United,West Bromwich Albion,1-1,1,1,1,1,2,0,D
1900-09-29,1900,Wolverhampton Wanderers,Bolton Wanderers,1-1,1,1,1,1,2,0,D
1900-10-04,1900,Nottingham Forest,Preston North End,4-1,4,1,1,1,5,3,H
1900-10-06,1900,Blackburn Rovers,Nottingham Forest,1-3,1,3,1,1,4,-2,A
1900-10-06,1900,Bolton Wanderers,Aston Villa,1-0,1,0,1,1,1,1,H
1900-10-06,1900,Derby County,Liverpool,2-3,2,3,1,1,5,-1,A
1900-10-06,1900,Everton,Sheffield United,3-1,3,1,1,1,4,2,H
1900-10-06,1900,Notts County,Wolverhampton Wanderers,4-1,4,1,1,1,5,3,H
1900-10-06,1900,Sheffield Wednesday,Preston North End,0-1,0,1,1,1,1,-1,A
1900-10-06,1900,Stoke City,Bury,1-2,1,2,1,1,3,-1,A
1900-10-06,1900,Sunderland,Newcastle United,1-1,1,1,1,1,2,0,D
1900-10-06,1900,West Bromwich Albion,Manchester City,3-2,3,2,1,1,5,1,H
1900-10-13,1900,Aston Villa,Notts County,1-2,1,2,1,1,3,-1,A
1900-10-13,1900,Blackburn Rovers,Sheffield Wednesday,2-2,2,2,1,1,4,0,D
1900-10-13,1900,Bury,West Bromwich Albion,6-1,6,1,1,1,7,5,H
1900-10-13,1900,Liverpool,Bolton Wanderers,2-1,2,1,1,1,3,1,H
1900-10-13,1900,Manchester City,Everton,1-0,1,0,1,1,1,1,H
1900-10-13,1900,Newcastle United,Derby County,2-1,2,1,1,1,3,1,H
1900-10-13,1900,Nottingham Forest,Stoke City,1-1,1,1,1,1,2,0,D
1900-10-13,1900,Sheffield United,Sunderland,2-0,2,0,1,1,2,2,H
1900-10-13,1900,Wolverhampton Wanderers,Preston North End,2-2,2,2,1,1,4,0,D
1900-10-20,1900,Bolton Wanderers,Newcastle United,3-2,3,2,1,1,5,1,H
1900-10-20,1900,Derby County,Sheffield United,4-0,4,0,1,1,4,4,H
1900-10-20,1900,Notts County,Liverpool,3-0,3,0,1,1,3,3,H
1900-10-20,1900,Preston North End,Aston Villa,0-2,0,2,1,1,2,-2,A
1900-10-20,1900,Stoke City,Blackburn Rovers,2-0,2,0,1,1,2,2,H
1900-10-20,1900,Sunderland,Manchester City,3-0,3,0,1,1,3,3,H
1900-10-20,1900,West Bromwich Albion,Nottingham Forest,1-6,1,6,1,1,7,-5,A
1900-10-27,1900,Aston Villa,Wolverhampton Wanderers,0-0,0,0,1,1,0,0,D
1900-10-27,1900,Blackburn Rovers,West Bromwich Albion,1-1,1,1,1,1,2,0,D
1900-10-27,1900,Bury,Sunderland,0-0,0,0,1,1,0,0,D
1900-10-27,1900,Liverpool,Preston North End,3-2,3,2,1,1,5,1,H
1900-10-27,1900,Manchester City,Derby County,2-0,2,0,1,1,2,2,H
1900-10-27,1900,Newcastle United,Notts County,2-0,2,0,1,1,2,2,H
1900-10-27,1900,Nottingham Forest,Everton,2-1,2,1,1,1,3,1,H
1900-10-27,1900,Sheffield United,Bolton Wanderers,0-2,0,2,1,1,2,-2,A
1900-10-27,1900,Stoke City,Sheffield Wednesday,2-1,2,1,1,1,3,1,H
1900-10-29,1900,Aston Villa,Blackburn Rovers,3-3,3,3,1,1,6,0,D
1900-11-03,1900,Bolton Wanderers,Manchester City,0-0,0,0,1,1,0,0,D
1900-11-03,1900,Derby County,Bury,5-2,5,2,1,1,7,3,H
1900-11-03,1900,Everton,Blackburn Rovers,0-0,0,0,1,1,0,0,D
1900-11-03,1900,Notts County,Sheffield United,2-4,2,4,1,1,6,-2,A
1900-11-03,1900,Preston North End,Newcastle United,0-1,0,1,1,1,1,-1,A
1900-11-03,1900,Sheffield Wednesday,Aston Villa,3-2,3,2,1,1,5,1,H
1900-11-03,1900,Sunderland,Nottingham Forest,0-1,0,1,1,1,1,-1,A
1900-11-03,1900,West Bromwich Albion,Stoke City,2-2,2,2,1,1,4,0,D
1900-11-03,1900,Wolverhampton Wanderers,Liverpool,2-1,2,1,1,1,3,1,H
1900-11-05,1900,West Bromwich Albion,Notts County,1-0,1,0,1,1,1,1,H
1900-11-10,1900,Blackburn Rovers,Sunderland,0-1,0,1,1,1,1,-1,A
1900-11-10,1900,Bury,Bolton Wanderers,3-0,3,0,1,1,3,3,H
1900-11-10,1900,Liverpool,Aston Villa,5-1,5,1,1,1,6,4,H
1900-11-10,1900,Manchester City,Notts County,2-0,2,0,1,1,2,2,H
1900-11-10,1900,Newcastle United,Wolverhampton Wanderers,3-1,3,1,1,1,4,2,H
1900-11-10,1900,Nottingham Forest,Derby County,1-0,1,0,1,1,1,1,H
1900-11-10,1900,Sheffield United,Preston North End,2-1,2,1,1,1,3,1,H
1900-11-10,1900,Stoke City,Everton,0-2,0,2,1,1,2,-2,A
1900-11-10,1900,West Bromwich Albion,Sheffield Wednesday,1-1,1,1,1,1,2,0,D
1900-11-12,1900,Stoke City,Bolton Wanderers,2-1,2,1,1,1,3,1,H
1900-11-17,1900,Aston Villa,Newcastle United,2-2,2,2,1,1,4,0,D
1900-11-17,1900,Derby County,Blackburn Rovers,4-0,4,0,1,1,4,4,H
1900-11-17,1900,Everton,West Bromwich Albion,1-0,1,0,1,1,1,1,H
1900-11-17,1900,Notts County,Bury,1-0,1,0,1,1,1,1,H
1900-11-17,1900,Preston North End,Manchester City,0-4,0,4,1,1,4,-4,A
1900-11-17,1900,Sheffield Wednesday,Liverpool,3-2,3,2,1,1,5,1,H
1900-11-17,1900,Sunderland,Stoke City,6-1,6,1,1,1,7,5,H
1900-11-17,1900,Wolverhampton Wanderers,Sheffield United,3-0,3,0,1,1,3,3,H
1900-11-24,1900,Blackburn Rovers,Bolton Wanderers,2-0,2,0,1,1,2,2,H
1900-11-24,1900,Bury,Preston North End,2-1,2,1,1,1,3,1,H
1900-11-24,1900,Everton,Sheffield Wednesday,1-1,1,1,1,1,2,0,D
1900-11-24,1900,Manchester City,Wolverhampton Wanderers,3-2,3,2,1,1,5,1,H
1900-11-24,1900,Newcastle United,Liverpool,1-1,1,1,1,1,2,0,D
1900-11-24,1900,Nottingham Forest,Notts County,5-0,5,0,1,1,5,5,H
1900-11-24,1900,Sheffield United,Aston Villa,2-2,2,2,1,1,4,0,D
1900-11-24,1900,Stoke City,Derby County,0-1,0,1,1,1,1,-1,A
1900-11-24,1900,West Bromwich Albion,Sunderland,1-0,1,0,1,1,1,1,H
1900-12-01,1900,Aston Villa,Manchester City,7-1,7,1,1,1,8,6,H
1900-12-01,1900,Bolton Wanderers,Stoke City,1-0,1,0,1,1,1,1,H
1900-12-01,1900,Derby County,West Bromwich Albion,4-0,4,0,1,1,4,4,H
1900-12-01,1900,Liverpool,Sheffield United,1-2,1,2,1,1,3,-1,A
1900-12-01,1900,Notts County,Blackburn Rovers,2-1,2,1,1,1,3,1,H
1900-12-01,1900,Preston North End,Nottingham Forest,1-1,1,1,1,1,2,0,D
1900-12-01,1900,Sheffield Wednesday,Newcastle United,2-2,2,2,1,1,4,0,D
1900-12-01,1900,Sunderland,Everton,2-0,2,0,1,1,2,2,H
1900-12-01,1900,Wolverhampton Wanderers,Bury,1-1,1,1,1,1,2,0,D
1900-12-08,1900,Bury,Aston Villa,3-1,3,1,1,1,4,2,H
1900-12-08,1900,Everton,Derby County,2-0,2,0,1,1,2,2,H
1900-12-08,1900,Manchester City,Liverpool,3-4,3,4,1,1,7,-1,A
1900-12-08,1900,Nottingham Forest,Wolverhampton Wanderers,2-1,2,1,1,1,3,1,H
1900-12-08,1900,Preston North End,Blackburn Rovers,4-1,4,1,1,1,5,3,H
1900-12-08,1900,Sheffield United,Newcastle United,2-0,2,0,1,1,2,2,H
1900-12-08,1900,Sunderland,Sheffield Wednesday,1-0,1,0,1,1,1,1,H
1900-12-08,1900,West Bromwich Albion,Bolton Wanderers,7-2,7,2,1,1,9,5,H
1900-12-15,1900,Aston Villa,Nottingham Forest,2-1,2,1,1,1,3,1,H
1900-12-15,1900,Bolton Wanderers,Everton,1-0,1,0,1,1,1,1,H
1900-12-15,1900,Liverpool,Bury,1-0,1,0,1,1,1,1,H
1900-12-15,1900,Newcastle United,Manchester City,2-1,2,1,1,1,3,1,H
1900-12-15,1900,Notts County,West Bromwich Albion,1-0,1,0,1,1,1,1,H
1900-12-15,1900,Sheffield United,Sheffield Wednesday,1-0,1,0,1,1,1,1,H
1900-12-15,1900,Wolverhampton Wanderers,Blackburn Rovers,2-2,2,2,1,1,4,0,D
1900-12-22,1900,Blackburn Rovers,Aston Villa,2-2,2,2,1,1,4,0,D
1900-12-22,1900,Bury,Newcastle United,1-0,1,0,1,1,1,1,H
1900-12-22,1900,Everton,Notts County,0-1,0,1,1,1,1,-1,A
1900-12-22,1900,Manchester City,Sheffield United,2-1,2,1,1,1,3,1,H
1900-12-22,1900,Nottingham Forest,Liverpool,0-0,0,0,1,1,0,0,D
1900-12-22,1900,Sheffield Wednesday,Derby County,2-1,2,1,1,1,3,1,H
1900-12-22,1900,Stoke City,Wolverhampton Wanderers,3-0,3,0,1,1,3,3,H
1900-12-22,1900,West Bromwich Albion,Preston North End,0-1,0,1,1,1,1,-1,A
1900-12-25,1900,Liverpool,Derby County,0-0,0,0,1,1,0,0,D
1900-12-25,1900,Manchester City,Sunderland,1-1,1,1,1,1,2,0,D
1900-12-25,1900,Nottingham Forest,Bolton Wanderers,3-0,3,0,1,1,3,3,H
1900-12-25,1900,Preston North End,Stoke City,4-2,4,2,1,1,6,2,H
1900-12-25,1900,Sheffield United,Everton,2-1,2,1,1,1,3,1,H
1900-12-26,1900,Aston Villa,Bolton Wanderers,3-0,3,0,1,1,3,3,H
1900-12-26,1900,Derby County,Sunderland,1-1,1,1,1,1,2,0,D
1900-12-26,1900,Everton,Bury,3-3,3,3,1,1,6,0,D
1900-12-26,1900,Notts County,Nottingham Forest,1-0,1,0,1,1,1,1,H
1900-12-26,1900,Sheffield United,Manchester City,1-1,1,1,1,1,2,0,D
1900-12-26,1900,Stoke City,Preston North End,5-0,5,0,1,1,5,5,H
1900-12-26,1900,Wolverhampton Wanderers,Sheffield Wednesday,1-1,1,1,1,1,2,0,D
1900-12-29,1900,Blackburn Rovers,Liverpool,3-1,3,1,1,1,4,2,H
1900-12-29,1900,Bury,Sheffield United,1-1,1,1,1,1,2,0,D
1900-12-29,1900,Derby County,Bolton Wanderers,4-2,4,2,1,1,6,2,H
1900-12-29,1900,Everton,Preston North End,4-1,4,1,1,1,5,3,H
1900-12-29,1900,Nottingham Forest,Newcastle United,1-2,1,2,1,1,3,-1,A
1900-12-29,1900,Sheffield Wednesday,Manchester City,4-1,4,1,1,1,5,3,H
1900-12-29,1900,Stoke City,Aston Villa,0-0,0,0,1,1,0,0,D
1900-12-29,1900,Sunderland,Notts County,1-1,1,1,1,1,2,0,D
1900-12-29,1900,West Bromwich Albion,Wolverhampton Wanderers,1-2,1,2,1,1,3,-1,A
1901-01-01,1900,Blackburn Rovers,Preston North End,3-1,3,1,1,1,4,2,H
1901-01-01,1900,Bolton Wanderers,Nottingham Forest,4-2,4,2,1,1,6,2,H
1901-01-01,1900,Bury,Everton,3-0,3,0,1,1,3,3,H
1901-01-01,1900,Liverpool,Stoke City,3-1,3,1,1,1,4,2,H
1901-01-01,1900,Sheffield Wednesday,Wolverhampton Wanderers,2-0,2,0,1,1,2,2,H
1901-01-01,1900,Sunderland,Derby County,2-1,2,1,1,1,3,1,H
1901-01-02,1900,Bolton Wanderers,Sunderland,0-0,0,0,1,1,0,0,D
1901-01-05,1900,Aston Villa,West Bromwich Albion,0-1,0,1,1,1,1,-1,A
1901-01-05,1900,Bolton Wanderers,Sheffield Wednesday,1-1,1,1,1,1,2,0,D
1901-01-05,1900,Manchester City,Bury,1-0,1,0,1,1,1,1,H
1901-01-05,1900,Newcastle United,Blackburn Rovers,1-0,1,0,1,1,1,1,H
1901-01-05,1900,Notts County,Derby County,2-1,2,1,1,1,3,1,H
1901-01-05,1900,Preston North End,Sunderland,1-1,1,1,1,1,2,0,D
1901-01-05,1900,Sheffield United,Nottingham Forest,0-1,0,1,1,1,1,-1,A
1901-01-05,1900,Wolverhampton Wanderers,Everton,1-1,1,1,1,1,2,0,D
1901-01-12,1900,Blackburn Rovers,Sheffield United,1-0,1,0,1,1,1,1,H
1901-01-12,1900,Derby County,Preston North End,0-0,0,0,1,1,0,0,D
1901-01-12,1900,Everton,Aston Villa,2-1,2,1,1,1,3,1,H
1901-01-12,1900,Nottingham Forest,Manchester City,4-2,4,2,1,1,6,2,H
1901-01-12,1900,Sheffield Wednesday,Bury,1-2,1,2,1,1,3,-1,A
1901-01-12,1900,Stoke City,Newcastle United,2-0,2,0,1,1,2,2,H
1901-01-12,1900,Sunderland,Wolverhampton Wanderers,7-2,7,2,1,1,9,5,H
1901-01-19,1900,Aston Villa,Sunderland,2-2,2,2,1,1,4,0,D
1901-01-19,1900,Liverpool,Everton,1-2,1,2,1,1,3,-1,A
1901-01-19,1900,Manchester City,Blackburn Rovers,1-3,1,3,1,1,4,-2,A
1901-01-19,1900,Newcastle United,West Bromwich Albion,1-1,1,1,1,1,2,0,D
1901-01-19,1900,Notts County,Sheffield Wednesday,2-0,2,0,1,1,2,2,H
1901-01-19,1900,Sheffield United,Stoke City,0-4,0,4,1,1,4,-4,A
1901-01-19,1900,Wolverhampton Wanderers,Derby County,0-0,0,0,1,1,0,0,D
1901-01-26,1900,Stoke City,Manchester City,2-1,2,1,1,1,3,1,H
1901-02-16,1900,Bolton Wanderers,Liverpool,1-0,1,0,1,1,1,1,H
1901-02-16,1900,Derby County,Newcastle United,1-1,1,1,1,1,2,0,D
1901-02-16,1900,Everton,Manchester City,5-2,5,2,1,1,7,3,H
1901-02-16,1900,Notts County,Aston Villa,2-0,2,0,1,1,2,2,H
1901-02-16,1900,Preston North End,Wolverhampton Wanderers,1-1,1,1,1,1,2,0,D
1901-02-16,1900,Sheffield Wednesday,Blackburn Rovers,1-1,1,1,1,1,2,0,D
1901-02-16,1900,Stoke City,Nottingham Forest,0-3,0,3,1,1,3,-3,A
1901-02-16,1900,Sunderland,Sheffield United,3-0,3,0,1,1,3,3,H
1901-02-16,1900,West Bromwich Albion,Bury,1-2,1,2,1,1,3,-1,A
1901-02-23,1900,Blackburn Rovers,Stoke City,3-2,3,2,1,1,5,1,H
1901-02-23,1900,Manchester City,Preston North End,3-1,3,1,1,1,4,2,H
1901-02-23,1900,Sunderland,Liverpool,0-1,0,1,1,1,1,-1,A
1901-03-02,1900,Bolton Wanderers,Sheffield United,0-0,0,0,1,1,0,0,D
1901-03-02,1900,Derby County,Manchester City,2-0,2,0,1,1,2,2,H
1901-03-02,1900,Everton,Nottingham Forest,4-1,4,1,1,1,5,3,H
1901-03-02,1900,Notts County,Newcastle United,3-1,3,1,1,1,4,2,H
1901-03-02,1900,Preston North End,Liverpool,2-2,2,2,1,1,4,0,D
1901-03-02,1900,Sheffield Wednesday,Stoke City,4-0,4,0,1,1,4,4,H
1901-03-02,1900,Sunderland,Bury,4-1,4,1,1,1,5,3,H
1901-03-02,1900,West Bromwich Albion,Blackburn Rovers,1-1,1,1,1,1,2,0,D
1901-03-09,1900,Aston Villa,Sheffield Wednesday,2-1,2,1,1,1,3,1,H
1901-03-09,1900,Blackburn Rovers,Everton,2-1,2,1,1,1,3,1,H
1901-03-09,1900,Bury,Derby County,2-1,2,1,1,1,3,1,H
1901-03-09,1900,Liverpool,Wolverhampton Wanderers,1-0,1,0,1,1,1,1,H
1901-03-09,1900,Manchester City,Bolton Wanderers,1-1,1,1,1,1,2,0,D
1901-03-09,1900,Newcastle United,Preston North End,3-5,3,5,1,1,8,-2,A
1901-03-09,1900,Nottingham Forest,Sunderland,0-0,0,0,1,1,0,0,D
1901-03-09,1900,Sheffield United,Notts County,4-2,4,2,1,1,6,2,H
1901-03-09,1900,Stoke City,West Bromwich Albion,2-0,2,0,1,1,2,2,H
1901-03-11,1900,Sheffield United,Derby County,2-1,2,1,1,1,3,1,H
1901-03-13,1900,Nottingham Forest,West Bromwich Albion,2-3,2,3,1,1,5,-1,A
1901-03-16,1900,Aston Villa,Liverpool,0-2,0,2,1,1,2,-2,A
1901-03-16,1900,Bolton Wanderers,Bury,3-2,3,2,1,1,5,1,H
1901-03-16,1900,Derby County,Nottingham Forest,0-0,0,0,1,1,0,0,D
1901-03-16,1900,Everton,Stoke City,3-0,3,0,1,1,3,3,H
1901-03-16,1900,Notts County,Manchester City,0-0,0,0,1,1,0,0,D
1901-03-16,1900,Preston North End,Sheffield United,3-1,3,1,1,1,4,2,H
1901-03-16,1900,Sheffield Wednesday,West Bromwich Albion,2-1,2,1,1,1,3,1,H
1901-03-16,1900,Sunderland,Blackburn Rovers,2-0,2,0,1,1,2,2,H
1901-03-16,1900,Wolverhampton Wanderers,Newcastle United,1-0,1,0,1,1,1,1,H
1901-03-23,1900,Blackburn Rovers,Derby County,1-0,1,0,1,1,1,1,H
1901-03-23,1900,Bury,Notts County,1-0,1,0,1,1,1,1,H
1901-03-23,1900,Liverpool,Sheffield Wednesday,1-1,1,1,1,1,2,0,D
1901-03-23,1900,Preston North End,Bolton Wanderers,1-3,1,3,1,1,4,-2,A
1901-03-23,1900,Stoke City,Sunderland,0-0,0,0,1,1,0,0,D
1901-03-25,1900,Sheffield United,Wolverhampton Wanderers,1-1,1,1,1,1,2,0,D
1901-03-27,1900,Bury,Nottingham Forest,0-1,0,1,1,1,1,-1,A
1901-03-27,1900,Newcastle United,Bolton Wanderers,3-0,3,0,1,1,3,3,H
1901-03-27,1900,Notts County,Preston North End,6-1,6,1,1,1,7,5,H
1901-03-30,1900,Aston Villa,Sheffield United,0-0,0,0,1,1,0,0,D
1901-03-30,1900,Bolton Wanderers,Blackburn Rovers,1-0,1,0,1,1,1,1,H
1901-03-30,1900,Derby County,Stoke City,4-1,4,1,1,1,5,3,H
1901-03-30,1900,Liverpool,Newcastle United,3-0,3,0,1,1,3,3,H
1901-03-30,1900,Preston North End,Bury,3-1,3,1,1,1,4,2,H
1901-03-30,1900,Sheffield Wednesday,Everton,3-1,3,1,1,1,4,2,H
1901-03-30,1900,Sunderland,West Bromwich Albion,3-0,3,0,1,1,3,3,H
1901-03-30,1900,Wolverhampton Wanderers,Manchester City,1-0,1,0,1,1,1,1,H
1901-04-05,1900,Bolton Wanderers,Notts County,0-1,0,1,1,1,1,-1,A
1901-04-05,1900,Bury,Stoke City,3-2,3,2,1,1,5,1,H
1901-04-05,1900,Manchester City,West Bromwich Albion,1-0,1,0,1,1,1,1,H
1901-04-05,1900,Preston North End,Sheffield Wednesday,3-2,3,2,1,1,5,1,H
1901-04-06,1900,Blackburn Rovers,Notts County,0-2,0,2,1,1,2,-2,A
1901-04-06,1900,Bury,Wolverhampton Wanderers,0-1,0,1,1,1,1,-1,A
1901-04-06,1900,Everton,Sunderland,1-0,1,0,1,1,1,1,H
1901-04-06,1900,Newcastle United,Sheffield Wednesday,0-0,0,0,1,1,0,0,D
1901-04-08,1900,Everton,Newcastle United,0-1,0,1,1,1,1,-1,A
1901-04-08,1900,Liverpool,Notts County,1-0,1,0,1,1,1,1,H
1901-04-08,1900,Nottingham Forest,Blackburn Rovers,0-1,0,1,1,1,1,-1,A
1901-04-08,1900,Sunderland,Bolton Wanderers,5-1,5,1,1,1,6,4,H
1901-04-08,1900,Wolverhampton Wanderers,Aston Villa,0-0,0,0,1,1,0,0,D
1901-04-09,1900,Notts County,Everton,3-2,3,2,1,1,5,1,H
1901-04-09,1900,Sheffield Wednesday,Nottingham Forest,4-1,4,1,1,1,5,3,H
1901-04-09,1900,Wolverhampton Wanderers,Stoke City,0-2,0,2,1,1,2,-2,A
1901-04-13,1900,Blackburn Rovers,Bury,0-2,0,2,1,1,2,-2,A
1901-04-13,1900,Bolton Wanderers,West Bromwich Albion,3-2,3,2,1,1,5,1,H
1901-04-13,1900,Derby County,Everton,0-1,0,1,1,1,1,-1,A
1901-04-13,1900,Liverpool,Manchester City,3-1,3,1,1,1,4,2,H
1901-04-13,1900,Newcastle United,Sheffield United,3-0,3,0,1,1,3,3,H
1901-04-13,1900,Notts County,Stoke City,2-4,2,4,1,1,6,-2,A
1901-04-13,1900,Sheffield Wednesday,Sunderland,1-0,1,0,1,1,1,1,H
1901-04-13,1900,Wolverhampton Wanderers,Nottingham Forest,1-0,1,0,1,1,1,1,H
1901-04-15,1900,Preston North End,West Bromwich Albion,2-3,2,3,1,1,5,-1,A
1901-04-17,1900,Newcastle United,Aston Villa,3-0,3,0,1,1,3,3,H
1901-04-20,1900,Blackburn Rovers,Wolverhampton Wanderers,2-0,2,0,1,1,2,2,H
1901-04-20,1900,Bury,Liverpool,0-0,0,0,1,1,0,0,D
1901-04-20,1900,Everton,Bolton Wanderers,2-3,2,3,1,1,5,-1,A
1901-04-20,1900,Manchester City,Newcastle United,2-1,2,1,1,1,3,1,H
1901-04-20,1900,Nottingham Forest,Aston Villa,3-1,3,1,1,1,4,2,H
1901-04-22,1900,Derby County,Aston Villa,3-0,3,0,1,1,3,3,H
1901-04-22,1900,Sheffield United,Liverpool,0-2,0,2,1,1,2,-2,A
1901-04-22,1900,West Bromwich Albion,Everton,1-2,1,2,1,1,3,-1,A
1901-04-24,1900,Newcastle United,Sunderland,0-2,0,2,1,1,2,-2,A
1901-04-27,1900,Derby County,Sheffield Wednesday,3-1,3,1,1,1,4,2,H
1901-04-27,1900,Liverpool,Nottingham Forest,2-0,2,0,1,1,2,2,H
1901-04-27,1900,Manchester City,Aston Villa,4-0,4,0,1,1,4,4,H
1901-04-27,1900,Newcastle United,Bury,0-0,0,0,1,1,0,0,D
1901-04-29,1900,Bolton Wanderers,Wolverhampton Wanderers,1-0,1,0,1,1,1,1,H
1901-04-29,1900,Sheffield Wednesday,Sheffield United,1-0,1,0,1,1,1,1,H
1901-04-29,1900,West Bromwich Albion,Liverpool,0-1,0,1,1,1,1,-1,A
1901-04-30,1900,West Bromwich Albion,Sheffield United,0-2,0,2,1,1,2,-2,A
1901-09-02,1901,Birmingham City,Liverpool,0-0,0,0,1,1,0,0,D
1901-09-02,1901,Everton,Manchester City,3-1,3,1,1,1,4,2,H
1901-09-02,1901,Stoke City,Bury,1-2,1,2,1,1,3,-1,A
1901-09-02,1901,Sunderland,Sheffield United,3-1,3,1,1,1,4,2,H
1901-09-02,1901,Wolverhampton Wanderers,Nottingham Forest,2-0,2,0,1,1,2,2,H
1901-09-03,1901,Grimsby Town,Derby County,1-1,1,1,1,1,2,0,D
1901-09-07,1901,Birmingham City,Bolton Wanderers,2-0,2,0,1,1,2,2,H
1901-09-07,1901,Blackburn Rovers,Newcastle United,0-0,0,0,1,1,0,0,D
1901-09-07,1901,Bury,Aston Villa,0-0,0,0,1,1,0,0,D
1901-09-07,1901,Derby County,Notts County,2-0,2,0,1,1,2,2,H
1901-09-07,1901,Everton,Wolverhampton Wanderers,6-1,6,1,1,1,7,5,H
1901-09-07,1901,Nottingham Forest,Sheffield United,2-1,2,1,1,1,3,1,H
1901-09-07,1901,Sheffield Wednesday,Grimsby Town,3-1,3,1,1,1,4,2,H
1901-09-07,1901,Stoke City,Liverpool,1-0,1,0,1,1,1,1,H
1901-09-07,1901,Sunderland,Manchester City,1-0,1,0,1,1,1,1,H
1901-09-09,1901,Aston Villa,Notts County,2-0,2,0,1,1,2,2,H
1901-09-14,1901,Aston Villa,Blackburn Rovers,1-1,1,1,1,1,2,0,D
1901-09-14,1901,Bolton Wanderers,Derby County,2-1,2,1,1,1,3,1,H
1901-09-14,1901,Grimsby Town,Nottingham Forest,1-0,1,0,1,1,1,1,H
1901-09-14,1901,Liverpool,Everton,2-2,2,2,1,1,4,0,D
1901-09-14,1901,Manchester City,Birmingham City,1-4,1,4,1,1,5,-3,A
1901-09-14,1901,Newcastle United,Stoke City,5-1,5,1,1,1,6,4,H
1901-09-14,1901,Notts County,Sheffield Wednesday,6-1,6,1,1,1,7,5,H
1901-09-14,1901,Sheffield United,Bury,3-1,3,1,1,1,4,2,H
1901-09-14,1901,Wolverhampton Wanderers,Sunderland,4-2,4,2,1,1,6,2,H
1901-09-16,1901,Aston Villa,Sheffield United,1-2,1,2,1,1,3,-1,A
1901-09-21,1901,Birmingham City,Wolverhampton Wanderers,1-2,1,2,1,1,3,-1,A
1901-09-21,1901,Blackburn Rovers,Sheffield United,2-1,2,1,1,1,3,1,H
1901-09-21,1901,Bury,Nottingham Forest,1-1,1,1,1,1,2,0,D
1901-09-21,1901,Derby County,Manchester City,2-0,2,0,1,1,2,2,H
1901-09-21,1901,Everton,Newcastle United,0-0,0,0,1,1,0,0,D
1901-09-21,1901,Notts County,Grimsby Town,3-0,3,0,1,1,3,3,H
1901-09-21,1901,Sheffield Wednesday,Bolton Wanderers,5-1,5,1,1,1,6,4,H
1901-09-21,1901,Stoke City,Aston Villa,1-0,1,0,1,1,1,1,H
1901-09-21,1901,Sunderland,Liverpool,1-1,1,1,1,1,2,0,D
1901-09-28,1901,Aston Villa,Everton,1-1,1,1,1,1,2,0,D
1901-09-28,1901,Bolton Wanderers,Notts County,1-1,1,1,1,1,2,0,D
1901-09-28,1901,Grimsby Town,Bury,2-0,2,0,1,1,2,2,H
1901-09-28,1901,Liverpool,Birmingham City,3-1,3,1,1,1,4,2,H
1901-09-28,1901,Newcastle United,Sunderland,0-1,0,1,1,1,1,-1,A
1901-09-28,1901,Nottingham Forest,Blackburn Rovers,3-0,3,0,1,1,3,3,H
1901-09-28,1901,Sheffield United,Stoke City,1-1,1,1,1,1,2,0,D
1901-09-28,1901,Wolverhampton Wanderers,Derby County,0-0,0,0,1,1,0,0,D
1901-10-03,1901,Notts County,Newcastle United,0-2,0,2,1,1,2,-2,A
1901-10-05,1901,Birmingham City,Newcastle United,3-1,3,1,1,1,4,2,H
1901-10-05,1901,Blackburn Rovers,Bury,0-3,0,3,1,1,3,-3,A
1901-10-05,1901,Bolton Wanderers,Grimsby Town,4-0,4,0,1,1,4,4,H
1901-10-05,1901,Derby County,Liverpool,1-1,1,1,1,1,2,0,D
1901-10-05,1901,Everton,Sheffield United,2-1,2,1,1,1,3,1,H
1901-10-05,1901,Notts County,Manchester City,2-0,2,0,1,1,2,2,H
1901-10-05,1901,Sheffield Wednesday,Wolverhampton Wanderers,1-1,1,1,1,1,2,0,D
1901-10-05,1901,Stoke City,Nottingham Forest,1-1,1,1,1,1,2,0,D
1901-10-05,1901,Sunderland,Aston Villa,1-0,1,0,1,1,1,1,H
1901-10-12,1901,Birmingham City,Aston Villa,0-2,0,2,1,1,2,-2,A
1901-10-12,1901,Bury,Stoke City,4-2,4,2,1,1,6,2,H
1901-10-12,1901,Grimsby Town,Blackburn Rovers,2-1,2,1,1,1,3,1,H
1901-10-12,1901,Liverpool,Sheffield Wednesday,1-2,1,2,1,1,3,-1,A
1901-10-12,1901,Manchester City,Bolton Wanderers,1-0,1,0,1,1,1,1,H
1901-10-12,1901,Newcastle United,Derby County,0-1,0,1,1,1,1,-1,A
1901-10-12,1901,Nottingham Forest,Everton,4-0,4,0,1,1,4,4,H
1901-10-12,1901,Sheffield United,Sunderland,0-1,0,1,1,1,1,-1,A
1901-10-12,1901,Wolverhampton Wanderers,Notts County,3-1,3,1,1,1,4,2,H
1901-10-19,1901,Birmingham City,Sheffield United,5-1,5,1,1,1,6,4,H
1901-10-19,1901,Bolton Wanderers,Wolverhampton Wanderers,2-2,2,2,1,1,4,0,D
1901-10-19,1901,Derby County,Aston Villa,1-0,1,0,1,1,1,1,H
1901-10-19,1901,Everton,Bury,1-1,1,1,1,1,2,0,D
1901-10-19,1901,Manchester City,Grimsby Town,3-0,3,0,1,1,3,3,H
1901-10-19,1901,Notts County,Liverpool,2-2,2,2,1,1,4,0,D
1901-10-19,1901,Sheffield Wednesday,Newcastle United,0-0,0,0,1,1,0,0,D
1901-10-19,1901,Stoke City,Blackburn Rovers,2-2,2,2,1,1,4,0,D
1901-10-19,1901,Sunderland,Nottingham Forest,4-0,4,0,1,1,4,4,H
1901-10-26,1901,Aston Villa,Sheffield Wednesday,4-1,4,1,1,1,5,3,H
1901-10-26,1901,Blackburn Rovers,Everton,3-1,3,1,1,1,4,2,H
1901-10-26,1901,Bury,Sunderland,1-0,1,0,1,1,1,1,H
1901-10-26,1901,Grimsby Town,Stoke City,1-2,1,2,1,1,3,-1,A
1901-10-26,1901,Liverpool,Bolton Wanderers,1-1,1,1,1,1,2,0,D
1901-10-26,1901,Newcastle United,Notts County,8-0,8,0,1,1,8,8,H
1901-10-26,1901,Nottingham Forest,Birmingham City,1-1,1,1,1,1,2,0,D
1901-10-26,1901,Sheffield United,Derby County,3-0,3,0,1,1,3,3,H
1901-10-26,1901,Wolverhampton Wanderers,Manchester City,0-0,0,0,1,1,0,0,D
1901-11-02,1901,Birmingham City,Bury,1-0,1,0,1,1,1,1,H
1901-11-02,1901,Bolton Wanderers,Newcastle United,3-1,3,1,1,1,4,2,H
1901-11-02,1901,Derby County,Nottingham Forest,1-1,1,1,1,1,2,0,D
1901-11-02,1901,Everton,Stoke City,1-0,1,0,1,1,1,1,H
1901-11-02,1901,Manchester City,Liverpool,2-3,2,3,1,1,5,-1,A
1901-11-02,1901,Notts County,Aston Villa,0-3,0,3,1,1,3,-3,A
1901-11-02,1901,Sheffield Wednesday,Sheffield United,1-0,1,0,1,1,1,1,H
1901-11-02,1901,Sunderland,Blackburn Rovers,3-2,3,2,1,1,5,1,H
1901-11-02,1901,Wolverhampton Wanderers,Grimsby Town,2-0,2,0,1,1,2,2,H
1901-11-09,1901,Aston Villa,Bolton Wanderers,1-0,1,0,1,1,1,1,H
1901-11-09,1901,Blackburn Rovers,Birmingham City,3-1,3,1,1,1,4,2,H
1901-11-09,1901,Bury,Derby County,2-0,2,0,1,1,2,2,H
1901-11-09,1901,Grimsby Town,Everton,0-2,0,2,1,1,2,-2,A
1901-11-09,1901,Liverpool,Wolverhampton Wanderers,4-1,4,1,1,1,5,3,H
1901-11-09,1901,Newcastle United,Manchester City,3-0,3,0,1,1,3,3,H
1901-11-09,1901,Nottingham Forest,Sheffield Wednesday,1-1,1,1,1,1,2,0,D
1901-11-09,1901,Sheffield United,Notts County,3-0,3,0,1,1,3,3,H
1901-11-09,1901,Stoke City,Sunderland,3-0,3,0,1,1,3,3,H
1901-11-11,1901,Stoke City,Wolverhampton Wanderers,3-0,3,0,1,1,3,3,H
1901-11-16,1901,Derby County,Blackburn Rovers,1-1,1,1,1,1,2,0,D
1901-11-16,1901,Notts County,Nottingham Forest,3-0,3,0,1,1,3,3,H
1901-11-16,1901,Sheffield Wednesday,Bury,4-1,4,1,1,1,5,3,H
1901-11-16,1901,Sunderland,Everton,2-4,2,4,1,1,6,-2,A
1901-11-23,1901,Aston Villa,Wolverhampton Wanderers,2-1,2,1,1,1,3,1,H
1901-11-23,1901,Blackburn Rovers,Sheffield Wednesday,2-0,2,0,1,1,2,2,H
1901-11-23,1901,Bury,Notts County,3-0,3,0,1,1,3,3,H
1901-11-23,1901,Everton,Birmingham City,1-0,1,0,1,1,1,1,H
1901-11-23,1901,Grimsby Town,Sunderland,3-3,3,3,1,1,6,0,D
1901-11-23,1901,Newcastle United,Liverpool,1-0,1,0,1,1,1,1,H
1901-11-23,1901,Nottingham Forest,Bolton Wanderers,4-1,4,1,1,1,5,3,H
1901-11-23,1901,Sheffield United,Manchester City,5-0,5,0,1,1,5,5,H
1901-11-23,1901,Stoke City,Derby County,1-1,1,1,1,1,2,0,D
1901-11-30,1901,Birmingham City,Sunderland,2-3,2,3,1,1,5,-1,A
1901-11-30,1901,Bolton Wanderers,Bury,2-2,2,2,1,1,4,0,D
1901-11-30,1901,Derby County,Everton,3-1,3,1,1,1,4,2,H
1901-11-30,1901,Liverpool,Aston Villa,1-0,1,0,1,1,1,1,H
1901-11-30,1901,Manchester City,Nottingham Forest,3-1,3,1,1,1,4,2,H
1901-11-30,1901,Newcastle United,Grimsby Town,5-1,5,1,1,1,6,4,H
1901-11-30,1901,Notts County,Blackburn Rovers,3-0,3,0,1,1,3,3,H
1901-11-30,1901,Sheffield Wednesday,Stoke City,3-1,3,1,1,1,4,2,H
1901-11-30,1901,Wolverhampton Wanderers,Sheffield United,1-1,1,1,1,1,2,0,D
1901-12-07,1901,Aston Villa,Newcastle United,0-0,0,0,1,1,0,0,D
1901-12-07,1901,Blackburn Rovers,Bolton Wanderers,2-0,2,0,1,1,2,2,H
1901-12-07,1901,Bury,Manchester City,3-0,3,0,1,1,3,3,H
1901-12-07,1901,Everton,Sheffield Wednesday,5-0,5,0,1,1,5,5,H
1901-12-07,1901,Grimsby Town,Birmingham City,1-0,1,0,1,1,1,1,H
1901-12-07,1901,Nottingham Forest,Wolverhampton Wanderers,2-0,2,0,1,1,2,2,H
1901-12-07,1901,Sheffield United,Liverpool,2-1,2,1,1,1,3,1,H
1901-12-07,1901,Stoke City,Notts County,3-0,3,0,1,1,3,3,H
1901-12-14,1901,Aston Villa,Grimsby Town,4-1,4,1,1,1,5,3,H
1901-12-14,1901,Bolton Wanderers,Stoke City,2-1,2,1,1,1,3,1,H
1901-12-14,1901,Liverpool,Nottingham Forest,0-2,0,2,1,1,2,-2,A
1901-12-14,1901,Manchester City,Blackburn Rovers,1-1,1,1,1,1,2,0,D
1901-12-14,1901,Newcastle United,Sheffield United,1-1,1,1,1,1,2,0,D
1901-12-14,1901,Notts County,Everton,0-2,0,2,1,1,2,-2,A
1901-12-14,1901,Sheffield Wednesday,Sunderland,1-1,1,1,1,1,2,0,D
1901-12-14,1901,Wolverhampton Wanderers,Bury,1-0,1,0,1,1,1,1,H
1901-12-21,1901,Birmingham City,Sheffield Wednesday,1-1,1,1,1,1,2,0,D
1901-12-21,1901,Blackburn Rovers,Wolverhampton Wanderers,2-0,2,0,1,1,2,2,H
1901-12-21,1901,Everton,Bolton Wanderers,1-0,1,0,1,1,1,1,H
1901-12-21,1901,Sunderland,Notts County,2-1,2,1,1,1,3,1,H
1901-12-25,1901,Blackburn Rovers,Grimsby Town,2-0,2,0,1,1,2,2,H
1901-12-25,1901,Derby County,Wolverhampton Wanderers,3-1,3,1,1,1,4,2,H
1901-12-25,1901,Everton,Aston Villa,2-3,2,3,1,1,5,-1,A
1901-12-26,1901,Aston Villa,Birmingham City,1-0,1,0,1,1,1,1,H
1901-12-26,1901,Derby County,Newcastle United,1-0,1,0,1,1,1,1,H
1901-12-26,1901,Liverpool,Sunderland,0-1,0,1,1,1,1,-1,A
1901-12-26,1901,Nottingham Forest,Notts County,1-0,1,0,1,1,1,1,H
1901-12-26,1901,Sheffield Wednesday,Manchester City,2-1,2,1,1,1,3,1,H
1901-12-26,1901,Stoke City,Sheffield United,3-2,3,2,1,1,5,1,H
1901-12-26,1901,Wolverhampton Wanderers,Everton,2-1,2,1,1,1,3,1,H
1901-12-28,1901,Aston Villa,Nottingham Forest,3-0,3,0,1,1,3,3,H
1901-12-28,1901,Bolton Wanderers,Sunderland,0-0,0,0,1,1,0,0,D
1901-12-28,1901,Grimsby Town,Sheffield United,0-1,0,1,1,1,1,-1,A
1901-12-28,1901,Liverpool,Blackburn Rovers,1-0,1,0,1,1,1,1,H
1901-12-28,1901,Newcastle United,Bury,1-1,1,1,1,1,2,0,D
1901-12-28,1901,Notts County,Birmingham City,6-1,6,1,1,1,7,5,H
1901-12-28,1901,Wolverhampton Wanderers,Stoke City,4-1,4,1,1,1,5,3,H
1902-01-01,1901,Blackburn Rovers,Nottingham Forest,1-0,1,0,1,1,1,1,H
1902-01-01,1901,Bolton Wanderers,Manchester City,3-3,3,3,1,1,6,0,D
1902-01-01,1901,Bury,Grimsby Town,1-1,1,1,1,1,2,0,D
1902-01-01,1901,Sheffield United,Aston Villa,6-0,6,0,1,1,6,6,H
1902-01-01,1901,Sunderland,Derby County,1-0,1,0,1,1,1,1,H
1902-01-02,1901,Bolton Wanderers,Nottingham Forest,3-0,3,0,1,1,3,3,H
1902-01-04,1901,Aston Villa,Bury,2-0,2,0,1,1,2,2,H
1902-01-04,1901,Bolton Wanderers,Birmingham City,4-0,4,0,1,1,4,4,H
1902-01-04,1901,Grimsby Town,Sheffield Wednesday,3-1,3,1,1,1,4,2,H
1902-01-04,1901,Liverpool,Stoke City,7-0,7,0,1,1,7,7,H
1902-01-04,1901,Manchester City,Sunderland,0-3,0,3,1,1,3,-3,A
1902-01-04,1901,Newcastle United,Blackburn Rovers,0-3,0,3,1,1,3,-3,A
1902-01-04,1901,Notts County,Derby County,3-2,3,2,1,1,5,1,H
1902-01-04,1901,Sheffield United,Nottingham Forest,2-2,2,2,1,1,4,0,D
1902-01-11,1901,Birmingham City,Manchester City,1-0,1,0,1,1,1,1,H
1902-01-11,1901,Blackburn Rovers,Aston Villa,4-0,4,0,1,1,4,4,H
1902-01-11,1901,Bury,Sheffield United,1-2,1,2,1,1,3,-1,A
1902-01-11,1901,Derby County,Bolton Wanderers,1-2,1,2,1,1,3,-1,A
1902-01-11,1901,Everton,Liverpool,4-0,4,0,1,1,4,4,H
1902-01-11,1901,Nottingham Forest,Grimsby Town,0-1,0,1,1,1,1,-1,A
1902-01-11,1901,Sheffield Wednesday,Notts County,4-0,4,0,1,1,4,4,H
1902-01-11,1901,Stoke City,Newcastle United,0-0,0,0,1,1,0,0,D
1902-01-11,1901,Sunderland,Wolverhampton Wanderers,2-0,2,0,1,1,2,2,H
1902-01-13,1901,Stoke City,Manchester City,3-0,3,0,1,1,3,3,H
1902-01-18,1901,Aston Villa,Stoke City,0-0,0,0,1,1,0,0,D
1902-01-18,1901,Bolton Wanderers,Sheffield Wednesday,3-1,3,1,1,1,4,2,H
1902-01-18,1901,Grimsby Town,Notts County,1-0,1,0,1,1,1,1,H
1902-01-18,1901,Manchester City,Derby County,0-0,0,0,1,1,0,0,D
1902-01-18,1901,Newcastle United,Everton,1-1,1,1,1,1,2,0,D
1902-01-18,1901,Nottingham Forest,Bury,2-1,2,1,1,1,3,1,H
1902-01-18,1901,Sheffield United,Blackburn Rovers,4-1,4,1,1,1,5,3,H
1902-01-18,1901,Wolverhampton Wanderers,Birmingham City,2-1,2,1,1,1,3,1,H
1902-02-01,1901,Aston Villa,Sunderland,0-1,0,1,1,1,1,-1,A
1902-02-01,1901,Bury,Liverpool,0-0,0,0,1,1,0,0,D
1902-02-01,1901,Grimsby Town,Bolton Wanderers,4-1,4,1,1,1,5,3,H
1902-02-01,1901,Manchester City,Notts County,1-0,1,0,1,1,1,1,H
1902-02-01,1901,Newcastle United,Birmingham City,2-0,2,0,1,1,2,2,H
1902-02-01,1901,Nottingham Forest,Stoke City,2-0,2,0,1,1,2,2,H
1902-02-01,1901,Sheffield United,Everton,0-0,0,0,1,1,0,0,D
1902-02-01,1901,Wolverhampton Wanderers,Sheffield Wednesday,1-0,1,0,1,1,1,1,H
1902-02-11,1901,Sheffield United,Grimsby Town,2-2,2,2,1,1,4,0,D
1902-02-15,1901,Aston Villa,Derby County,3-2,3,2,1,1,5,1,H
1902-02-15,1901,Blackburn Rovers,Stoke City,6-1,6,1,1,1,7,5,H
1902-02-15,1901,Bury,Everton,1-0,1,0,1,1,1,1,H
1902-02-15,1901,Grimsby Town,Manchester City,3-2,3,2,1,1,5,1,H
1902-02-15,1901,Liverpool,Notts County,0-1,0,1,1,1,1,-1,A
1902-02-15,1901,Newcastle United,Sheffield Wednesday,2-1,2,1,1,1,3,1,H
1902-02-15,1901,Nottingham Forest,Sunderland,2-1,2,1,1,1,3,1,H
1902-02-15,1901,Sheffield United,Birmingham City,1-4,1,4,1,1,5,-3,A
1902-02-15,1901,Wolverhampton Wanderers,Bolton Wanderers,1-2,1,2,1,1,3,-1,A
1902-02-17,1901,Birmingham City,Stoke City,1-1,1,1,1,1,2,0,D
1902-02-17,1901,Manchester City,Aston Villa,1-0,1,0,1,1,1,1,H
1902-02-22,1901,Birmingham City,Grimsby Town,6-0,6,0,1,1,6,6,H
1902-02-22,1901,Bolton Wanderers,Liverpool,1-0,1,0,1,1,1,1,H
1902-02-22,1901,Everton,Blackburn Rovers,0-2,0,2,1,1,2,-2,A
1902-02-22,1901,Manchester City,Wolverhampton Wanderers,3-0,3,0,1,1,3,3,H
1902-02-22,1901,Sheffield Wednesday,Aston Villa,1-0,1,0,1,1,1,1,H
1902-03-01,1901,Blackburn Rovers,Sunderland,0-1,0,1,1,1,1,-1,A
1902-03-01,1901,Bury,Birmingham City,2-0,2,0,1,1,2,2,H
1902-03-01,1901,Grimsby Town,Wolverhampton Wanderers,3-0,3,0,1,1,3,3,H
1902-03-01,1901,Liverpool,Manchester City,4-0,4,0,1,1,4,4,H
1902-03-01,1901,Newcastle United,Bolton Wanderers,4-1,4,1,1,1,5,3,H
1902-03-01,1901,Nottingham Forest,Derby County,3-1,3,1,1,1,4,2,H
1902-03-01,1901,Sheffield United,Sheffield Wednesday,3-0,3,0,1,1,3,3,H
1902-03-01,1901,Stoke City,Everton,1-2,1,2,1,1,3,-1,A
1902-03-08,1901,Birmingham City,Blackburn Rovers,2-0,2,0,1,1,2,2,H
1902-03-08,1901,Bolton Wanderers,Aston Villa,2-2,2,2,1,1,4,0,D
1902-03-08,1901,Derby County,Bury,1-0,1,0,1,1,1,1,H
1902-03-08,1901,Everton,Grimsby Town,0-1,0,1,1,1,1,-1,A
1902-03-08,1901,Manchester City,Newcastle United,2-0,2,0,1,1,2,2,H
1902-03-08,1901,Notts County,Sheffield United,4-0,4,0,1,1,4,4,H
1902-03-08,1901,Sheffield Wednesday,Nottingham Forest,0-2,0,2,1,1,2,-2,A
1902-03-08,1901,Sunderland,Stoke City,2-0,2,0,1,1,2,2,H
1902-03-08,1901,Wolverhampton Wanderers,Liverpool,3-1,3,1,1,1,4,2,H
1902-03-10,1901,Wolverhampton Wanderers,Newcastle United,3-0,3,0,1,1,3,3,H
1902-03-15,1901,Bury,Sheffield Wednesday,2-0,2,0,1,1,2,2,H
1902-03-15,1901,Everton,Sunderland,2-0,2,0,1,1,2,2,H
1902-03-15,1901,Grimsby Town,Liverpool,1-1,1,1,1,1,2,0,D
1902-03-15,1901,Newcastle United,Wolverhampton Wanderers,3-1,3,1,1,1,4,2,H
1902-03-15,1901,Stoke City,Birmingham City,1-0,1,0,1,1,1,1,H
1902-03-17,1901,Manchester City,Everton,2-0,2,0,1,1,2,2,H
1902-03-17,1901,Sheffield Wednesday,Derby County,2-0,2,0,1,1,2,2,H
1902-03-19,1901,Nottingham Forest,Newcastle United,0-2,0,2,1,1,2,-2,A
1902-03-22,1901,Birmingham City,Everton,0-1,0,1,1,1,1,-1,A
1902-03-22,1901,Derby County,Stoke City,1-0,1,0,1,1,1,1,H
1902-03-22,1901,Liverpool,Newcastle United,0-1,0,1,1,1,1,-1,A
1902-03-22,1901,Manchester City,Sheffield United,4-0,4,0,1,1,4,4,H
1902-03-22,1901,Notts County,Bury,2-1,2,1,1,1,3,1,H
1902-03-22,1901,Sheffield Wednesday,Blackburn Rovers,0-1,0,1,1,1,1,-1,A
1902-03-22,1901,Sunderland,Grimsby Town,3-1,3,1,1,1,4,2,H
1902-03-22,1901,Wolverhampton Wanderers,Aston Villa,0-2,0,2,1,1,2,-2,A
1902-03-28,1901,Bolton Wanderers,Sheffield United,1-0,1,0,1,1,1,1,H
1902-03-28,1901,Bury,Blackburn Rovers,2-0,2,0,1,1,2,2,H
1902-03-28,1901,Grimsby Town,Newcastle United,3-0,3,0,1,1,3,3,H
1902-03-28,1901,Manchester City,Sheffield Wednesday,0-3,0,3,1,1,3,-3,A
1902-03-28,1901,Notts County,Wolverhampton Wanderers,5-3,5,3,1,1,8,2,H
1902-03-29,1901,Aston Villa,Liverpool,0-1,0,1,1,1,1,-1,A
1902-03-29,1901,Blackburn Rovers,Notts County,4-2,4,2,1,1,6,2,H
1902-03-29,1901,Bury,Bolton Wanderers,2-2,2,2,1,1,4,0,D
1902-03-29,1901,Everton,Derby County,2-0,2,0,1,1,2,2,H
1902-03-29,1901,Nottingham Forest,Manchester City,3-1,3,1,1,1,4,2,H
1902-03-29,1901,Sheffield United,Wolverhampton Wanderers,0-0,0,0,1,1,0,0,D
1902-03-29,1901,Stoke City,Sheffield Wednesday,1-2,1,2,1,1,3,-1,A
1902-03-29,1901,Sunderland,Birmingham City,1-1,1,1,1,1,2,0,D
1902-03-31,1901,Aston Villa,Manchester City,2-2,2,2,1,1,4,0,D
1902-03-31,1901,Derby County,Birmingham City,0-0,0,0,1,1,0,0,D
1902-03-31,1901,Everton,Nottingham Forest,1-0,1,0,1,1,1,1,H
1902-03-31,1901,Notts County,Bolton Wanderers,2-1,2,1,1,1,3,1,H
1902-03-31,1901,Sunderland,Newcastle United,0-0,0,0,1,1,0,0,D
1902-03-31,1901,Wolverhampton Wanderers,Blackburn Rovers,3-1,3,1,1,1,4,2,H
1902-04-01,1901,Derby County,Grimsby Town,2-0,2,0,1,1,2,2,H
1902-04-01,1901,Nottingham Forest,Aston Villa,1-1,1,1,1,1,2,0,D
1902-04-01,1901,Sheffield Wednesday,Liverpool,1-1,1,1,1,1,2,0,D
1902-04-05,1901,Birmingham City,Nottingham Forest,1-1,1,1,1,1,2,0,D
1902-04-05,1901,Bolton Wanderers,Blackburn Rovers,4-0,4,0,1,1,4,4,H
1902-04-05,1901,Derby County,Sunderland,1-0,1,0,1,1,1,1,H
1902-04-05,1901,Liverpool,Sheffield United,1-0,1,0,1,1,1,1,H
1902-04-05,1901,Manchester City,Bury,2-0,2,0,1,1,2,2,H
1902-04-05,1901,Newcastle United,Aston Villa,2-1,2,1,1,1,3,1,H
1902-04-05,1901,Notts County,Stoke City,1-1,1,1,1,1,2,0,D
1902-04-05,1901,Sheffield Wednesday,Everton,1-1,1,1,1,1,2,0,D
1902-04-07,1901,Sheffield United,Bolton Wanderers,2-0,2,0,1,1,2,2,H
1902-04-12,1901,Birmingham City,Derby County,5-1,5,1,1,1,6,4,H
1902-04-12,1901,Blackburn Rovers,Manchester City,1-4,1,4,1,1,5,-3,A
1902-04-12,1901,Bury,Wolverhampton Wanderers,2-1,2,1,1,1,3,1,H
1902-04-12,1901,Everton,Notts County,0-1,0,1,1,1,1,-1,A
1902-04-12,1901,Grimsby Town,Aston Villa,4-1,4,1,1,1,5,3,H
1902-04-12,1901,Nottingham Forest,Liverpool,1-1,1,1,1,1,2,0,D
1902-04-12,1901,Sheffield United,Newcastle United,1-0,1,0,1,1,1,1,H
1902-04-12,1901,Stoke City,Bolton Wanderers,4-0,4,0,1,1,4,4,H
1902-04-12,1901,Sunderland,Sheffield Wednesday,1-2,1,2,1,1,3,-1,A
1902-04-14,1901,Liverpool,Derby County,0-2,0,2,1,1,2,-2,A
1902-04-14,1901,Stoke City,Grimsby Town,2-0,2,0,1,1,2,2,H
1902-04-16,1901,Sunderland,Bury,3-0,3,0,1,1,3,3,H
1902-04-19,1901,Blackburn Rovers,Derby County,3-1,3,1,1,1,4,2,H
1902-04-19,1901,Bolton Wanderers,Everton,1-3,1,3,1,1,4,-2,A
1902-04-19,1901,Liverpool,Bury,1-0,1,0,1,1,1,1,H
1902-04-19,1901,Manchester City,Stoke City,2-2,2,2,1,1,4,0,D
1902-04-19,1901,Newcastle United,Nottingham Forest,3-0,3,0,1,1,3,3,H
1902-04-19,1901,Notts County,Sunderland,2-0,2,0,1,1,2,2,H
1902-04-19,1901,Sheffield Wednesday,Birmingham City,1-2,1,2,1,1,3,-1,A
1902-04-21,1901,Liverpool,Grimsby Town,2-2,2,2,1,1,4,0,D
1902-04-26,1901,Birmingham City,Notts County,0-0,0,0,1,1,0,0,D
1902-04-26,1901,Blackburn Rovers,Liverpool,1-1,1,1,1,1,2,0,D
1902-04-26,1901,Bury,Newcastle United,4-0,4,0,1,1,4,4,H
1902-04-26,1901,Derby County,Sheffield Wednesday,2-2,2,2,1,1,4,0,D
1902-04-26,1901,Sunderland,Bolton Wanderers,2-1,2,1,1,1,3,1,H
1902-04-28,1901,Derby County,Sheffield United,3-1,3,1,1,1,4,2,H
1902-09-01,1902,Blackburn Rovers,Middlesbrough,0-1,0,1,1,1,1,-1,A
1902-09-01,1902,Sheffield United,Sheffield Wednesday,2-3,2,3,1,1,5,-1,A
1902-09-01,1902,Sunderland,Nottingham Forest,0-1,0,1,1,1,1,-1,A
1902-09-01,1902,West Bromwich Albion,Everton,2-1,2,1,1,1,3,1,H
1902-09-01,1902,Wolverhampton Wanderers,Derby County,3-0,3,0,1,1,3,3,H
1902-09-06,1902,Aston Villa,Derby County,0-0,0,0,1,1,0,0,D
1902-09-06,1902,Bolton Wanderers,Sheffield Wednesday,0-2,0,2,1,1,2,-2,A
1902-09-06,1902,Liverpool,Blackburn Rovers,5-2,5,2,1,1,7,3,H
1902-09-06,1902,Middlesbrough,Everton,1-0,1,0,1,1,1,1,H
1902-09-06,1902,Newcastle United,Stoke City,5-0,5,0,1,1,5,5,H
1902-09-06,1902,Notts County,West Bromwich Albion,3-1,3,1,1,1,4,2,H
1902-09-06,1902,Sheffield United,Bury,1-0,1,0,1,1,1,1,H
1902-09-06,1902,Wolverhampton Wanderers,Sunderland,3-3,3,3,1,1,6,0,D
1902-09-09,1902,Grimsby Town,Nottingham Forest,0-1,0,1,1,1,1,-1,A
1902-09-13,1902,Blackburn Rovers,Sheffield United,2-0,2,0,1,1,2,2,H
1902-09-13,1902,Bury,Grimsby Town,2-1,2,1,1,1,3,1,H
1902-09-13,1902,Derby County,Notts County,4-1,4,1,1,1,5,3,H
1902-09-13,1902,Everton,Newcastle United,0-1,0,1,1,1,1,-1,A
1902-09-13,1902,Nottingham Forest,Aston Villa,2-0,2,0,1,1,2,2,H
1902-09-13,1902,Sheffield Wednesday,Middlesbrough,2-0,2,0,1,1,2,2,H
1902-09-13,1902,Stoke City,Wolverhampton Wanderers,3-0,3,0,1,1,3,3,H
1902-09-13,1902,Sunderland,Liverpool,2-1,2,1,1,1,3,1,H
1902-09-13,1902,West Bromwich Albion,Bolton Wanderers,2-1,2,1,1,1,3,1,H
1902-09-15,1902,Stoke City,Notts County,0-2,0,2,1,1,2,-2,A
1902-09-20,1902,Aston Villa,Bury,2-2,2,2,1,1,4,0,D
1902-09-20,1902,Bolton Wanderers,Notts County,0-1,0,1,1,1,1,-1,A
1902-09-20,1902,Grimsby Town,Blackburn Rovers,4-1,4,1,1,1,5,3,H
1902-09-20,1902,Liverpool,Stoke City,1-1,1,1,1,1,2,0,D
1902-09-20,1902,Middlesbrough,West Bromwich Albion,1-1,1,1,1,1,2,0,D
1902-09-20,1902,Newcastle United,Sheffield Wednesday,3-0,3,0,1,1,3,3,H
1902-09-20,1902,Nottingham Forest,Derby County,2-3,2,3,1,1,5,-1,A
1902-09-20,1902,Sheffield United,Sunderland,1-0,1,0,1,1,1,1,H
1902-09-20,1902,Wolverhampton Wanderers,Everton,1-1,1,1,1,1,2,0,D
1902-09-27,1902,Blackburn Rovers,Aston Villa,0-2,0,2,1,1,2,-2,A
1902-09-27,1902,Bury,Nottingham Forest,3-1,3,1,1,1,4,2,H
1902-09-27,1902,Derby County,Bolton Wanderers,5-0,5,0,1,1,5,5,H
1902-09-27,1902,Everton,Liverpool,3-1,3,1,1,1,4,2,H
1902-09-27,1902,Notts County,Middlesbrough,2-0,2,0,1,1,2,2,H
1902-09-27,1902,Sheffield Wednesday,Wolverhampton Wanderers,1-1,1,1,1,1,2,0,D
1902-09-27,1902,Stoke City,Sheffield United,0-1,0,1,1,1,1,-1,A
1902-09-27,1902,Sunderland,Grimsby Town,5-1,5,1,1,1,6,4,H
1902-09-27,1902,West Bromwich Albion,Newcastle United,6-1,6,1,1,1,7,5,H
1902-10-02,1902,Nottingham Forest,Everton,2-2,2,2,1,1,4,0,D
1902-10-03,1902,Notts County,Sheffield Wednesday,0-3,0,3,1,1,3,-3,A
1902-10-04,1902,Aston Villa,Sunderland,0-1,0,1,1,1,1,-1,A
1902-10-04,1902,Bury,Derby County,1-0,1,0,1,1,1,1,H
1902-10-04,1902,Grimsby Town,Stoke City,2-2,2,2,1,1,4,0,D
1902-10-04,1902,Liverpool,Sheffield Wednesday,4-2,4,2,1,1,6,2,H
1902-10-04,1902,Middlesbrough,Bolton Wanderers,4-3,4,3,1,1,7,1,H
1902-10-04,1902,Newcastle United,Notts County,6-1,6,1,1,1,7,5,H
1902-10-04,1902,Nottingham Forest,Blackburn Rovers,2-0,2,0,1,1,2,2,H
1902-10-04,1902,Sheffield United,Everton,0-2,0,2,1,1,2,-2,A
1902-10-04,1902,Wolverhampton Wanderers,West Bromwich Albion,1-2,1,2,1,1,3,-1,A
1902-10-11,1902,Blackburn Rovers,Bury,0-3,0,3,1,1,3,-3,A
1902-10-11,1902,Bolton Wanderers,Newcastle United,0-2,0,2,1,1,2,-2,A
1902-10-11,1902,Derby County,Middlesbrough,3-2,3,2,1,1,5,1,H
1902-10-11,1902,Everton,Grimsby Town,4-2,4,2,1,1,6,2,H
1902-10-11,1902,Notts County,Wolverhampton Wanderers,0-0,0,0,1,1,0,0,D
1902-10-11,1902,Sheffield Wednesday,Sheffield United,0-1,0,1,1,1,1,-1,A
1902-10-11,1902,Stoke City,Aston Villa,1-0,1,0,1,1,1,1,H
1902-10-11,1902,West Bromwich Albion,Liverpool,1-2,1,2,1,1,3,-1,A
1902-10-13,1902,Sheffield United,Nottingham Forest,2-0,2,0,1,1,2,2,H
1902-10-18,1902,Aston Villa,Everton,2-1,2,1,1,1,3,1,H
1902-10-18,1902,Blackburn Rovers,Derby County,2-4,2,4,1,1,6,-2,A
1902-10-18,1902,Bury,Sunderland,3-1,3,1,1,1,4,2,H
1902-10-18,1902,Grimsby Town,Sheffield Wednesday,0-1,0,1,1,1,1,-1,A
1902-10-18,1902,Liverpool,Notts County,0-2,0,2,1,1,2,-2,A
1902-10-18,1902,Newcastle United,Middlesbrough,0-1,0,1,1,1,1,-1,A
1902-10-18,1902,Nottingham Forest,Stoke City,1-3,1,3,1,1,4,-2,A
1902-10-18,1902,Sheffield United,West Bromwich Albion,1-2,1,2,1,1,3,-1,A
1902-10-18,1902,Wolverhampton Wanderers,Bolton Wanderers,3-1,3,1,1,1,4,2,H
1902-10-25,1902,Bolton Wanderers,Liverpool,1-1,1,1,1,1,2,0,D
1902-10-25,1902,Derby County,Newcastle United,0-0,0,0,1,1,0,0,D
1902-10-25,1902,Everton,Nottingham Forest,1-1,1,1,1,1,2,0,D
1902-10-25,1902,Middlesbrough,Wolverhampton Wanderers,2-0,2,0,1,1,2,2,H
1902-10-25,1902,Notts County,Sheffield United,1-1,1,1,1,1,2,0,D
1902-10-25,1902,Stoke City,Bury,1-0,1,0,1,1,1,1,H
1902-10-25,1902,Sunderland,Blackburn Rovers,2-2,2,2,1,1,4,0,D
1902-10-25,1902,West Bromwich Albion,Grimsby Town,1-0,1,0,1,1,1,1,H
1902-11-01,1902,Aston Villa,West Bromwich Albion,0-3,0,3,1,1,3,-3,A
1902-11-01,1902,Blackburn Rovers,Stoke City,1-1,1,1,1,1,2,0,D
1902-11-01,1902,Bolton Wanderers,Everton,1-3,1,3,1,1,4,-2,A
1902-11-01,1902,Derby County,Sunderland,5-2,5,2,1,1,7,3,H
1902-11-01,1902,Grimsby Town,Notts County,1-1,1,1,1,1,2,0,D
1902-11-01,1902,Liverpool,Middlesbrough,5-0,5,0,1,1,5,5,H
1902-11-01,1902,Nottingham Forest,Sheffield Wednesday,1-4,1,4,1,1,5,-3,A
1902-11-01,1902,Wolverhampton Wanderers,Newcastle United,3-0,3,0,1,1,3,3,H
1902-11-08,1902,Blackburn Rovers,Everton,3-2,3,2,1,1,5,1,H
1902-11-08,1902,Derby County,Wolverhampton Wanderers,3-1,3,1,1,1,4,2,H
1902-11-08,1902,Grimsby Town,Bolton Wanderers,1-1,1,1,1,1,2,0,D
1902-11-08,1902,Middlesbrough,Sheffield United,0-2,0,2,1,1,2,-2,A
1902-11-08,1902,Newcastle United,Liverpool,1-2,1,2,1,1,3,-1,A
1902-11-08,1902,Notts County,Aston Villa,2-1,2,1,1,1,3,1,H
1902-11-08,1902,Sheffield Wednesday,Bury,2-0,2,0,1,1,2,2,H
1902-11-08,1902,Stoke City,Sunderland,1-1,1,1,1,1,2,0,D
1902-11-08,1902,West Bromwich Albion,Nottingham Forest,2-0,2,0,1,1,2,2,H
1902-11-15,1902,Aston Villa,Bolton Wanderers,4-2,4,2,1,1,6,2,H
1902-11-15,1902,Blackburn Rovers,Sheffield Wednesday,2-1,2,1,1,1,3,1,H
1902-11-15,1902,Bury,West Bromwich Albion,1-2,1,2,1,1,3,-1,A
1902-11-15,1902,Grimsby Town,Middlesbrough,2-2,2,2,1,1,4,0,D
1902-11-15,1902,Liverpool,Wolverhampton Wanderers,4-1,4,1,1,1,5,3,H
1902-11-15,1902,Nottingham Forest,Notts County,0-0,0,0,1,1,0,0,D
1902-11-15,1902,Sheffield United,Newcastle United,2-1,2,1,1,1,3,1,H
1902-11-15,1902,Stoke City,Derby County,2-0,2,0,1,1,2,2,H
1902-11-15,1902,Sunderland,Everton,2-1,2,1,1,1,3,1,H
1902-11-22,1902,Bolton Wanderers,Nottingham Forest,1-1,1,1,1,1,2,0,D
1902-11-22,1902,Derby County,Liverpool,2-1,2,1,1,1,3,1,H
1902-11-22,1902,Everton,Stoke City,0-1,0,1,1,1,1,-1,A
1902-11-22,1902,Middlesbrough,Aston Villa,1-2,1,2,1,1,3,-1,A
1902-11-22,1902,Newcastle United,Grimsby Town,1-0,1,0,1,1,1,1,H
1902-11-22,1902,Notts County,Bury,1-0,1,0,1,1,1,1,H
1902-11-22,1902,Sheffield Wednesday,Sunderland,1-0,1,0,1,1,1,1,H
1902-11-22,1902,West Bromwich Albion,Blackburn Rovers,5-3,5,3,1,1,8,2,H
1902-11-22,1902,Wolverhampton Wanderers,Sheffield United,1-3,1,3,1,1,4,-2,A
1902-11-29,1902,Aston Villa,Newcastle United,7-0,7,0,1,1,7,7,H
1902-11-29,1902,Blackburn Rovers,Notts County,1-2,1,2,1,1,3,-1,A
1902-11-29,1902,Bury,Bolton Wanderers,3-0,3,0,1,1,3,3,H
1902-11-29,1902,Everton,Derby County,2-1,2,1,1,1,3,1,H
1902-11-29,1902,Grimsby Town,Wolverhampton Wanderers,1-2,1,2,1,1,3,-1,A
1902-11-29,1902,Nottingham Forest,Middlesbrough,1-0,1,0,1,1,1,1,H
1902-11-29,1902,Sheffield United,Liverpool,2-0,2,0,1,1,2,2,H
1902-11-29,1902,Stoke City,Sheffield Wednesday,4-0,4,0,1,1,4,4,H
1902-11-29,1902,Sunderland,West Bromwich Albion,0-0,0,0,1,1,0,0,D
1902-12-06,1902,Bolton Wanderers,Blackburn Rovers,1-2,1,2,1,1,3,-1,A
1902-12-06,1902,Derby County,Sheffield United,1-0,1,0,1,1,1,1,H
1902-12-06,1902,Liverpool,Grimsby Town,9-2,9,2,1,1,11,7,H
1902-12-06,1902,Middlesbrough,Bury,1-1,1,1,1,1,2,0,D
1902-12-06,1902,Newcastle United,Nottingham Forest,0-2,0,2,1,1,2,-2,A
1902-12-06,1902,Notts County,Sunderland,0-0,0,0,1,1,0,0,D
1902-12-06,1902,Sheffield Wednesday,Everton,4-1,4,1,1,1,5,3,H
1902-12-06,1902,West Bromwich Albion,Stoke City,2-1,2,1,1,1,3,1,H
1902-12-06,1902,Wolverhampton Wanderers,Aston Villa,2-1,2,1,1,1,3,1,H
1902-12-13,1902,Aston Villa,Liverpool,1-2,1,2,1,1,3,-1,A
1902-12-13,1902,Bury,Newcastle United,1-0,1,0,1,1,1,1,H
1902-12-13,1902,Everton,West Bromwich Albion,3-1,3,1,1,1,4,2,H
1902-12-13,1902,Grimsby Town,Sheffield United,1-2,1,2,1,1,3,-1,A
1902-12-13,1902,Nottingham Forest,Wolverhampton Wanderers,2-0,2,0,1,1,2,2,H
1902-12-13,1902,Sheffield Wednesday,Derby County,0-1,0,1,1,1,1,-1,A
1902-12-13,1902,Sunderland,Bolton Wanderers,3-1,3,1,1,1,4,2,H
1902-12-20,1902,Bolton Wanderers,Stoke City,2-3,2,3,1,1,5,-1,A
1902-12-20,1902,Grimsby Town,Derby County,4-1,4,1,1,1,5,3,H
1902-12-20,1902,Liverpool,Nottingham Forest,2-1,2,1,1,1,3,1,H
1902-12-20,1902,Middlesbrough,Sunderland,0-1,0,1,1,1,1,-1,A
1902-12-20,1902,Newcastle United,Blackburn Rovers,1-0,1,0,1,1,1,1,H
1902-12-20,1902,Notts County,Everton,2-0,2,0,1,1,2,2,H
1902-12-20,1902,Sheffield United,Aston Villa,2-4,2,4,1,1,6,-2,A
1902-12-20,1902,West Bromwich Albion,Sheffield Wednesday,2-3,2,3,1,1,5,-1,A
1902-12-20,1902,Wolverhampton Wanderers,Bury,3-2,3,2,1,1,5,1,H
1902-12-25,1902,Blackburn Rovers,Sunderland,0-2,0,2,1,1,2,-2,A
1902-12-25,1902,Bury,Stoke City,2-1,2,1,1,1,3,1,H
1902-12-25,1902,Grimsby Town,Everton,0-0,0,0,1,1,0,0,D
1902-12-25,1902,Liverpool,Bolton Wanderers,5-1,5,1,1,1,6,4,H
1902-12-26,1902,Aston Villa,Sheffield Wednesday,1-0,1,0,1,1,1,1,H
1902-12-26,1902,Notts County,Nottingham Forest,1-1,1,1,1,1,2,0,D
1902-12-26,1902,Sheffield United,Bolton Wanderers,7-1,7,1,1,1,8,6,H
1902-12-26,1902,Stoke City,Blackburn Rovers,0-2,0,2,1,1,2,-2,A
1902-12-26,1902,Wolverhampton Wanderers,Middlesbrough,2-0,2,0,1,1,2,2,H
1902-12-27,1902,Aston Villa,Grimsby Town,2-2,2,2,1,1,4,0,D
1902-12-27,1902,Bury,Liverpool,3-1,3,1,1,1,4,2,H
1902-12-27,1902,Derby County,West Bromwich Albion,1-0,1,0,1,1,1,1,H
1902-12-27,1902,Everton,Bolton Wanderers,3-1,3,1,1,1,4,2,H
1902-12-27,1902,Nottingham Forest,Sheffield United,2-2,2,2,1,1,4,0,D
1902-12-27,1902,Sheffield Wednesday,Notts County,2-0,2,0,1,1,2,2,H
1902-12-27,1902,Stoke City,Middlesbrough,0-2,0,2,1,1,2,-2,A
1902-12-27,1902,Sunderland,Newcastle United,0-0,0,0,1,1,0,0,D
1902-12-27,1902,Wolverhampton Wanderers,Blackburn Rovers,2-0,2,0,1,1,2,2,H
1903-01-01,1902,Blackburn Rovers,Wolverhampton Wanderers,1-0,1,0,1,1,1,1,H
1903-01-01,1902,Bury,Everton,4-2,4,2,1,1,6,2,H
1903-01-01,1902,Liverpool,West Bromwich Albion,0-2,0,2,1,1,2,-2,A
1903-01-01,1902,Sheffield Wednesday,Aston Villa,4-0,4,0,1,1,4,4,H
1903-01-01,1902,Sunderland,Derby County,2-0,2,0,1,1,2,2,H
1903-01-02,1902,Bolton Wanderers,Grimsby Town,0-1,0,1,1,1,1,-1,A
1903-01-03,1902,Blackburn Rovers,Liverpool,3-1,3,1,1,1,4,2,H
1903-01-03,1902,Bury,Sheffield United,3-1,3,1,1,1,4,2,H
1903-01-03,1902,Derby County,Aston Villa,2-0,2,0,1,1,2,2,H
1903-01-03,1902,Everton,Middlesbrough,3-0,3,0,1,1,3,3,H
1903-01-03,1902,Nottingham Forest,Grimsby Town,2-1,2,1,1,1,3,1,H
1903-01-03,1902,Sheffield Wednesday,Bolton Wanderers,3-0,3,0,1,1,3,3,H
1903-01-03,1902,Stoke City,Newcastle United,5-0,5,0,1,1,5,5,H
1903-01-03,1902,Sunderland,Wolverhampton Wanderers,3-0,3,0,1,1,3,3,H
1903-01-03,1902,West Bromwich Albion,Notts County,3-2,3,2,1,1,5,1,H
1903-01-10,1902,Aston Villa,Nottingham Forest,3-1,3,1,1,1,4,2,H
1903-01-10,1902,Bolton Wanderers,West Bromwich Albion,0-1,0,1,1,1,1,-1,A
1903-01-10,1902,Grimsby Town,Bury,2-1,2,1,1,1,3,1,H
1903-01-10,1902,Middlesbrough,Sheffield Wednesday,2-1,2,1,1,1,3,1,H
1903-01-10,1902,Notts County,Derby County,2-1,2,1,1,1,3,1,H
1903-01-10,1902,Sheffield United,Blackburn Rovers,2-1,2,1,1,1,3,1,H
1903-01-10,1902,Wolverhampton Wanderers,Stoke City,1-0,1,0,1,1,1,1,H
1903-01-17,1902,Blackburn Rovers,Grimsby Town,2-0,2,0,1,1,2,2,H
1903-01-17,1902,Bury,Aston Villa,0-1,0,1,1,1,1,-1,A
1903-01-17,1902,Derby County,Nottingham Forest,0-1,0,1,1,1,1,-1,A
1903-01-17,1902,Everton,Wolverhampton Wanderers,2-1,2,1,1,1,3,1,H
1903-01-17,1902,Notts County,Bolton Wanderers,1-3,1,3,1,1,4,-2,A
1903-01-17,1902,Sheffield Wednesday,Newcastle United,3-0,3,0,1,1,3,3,H
1903-01-17,1902,Stoke City,Liverpool,1-0,1,0,1,1,1,1,H
1903-01-17,1902,Sunderland,Sheffield United,0-0,0,0,1,1,0,0,D
1903-01-17,1902,West Bromwich Albion,Middlesbrough,1-0,1,0,1,1,1,1,H
1903-01-24,1902,Aston Villa,Blackburn Rovers,5-0,5,0,1,1,5,5,H
1903-01-24,1902,Bolton Wanderers,Derby County,2-0,2,0,1,1,2,2,H
1903-01-24,1902,Grimsby Town,Sunderland,2-4,2,4,1,1,6,-2,A
1903-01-24,1902,Middlesbrough,Notts County,2-1,2,1,1,1,3,1,H
1903-01-24,1902,Newcastle United,West Bromwich Albion,1-0,1,0,1,1,1,1,H
1903-01-24,1902,Nottingham Forest,Bury,3-0,3,0,1,1,3,3,H
1903-01-24,1902,Sheffield United,Stoke City,1-3,1,3,1,1,4,-2,A
1903-01-24,1902,Wolverhampton Wanderers,Sheffield Wednesday,2-1,2,1,1,1,3,1,H
1903-01-31,1902,Blackburn Rovers,Nottingham Forest,2-2,2,2,1,1,4,0,D
1903-01-31,1902,Bolton Wanderers,Middlesbrough,2-1,2,1,1,1,3,1,H
1903-01-31,1902,Derby County,Bury,2-0,2,0,1,1,2,2,H
1903-01-31,1902,Everton,Sheffield United,1-0,1,0,1,1,1,1,H
1903-01-31,1902,Notts County,Newcastle United,2-2,2,2,1,1,4,0,D
1903-01-31,1902,Sheffield Wednesday,Liverpool,3-1,3,1,1,1,4,2,H
1903-01-31,1902,Stoke City,Grimsby Town,1-1,1,1,1,1,2,0,D
1903-01-31,1902,Sunderland,Aston Villa,1-0,1,0,1,1,1,1,H
1903-01-31,1902,West Bromwich Albion,Wolverhampton Wanderers,2-2,2,2,1,1,4,0,D
1903-02-14,1902,Bolton Wanderers,Wolverhampton Wanderers,4-1,4,1,1,1,5,3,H
1903-02-14,1902,Derby County,Blackburn Rovers,1-0,1,0,1,1,1,1,H
1903-02-14,1902,Everton,Aston Villa,0-1,0,1,1,1,1,-1,A
1903-02-14,1902,Middlesbrough,Newcastle United,1-0,1,0,1,1,1,1,H
1903-02-14,1902,Notts County,Liverpool,1-2,1,2,1,1,3,-1,A
1903-02-14,1902,Sheffield Wednesday,Grimsby Town,1-1,1,1,1,1,2,0,D
1903-02-14,1902,Stoke City,Nottingham Forest,3-2,3,2,1,1,5,1,H
1903-02-14,1902,Sunderland,Bury,3-1,3,1,1,1,4,2,H
1903-02-14,1902,West Bromwich Albion,Sheffield United,3-3,3,3,1,1,6,0,D
1903-02-28,1902,Bolton Wanderers,Sheffield United,1-0,1,0,1,1,1,1,H
1903-02-28,1902,Everton,Bury,3-0,3,0,1,1,3,3,H
1903-02-28,1902,Middlesbrough,Liverpool,0-2,0,2,1,1,2,-2,A
1903-02-28,1902,Newcastle United,Wolverhampton Wanderers,2-4,2,4,1,1,6,-2,A
1903-02-28,1902,Notts County,Grimsby Town,0-1,0,1,1,1,1,-1,A
1903-02-28,1902,Sheffield Wednesday,Nottingham Forest,1-0,1,0,1,1,1,1,H
1903-02-28,1902,West Bromwich Albion,Aston Villa,1-2,1,2,1,1,3,-1,A
1903-03-07,1902,Liverpool,Newcastle United,3-0,3,0,1,1,3,3,H
1903-03-07,1902,Nottingham Forest,West Bromwich Albion,3-1,3,1,1,1,4,2,H
1903-03-07,1902,Sheffield United,Middlesbrough,1-3,1,3,1,1,4,-2,A
1903-03-14,1902,Bolton Wanderers,Aston Villa,0-1,0,1,1,1,1,-1,A
1903-03-14,1902,Derby County,Stoke City,2-0,2,0,1,1,2,2,H
1903-03-14,1902,Everton,Sunderland,0-3,0,3,1,1,3,-3,A
1903-03-14,1902,Middlesbrough,Grimsby Town,2-0,2,0,1,1,2,2,H
1903-03-14,1902,Newcastle United,Sheffield United,0-0,0,0,1,1,0,0,D
1903-03-14,1902,Sheffield Wednesday,Blackburn Rovers,0-0,0,0,1,1,0,0,D
1903-03-21,1902,Blackburn Rovers,West Bromwich Albion,1-0,1,0,1,1,1,1,H
1903-03-21,1902,Grimsby Town,Newcastle United,1-0,1,0,1,1,1,1,H
1903-03-21,1902,Nottingham Forest,Bolton Wanderers,1-2,1,2,1,1,3,-1,A
1903-03-21,1902,Sheffield United,Wolverhampton Wanderers,3-0,3,0,1,1,3,3,H
1903-03-21,1902,Stoke City,Everton,2-0,2,0,1,1,2,2,H
1903-03-21,1902,Sunderland,Sheffield Wednesday,0-1,0,1,1,1,1,-1,A
1903-03-23,1902,Liverpool,Derby County,3-1,3,1,1,1,4,2,H
1903-03-26,1902,Bury,Notts County,3-1,3,1,1,1,4,2,H
1903-03-28,1902,Bolton Wanderers,Bury,1-0,1,0,1,1,1,1,H
1903-03-28,1902,Derby County,Everton,0-1,0,1,1,1,1,-1,A
1903-03-28,1902,Liverpool,Sheffield United,2-4,2,4,1,1,6,-2,A
1903-03-28,1902,Middlesbrough,Nottingham Forest,2-0,2,0,1,1,2,2,H
1903-03-28,1902,Newcastle United,Aston Villa,2-0,2,0,1,1,2,2,H
1903-03-28,1902,Notts County,Blackburn Rovers,4-0,4,0,1,1,4,4,H
1903-03-28,1902,Sheffield Wednesday,Stoke City,1-0,1,0,1,1,1,1,H
1903-03-28,1902,West Bromwich Albion,Sunderland,0-3,0,3,1,1,3,-3,A
1903-03-28,1902,Wolverhampton Wanderers,Grimsby Town,3-0,3,0,1,1,3,3,H
1903-03-30,1902,Liverpool,Sunderland,1-1,1,1,1,1,2,0,D
1903-03-30,1902,Sheffield United,Derby County,3-2,3,2,1,1,5,1,H
1903-04-01,1902,Newcastle United,Everton,3-0,3,0,1,1,3,3,H
1903-04-04,1902,Aston Villa,Wolverhampton Wanderers,3-1,3,1,1,1,4,2,H
1903-04-04,1902,Blackburn Rovers,Bolton Wanderers,4-2,4,2,1,1,6,2,H
1903-04-04,1902,Bury,Middlesbrough,3-1,3,1,1,1,4,2,H
1903-04-04,1902,Everton,Sheffield Wednesday,1-1,1,1,1,1,2,0,D
1903-04-04,1902,Grimsby Town,Liverpool,3-1,3,1,1,1,4,2,H
1903-04-04,1902,Nottingham Forest,Newcastle United,3-2,3,2,1,1,5,1,H
1903-04-04,1902,Stoke City,West Bromwich Albion,3-0,3,0,1,1,3,3,H
1903-04-04,1902,Sunderland,Notts County,2-1,2,1,1,1,3,1,H
1903-04-06,1902,Bury,Sheffield Wednesday,4-0,4,0,1,1,4,4,H
1903-04-10,1902,Bury,Blackburn Rovers,1-1,1,1,1,1,2,0,D
1903-04-10,1902,Grimsby Town,West Bromwich Albion,4-0,4,0,1,1,4,4,H
1903-04-10,1902,Liverpool,Everton,0-0,0,0,1,1,0,0,D
1903-04-10,1902,Newcastle United,Derby County,2-1,2,1,1,1,3,1,H
1903-04-10,1902,Sheffield United,Notts County,3-0,3,0,1,1,3,3,H
1903-04-10,1902,Sunderland,Stoke City,0-0,0,0,1,1,0,0,D
1903-04-11,1902,Bolton Wanderers,Sunderland,2-0,2,0,1,1,2,2,H
1903-04-11,1902,Derby County,Sheffield Wednesday,1-0,1,0,1,1,1,1,H
1903-04-11,1902,Liverpool,Aston Villa,2-1,2,1,1,1,3,1,H
1903-04-11,1902,Middlesbrough,Blackburn Rovers,4-0,4,0,1,1,4,4,H
1903-04-11,1902,Newcastle United,Bury,1-0,1,0,1,1,1,1,H
1903-04-11,1902,Notts County,Stoke City,3-0,3,0,1,1,3,3,H
1903-04-11,1902,Sheffield United,Grimsby Town,3-0,3,0,1,1,3,3,H
1903-04-11,1902,Wolverhampton Wanderers,Nottingham Forest,2-1,2,1,1,1,3,1,H
1903-04-13,1902,Aston Villa,Stoke City,2-0,2,0,1,1,2,2,H
1903-04-13,1902,Everton,Blackburn Rovers,0-3,0,3,1,1,3,-3,A
1903-04-13,1902,Middlesbrough,Derby County,3-1,3,1,1,1,4,2,H
1903-04-13,1902,Newcastle United,Bolton Wanderers,2-0,2,0,1,1,2,2,H
1903-04-13,1902,Nottingham Forest,Sunderland,5-2,5,2,1,1,7,3,H
1903-04-13,1902,Wolverhampton Wanderers,Notts County,2-0,2,0,1,1,2,2,H
1903-04-15,1902,Aston Villa,Notts County,2-1,2,1,1,1,3,1,H
1903-04-18,1902,Aston Villa,Sheffield United,4-2,4,2,1,1,6,2,H
1903-04-18,1902,Blackburn Rovers,Newcastle United,3-1,3,1,1,1,4,2,H
1903-04-18,1902,Everton,Notts County,2-0,2,0,1,1,2,2,H
1903-04-18,1902,Nottingham Forest,Liverpool,1-0,1,0,1,1,1,1,H
1903-04-18,1902,Sheffield Wednesday,West Bromwich Albion,3-1,3,1,1,1,4,2,H
1903-04-18,1902,Stoke City,Bolton Wanderers,2-0,2,0,1,1,2,2,H
1903-04-18,1902,Sunderland,Middlesbrough,2-1,2,1,1,1,3,1,H
1903-04-20,1902,West Bromwich Albion,Bury,1-3,1,3,1,1,4,-2,A
1903-04-22,1902,Bury,Wolverhampton Wanderers,4-0,4,0,1,1,4,4,H
1903-04-22,1902,Derby County,Grimsby Town,2-2,2,2,1,1,4,0,D
1903-04-25,1902,Grimsby Town,Aston Villa,0-2,0,2,1,1,2,-2,A
1903-04-25,1902,Liverpool,Bury,2-0,2,0,1,1,2,2,H
1903-04-25,1902,Middlesbrough,Stoke City,1-1,1,1,1,1,2,0,D
1903-04-25,1902,Newcastle United,Sunderland,1-0,1,0,1,1,1,1,H
1903-04-25,1902,West Bromwich Albion,Derby County,3-0,3,0,1,1,3,3,H
1903-04-27,1902,Aston Villa,Middlesbrough,5-0,5,0,1,1,5,5,H
1903-04-27,1902,Wolverhampton Wanderers,Liverpool,0-2,0,2,1,1,2,-2,A
1903-09-01,1903,Derby County,Birmingham City,4-1,4,1,1,1,5,3,H
1903-09-01,1903,Everton,Blackburn Rovers,3-1,3,1,1,1,4,2,H
1903-09-01,1903,Stoke City,Bury,4-1,4,1,1,1,5,3,H
1903-09-01,1903,Sunderland,Notts County,4-1,4,1,1,1,5,3,H
1903-09-02,1903,Newcastle United,Aston Villa,1-1,1,1,1,1,2,0,D
1903-09-02,1903,West Bromwich Albion,Sheffield Wednesday,0-1,0,1,1,1,1,-1,A
1903-09-05,1903,Birmingham City,Sheffield United,1-3,1,3,1,1,4,-2,A
1903-09-05,1903,Blackburn Rovers,Bury,2-2,2,2,1,1,4,0,D
1903-09-05,1903,Derby County,Wolverhampton Wanderers,2-1,2,1,1,1,3,1,H
1903-09-05,1903,Everton,Notts County,3-1,3,1,1,1,4,2,H
1903-09-05,1903,Nottingham Forest,Liverpool,2-1,2,1,1,1,3,1,H
1903-09-05,1903,Sheffield Wednesday,Middlesbrough,4-1,4,1,1,1,5,3,H
1903-09-05,1903,Stoke City,Manchester City,1-2,1,2,1,1,3,-1,A
1903-09-05,1903,Sunderland,Aston Villa,6-1,6,1,1,1,7,5,H
1903-09-05,1903,West Bromwich Albion,Newcastle United,1-2,1,2,1,1,3,-1,A
1903-09-07,1903,Birmingham City,Nottingham Forest,3-3,3,3,1,1,6,0,D
1903-09-12,1903,Aston Villa,West Bromwich Albion,3-1,3,1,1,1,4,2,H
1903-09-12,1903,Bury,Nottingham Forest,2-2,2,2,1,1,4,0,D
1903-09-12,1903,Liverpool,Sheffield Wednesday,1-3,1,3,1,1,4,-2,A
1903-09-12,1903,Manchester City,Derby County,2-1,2,1,1,1,3,1,H
1903-09-12,1903,Middlesbrough,Sunderland,2-3,2,3,1,1,5,-1,A
1903-09-12,1903,Newcastle United,Birmingham City,3-1,3,1,1,1,4,2,H
1903-09-12,1903,Notts County,Stoke City,1-0,1,0,1,1,1,1,H
1903-09-12,1903,Sheffield United,Everton,2-1,2,1,1,1,3,1,H
1903-09-12,1903,Wolverhampton Wanderers,Blackburn Rovers,1-0,1,0,1,1,1,1,H
1903-09-19,1903,Birmingham City,Aston Villa,2-2,2,2,1,1,4,0,D
1903-09-19,1903,Derby County,Notts County,0-1,0,1,1,1,1,-1,A
1903-09-19,1903,Everton,Newcastle United,4-1,4,1,1,1,5,3,H
1903-09-19,1903,Manchester City,Wolverhampton Wanderers,4-1,4,1,1,1,5,3,H
1903-09-19,1903,Nottingham Forest,Blackburn Rovers,0-1,0,1,1,1,1,-1,A
1903-09-19,1903,Sheffield Wednesday,Bury,1-1,1,1,1,1,2,0,D
1903-09-19,1903,Stoke City,Sheffield United,3-4,3,4,1,1,7,-1,A
1903-09-19,1903,Sunderland,Liverpool,2-1,2,1,1,1,3,1,H
1903-09-19,1903,West Bromwich Albion,Middlesbrough,0-0,0,0,1,1,0,0,D
1903-09-26,1903,Aston Villa,Everton,3-1,3,1,1,1,4,2,H
1903-09-26,1903,Blackburn Rovers,Sheffield Wednesday,0-0,0,0,1,1,0,0,D
1903-09-26,1903,Bury,Sunderland,3-1,3,1,1,1,4,2,H
1903-09-26,1903,Liverpool,West Bromwich Albion,1-3,1,3,1,1,4,-2,A
1903-09-26,1903,Middlesbrough,Birmingham City,3-1,3,1,1,1,4,2,H
1903-09-26,1903,Newcastle United,Stoke City,1-0,1,0,1,1,1,1,H
1903-09-26,1903,Notts County,Manchester City,0-3,0,3,1,1,3,-3,A
1903-09-26,1903,Sheffield United,Derby County,3-2,3,2,1,1,5,1,H
1903-09-26,1903,Wolverhampton Wanderers,Nottingham Forest,3-2,3,2,1,1,5,1,H
1903-10-01,1903,Notts County,Liverpool,4-2,4,2,1,1,6,2,H
1903-10-03,1903,Birmingham City,Liverpool,1-2,1,2,1,1,3,-1,A
1903-10-03,1903,Derby County,Newcastle United,1-3,1,3,1,1,4,-2,A
1903-10-03,1903,Everton,Middlesbrough,2-0,2,0,1,1,2,2,H
1903-10-03,1903,Manchester City,Sheffield United,0-1,0,1,1,1,1,-1,A
1903-10-03,1903,Notts County,Wolverhampton Wanderers,0-2,0,2,1,1,2,-2,A
1903-10-03,1903,Sheffield Wednesday,Nottingham Forest,2-1,2,1,1,1,3,1,H
1903-10-03,1903,Stoke City,Aston Villa,2-0,2,0,1,1,2,2,H
1903-10-03,1903,Sunderland,Blackburn Rovers,2-0,2,0,1,1,2,2,H
1903-10-03,1903,West Bromwich Albion,Bury,3-2,3,2,1,1,5,1,H
1903-10-10,1903,Aston Villa,Derby County,3-0,3,0,1,1,3,3,H
1903-10-10,1903,Blackburn Rovers,West Bromwich Albion,2-0,2,0,1,1,2,2,H
1903-10-10,1903,Bury,Birmingham City,1-0,1,0,1,1,1,1,H
1903-10-10,1903,Liverpool,Everton,2-2,2,2,1,1,4,0,D
1903-10-10,1903,Middlesbrough,Stoke City,2-0,2,0,1,1,2,2,H
1903-10-10,1903,Newcastle United,Manchester City,1-0,1,0,1,1,1,1,H
1903-10-10,1903,Nottingham Forest,Sunderland,3-0,3,0,1,1,3,3,H
1903-10-10,1903,Sheffield United,Notts County,3-1,3,1,1,1,4,2,H
1903-10-10,1903,Wolverhampton Wanderers,Sheffield Wednesday,2-1,2,1,1,1,3,1,H
1903-10-17,1903,Birmingham City,Blackburn Rovers,2-1,2,1,1,1,3,1,H
1903-10-17,1903,Derby County,Middlesbrough,2-2,2,2,1,1,4,0,D
1903-10-17,1903,Everton,Bury,2-1,2,1,1,1,3,1,H
1903-10-17,1903,Manchester City,Aston Villa,1-0,1,0,1,1,1,1,H
1903-10-17,1903,Notts County,Newcastle United,3-2,3,2,1,1,5,1,H
1903-10-17,1903,Sheffield United,Wolverhampton Wanderers,7-2,7,2,1,1,9,5,H
1903-10-17,1903,Stoke City,Liverpool,5-2,5,2,1,1,7,3,H
1903-10-17,1903,Sunderland,Sheffield Wednesday,0-1,0,1,1,1,1,-1,A
1903-10-17,1903,West Bromwich Albion,Nottingham Forest,1-1,1,1,1,1,2,0,D
1903-10-24,1903,Aston Villa,Notts County,4-0,4,0,1,1,4,4,H
1903-10-24,1903,Blackburn Rovers,Everton,0-2,0,2,1,1,2,-2,A
1903-10-24,1903,Bury,Stoke City,2-2,2,2,1,1,4,0,D
1903-10-24,1903,Liverpool,Derby County,3-1,3,1,1,1,4,2,H
1903-10-24,1903,Middlesbrough,Manchester City,6-0,6,0,1,1,6,6,H
1903-10-24,1903,Newcastle United,Sheffield United,0-1,0,1,1,1,1,-1,A
1903-10-24,1903,Nottingham Forest,Birmingham City,0-1,0,1,1,1,1,-1,A
1903-10-24,1903,Sheffield Wednesday,West Bromwich Albion,1-0,1,0,1,1,1,1,H
1903-10-24,1903,Wolverhampton Wanderers,Sunderland,2-1,2,1,1,1,3,1,H
1903-10-31,1903,Birmingham City,Sheffield Wednesday,0-0,0,0,1,1,0,0,D
1903-10-31,1903,Derby County,Bury,2-2,2,2,1,1,4,0,D
1903-10-31,1903,Everton,Nottingham Forest,0-2,0,2,1,1,2,-2,A
1903-10-31,1903,Manchester City,Liverpool,3-2,3,2,1,1,5,1,H
1903-10-31,1903,Newcastle United,Wolverhampton Wanderers,3-0,3,0,1,1,3,3,H
1903-10-31,1903,Notts County,Middlesbrough,3-2,3,2,1,1,5,1,H
1903-10-31,1903,Sheffield United,Aston Villa,1-2,1,2,1,1,3,-1,A
1903-10-31,1903,Stoke City,Blackburn Rovers,6-2,6,2,1,1,8,4,H
1903-10-31,1903,West Bromwich Albion,Sunderland,1-1,1,1,1,1,2,0,D
1903-11-07,1903,Aston Villa,Newcastle United,3-1,3,1,1,1,4,2,H
1903-11-07,1903,Blackburn Rovers,Derby County,2-1,2,1,1,1,3,1,H
1903-11-07,1903,Bury,Manchester City,1-3,1,3,1,1,4,-2,A
1903-11-07,1903,Liverpool,Notts County,2-1,2,1,1,1,3,1,H
1903-11-07,1903,Middlesbrough,Sheffield United,4-1,4,1,1,1,5,3,H
1903-11-07,1903,Sheffield Wednesday,Everton,1-0,1,0,1,1,1,1,H
1903-11-07,1903,Sunderland,Birmingham City,3-1,3,1,1,1,4,2,H
1903-11-07,1903,Wolverhampton Wanderers,West Bromwich Albion,1-0,1,0,1,1,1,1,H
1903-11-14,1903,Aston Villa,Wolverhampton Wanderers,2-0,2,0,1,1,2,2,H
1903-11-14,1903,Birmingham City,West Bromwich Albion,0-1,0,1,1,1,1,-1,A
1903-11-14,1903,Derby County,Nottingham Forest,2-6,2,6,1,1,8,-4,A
1903-11-14,1903,Everton,Sunderland,0-1,0,1,1,1,1,-1,A
1903-11-14,1903,Manchester City,Blackburn Rovers,1-0,1,0,1,1,1,1,H
1903-11-14,1903,Newcastle United,Middlesbrough,2-1,2,1,1,1,3,1,H
1903-11-14,1903,Notts County,Bury,0-0,0,0,1,1,0,0,D
1903-11-14,1903,Sheffield United,Liverpool,2-1,2,1,1,1,3,1,H
1903-11-14,1903,Stoke City,Sheffield Wednesday,3-1,3,1,1,1,4,2,H
1903-11-21,1903,Blackburn Rovers,Notts County,3-0,3,0,1,1,3,3,H
1903-11-21,1903,Bury,Sheffield United,0-1,0,1,1,1,1,-1,A
1903-11-21,1903,Liverpool,Newcastle United,1-0,1,0,1,1,1,1,H
1903-11-21,1903,Middlesbrough,Aston Villa,2-1,2,1,1,1,3,1,H
1903-11-21,1903,Nottingham Forest,Manchester City,0-3,0,3,1,1,3,-3,A
1903-11-21,1903,Sheffield Wednesday,Derby County,1-0,1,0,1,1,1,1,H
1903-11-21,1903,Sunderland,Stoke City,3-0,3,0,1,1,3,3,H
1903-11-21,1903,West Bromwich Albion,Everton,0-0,0,0,1,1,0,0,D
1903-11-21,1903,Wolverhampton Wanderers,Birmingham City,1-0,1,0,1,1,1,1,H
1903-11-25,1903,Nottingham Forest,Stoke City,4-2,4,2,1,1,6,2,H
1903-11-28,1903,Aston Villa,Liverpool,2-1,2,1,1,1,3,1,H
1903-11-28,1903,Derby County,Sunderland,7-2,7,2,1,1,9,5,H
1903-11-28,1903,Everton,Birmingham City,5-1,5,1,1,1,6,4,H
1903-11-28,1903,Manchester City,Sheffield Wednesday,1-1,1,1,1,1,2,0,D
1903-11-28,1903,Middlesbrough,Wolverhampton Wanderers,1-2,1,2,1,1,3,-1,A
1903-11-28,1903,Newcastle United,Bury,3-2,3,2,1,1,5,1,H
1903-11-28,1903,Notts County,Nottingham Forest,1-3,1,3,1,1,4,-2,A
1903-11-28,1903,Sheffield United,Blackburn Rovers,2-2,2,2,1,1,4,0,D
1903-11-28,1903,Stoke City,West Bromwich Albion,5-0,5,0,1,1,5,5,H
1903-12-05,1903,Birmingham City,Stoke City,1-0,1,0,1,1,1,1,H
1903-12-05,1903,Blackburn Rovers,Newcastle United,4-0,4,0,1,1,4,4,H
1903-12-05,1903,Bury,Aston Villa,2-2,2,2,1,1,4,0,D
1903-12-05,1903,Nottingham Forest,Sheffield United,1-1,1,1,1,1,2,0,D
1903-12-05,1903,Sunderland,Manchester City,1-1,1,1,1,1,2,0,D
1903-12-05,1903,Wolverhampton Wanderers,Everton,2-2,2,2,1,1,4,0,D
1903-12-12,1903,Aston Villa,Blackburn Rovers,2-3,2,3,1,1,5,-1,A
1903-12-12,1903,Liverpool,Wolverhampton Wanderers,1-2,1,2,1,1,3,-1,A
1903-12-12,1903,Manchester City,West Bromwich Albion,6-3,6,3,1,1,9,3,H
1903-12-12,1903,Middlesbrough,Bury,1-0,1,0,1,1,1,1,H
1903-12-12,1903,Newcastle United,Nottingham Forest,3-1,3,1,1,1,4,2,H
1903-12-12,1903,Notts County,Sunderland,2-1,2,1,1,1,3,1,H
1903-12-12,1903,Sheffield United,Sheffield Wednesday,1-1,1,1,1,1,2,0,D
1903-12-12,1903,Stoke City,Everton,2-3,2,3,1,1,5,-1,A
1903-12-14,1903,West Bromwich Albion,Derby County,0-0,0,0,1,1,0,0,D
1903-12-19,1903,Birmingham City,Manchester City,0-3,0,3,1,1,3,-3,A
1903-12-19,1903,Blackburn Rovers,Middlesbrough,1-1,1,1,1,1,2,0,D
1903-12-19,1903,Bury,Liverpool,2-2,2,2,1,1,4,0,D
1903-12-19,1903,Everton,Derby County,0-1,0,1,1,1,1,-1,A
1903-12-19,1903,Nottingham Forest,Aston Villa,3-7,3,7,1,1,10,-4,A
1903-12-19,1903,Sheffield Wednesday,Newcastle United,1-1,1,1,1,1,2,0,D
1903-12-19,1903,Stoke City,Wolverhampton Wanderers,5-1,5,1,1,1,6,4,H
1903-12-19,1903,Sunderland,Sheffield United,2-1,2,1,1,1,3,1,H
1903-12-19,1903,West Bromwich Albion,Notts County,0-0,0,0,1,1,0,0,D
1903-12-25,1903,Blackburn Rovers,Stoke City,2-0,2,0,1,1,2,2,H
1903-12-25,1903,Derby County,Liverpool,2-0,2,0,1,1,2,2,H
1903-12-25,1903,Nottingham Forest,Notts County,0-1,0,1,1,1,1,-1,A
1903-12-25,1903,Sheffield United,Newcastle United,2-2,2,2,1,1,4,0,D
1903-12-26,1903,Aston Villa,Sheffield Wednesday,2-1,2,1,1,1,3,1,H
1903-12-26,1903,Derby County,Stoke City,5-0,5,0,1,1,5,5,H
1903-12-26,1903,Liverpool,Blackburn Rovers,1-2,1,2,1,1,3,-1,A
1903-12-26,1903,Manchester City,Everton,1-3,1,3,1,1,4,-2,A
1903-12-26,1903,Middlesbrough,Nottingham Forest,1-1,1,1,1,1,2,0,D
1903-12-26,1903,Newcastle United,Sunderland,1-3,1,3,1,1,4,-2,A
1903-12-26,1903,Notts County,Birmingham City,2-0,2,0,1,1,2,2,H
1903-12-26,1903,Sheffield United,West Bromwich Albion,4-0,4,0,1,1,4,4,H
1903-12-26,1903,Wolverhampton Wanderers,Bury,0-0,0,0,1,1,0,0,D
1903-12-28,1903,Derby County,Aston Villa,2-2,2,2,1,1,4,0,D
1903-12-28,1903,Sheffield United,Manchester City,5-3,5,3,1,1,8,2,H
1903-12-28,1903,Stoke City,Middlesbrough,0-0,0,0,1,1,0,0,D
1903-12-28,1903,West Bromwich Albion,Blackburn Rovers,2-1,2,1,1,1,3,1,H
1903-12-28,1903,Wolverhampton Wanderers,Liverpool,4-2,4,2,1,1,6,2,H
1904-01-01,1903,Blackburn Rovers,Nottingham Forest,3-1,3,1,1,1,4,2,H
1904-01-01,1903,Bury,Notts County,3-0,3,0,1,1,3,3,H
1904-01-01,1903,Manchester City,Middlesbrough,1-1,1,1,1,1,2,0,D
1904-01-01,1903,Sheffield Wednesday,Wolverhampton Wanderers,4-0,4,0,1,1,4,4,H
1904-01-01,1903,Sunderland,Newcastle United,1-1,1,1,1,1,2,0,D
1904-01-02,1903,Aston Villa,Sunderland,2-0,2,0,1,1,2,2,H
1904-01-02,1903,Bury,Blackburn Rovers,3-0,3,0,1,1,3,3,H
1904-01-02,1903,Liverpool,Nottingham Forest,0-0,0,0,1,1,0,0,D
1904-01-02,1903,Manchester City,Stoke City,2-2,2,2,1,1,4,0,D
1904-01-02,1903,Middlesbrough,Sheffield Wednesday,0-1,0,1,1,1,1,-1,A
1904-01-02,1903,Newcastle United,West Bromwich Albion,1-0,1,0,1,1,1,1,H
1904-01-02,1903,Notts County,Everton,0-3,0,3,1,1,3,-3,A
1904-01-02,1903,Sheffield United,Birmingham City,1-1,1,1,1,1,2,0,D
1904-01-02,1903,Wolverhampton Wanderers,Derby County,2-2,2,2,1,1,4,0,D
1904-01-09,1903,Birmingham City,Newcastle United,3-0,3,0,1,1,3,3,H
1904-01-09,1903,Blackburn Rovers,Wolverhampton Wanderers,1-1,1,1,1,1,2,0,D
1904-01-09,1903,Derby County,Manchester City,2-3,2,3,1,1,5,-1,A
1904-01-09,1903,Everton,Sheffield United,2-0,2,0,1,1,2,2,H
1904-01-09,1903,Nottingham Forest,Bury,2-2,2,2,1,1,4,0,D
1904-01-09,1903,Sheffield Wednesday,Liverpool,2-1,2,1,1,1,3,1,H
1904-01-09,1903,Stoke City,Notts County,0-2,0,2,1,1,2,-2,A
1904-01-09,1903,Sunderland,Middlesbrough,3-1,3,1,1,1,4,2,H
1904-01-09,1903,West Bromwich Albion,Aston Villa,1-3,1,3,1,1,4,-2,A
1904-01-16,1903,Aston Villa,Birmingham City,1-1,1,1,1,1,2,0,D
1904-01-16,1903,Bury,Sheffield Wednesday,1-0,1,0,1,1,1,1,H
1904-01-16,1903,Liverpool,Sunderland,2-1,2,1,1,1,3,1,H
1904-01-16,1903,Middlesbrough,West Bromwich Albion,2-2,2,2,1,1,4,0,D
1904-01-16,1903,Newcastle United,Everton,1-0,1,0,1,1,1,1,H
1904-01-16,1903,Notts County,Derby County,2-2,2,2,1,1,4,0,D
1904-01-16,1903,Sheffield United,Stoke City,1-1,1,1,1,1,2,0,D
1904-01-23,1903,Birmingham City,Middlesbrough,2-2,2,2,1,1,4,0,D
1904-01-23,1903,Derby County,Sheffield United,3-5,3,5,1,1,8,-2,A
1904-01-23,1903,Everton,Aston Villa,1-0,1,0,1,1,1,1,H
1904-01-23,1903,Manchester City,Notts County,3-0,3,0,1,1,3,3,H
1904-01-23,1903,Nottingham Forest,Wolverhampton Wanderers,5-0,5,0,1,1,5,5,H
1904-01-23,1903,Sheffield Wednesday,Blackburn Rovers,3-1,3,1,1,1,4,2,H
1904-01-23,1903,Stoke City,Newcastle United,2-3,2,3,1,1,5,-1,A
1904-01-23,1903,Sunderland,Bury,6-0,6,0,1,1,6,6,H
1904-01-23,1903,West Bromwich Albion,Liverpool,2-2,2,2,1,1,4,0,D
1904-01-30,1903,Aston Villa,Stoke City,3-1,3,1,1,1,4,2,H
1904-01-30,1903,Blackburn Rovers,Sunderland,1-3,1,3,1,1,4,-2,A
1904-01-30,1903,Bury,West Bromwich Albion,2-1,2,1,1,1,3,1,H
1904-01-30,1903,Liverpool,Birmingham City,0-2,0,2,1,1,2,-2,A
1904-01-30,1903,Middlesbrough,Everton,3-0,3,0,1,1,3,3,H
1904-01-30,1903,Newcastle United,Derby County,0-0,0,0,1,1,0,0,D
1904-01-30,1903,Nottingham Forest,Sheffield Wednesday,0-1,0,1,1,1,1,-1,A
1904-01-30,1903,Wolverhampton Wanderers,Notts County,1-1,1,1,1,1,2,0,D
1904-02-13,1903,Aston Villa,Manchester City,0-1,0,1,1,1,1,-1,A
1904-02-13,1903,Blackburn Rovers,Birmingham City,1-1,1,1,1,1,2,0,D
1904-02-13,1903,Bury,Everton,0-0,0,0,1,1,0,0,D
1904-02-13,1903,Liverpool,Stoke City,0-0,0,0,1,1,0,0,D
1904-02-13,1903,Middlesbrough,Derby County,0-0,0,0,1,1,0,0,D
1904-02-13,1903,Newcastle United,Notts County,4-1,4,1,1,1,5,3,H
1904-02-13,1903,Sheffield Wednesday,Sunderland,0-0,0,0,1,1,0,0,D
1904-02-13,1903,Wolverhampton Wanderers,Sheffield United,1-0,1,0,1,1,1,1,H
1904-02-20,1903,Notts County,West Bromwich Albion,2-3,2,3,1,1,5,-1,A
1904-02-22,1903,Liverpool,Middlesbrough,1-0,1,0,1,1,1,1,H
1904-02-22,1903,Sheffield Wednesday,Notts County,2-0,2,0,1,1,2,2,H
1904-02-27,1903,Aston Villa,Sheffield United,6-1,6,1,1,1,7,5,H
1904-02-27,1903,Bury,Derby County,2-2,2,2,1,1,4,0,D
1904-02-27,1903,Liverpool,Manchester City,2-2,2,2,1,1,4,0,D
1904-02-27,1903,Middlesbrough,Notts County,1-0,1,0,1,1,1,1,H
1904-02-27,1903,Nottingham Forest,Everton,0-4,0,4,1,1,4,-4,A
1904-02-27,1903,Sheffield Wednesday,Birmingham City,3-2,3,2,1,1,5,1,H
1904-02-27,1903,Sunderland,West Bromwich Albion,1-1,1,1,1,1,2,0,D
1904-02-27,1903,Wolverhampton Wanderers,Newcastle United,3-2,3,2,1,1,5,1,H
1904-03-05,1903,Birmingham City,Sunderland,2-1,2,1,1,1,3,1,H
1904-03-05,1903,Stoke City,Nottingham Forest,2-3,2,3,1,1,5,-1,A
1904-03-05,1903,West Bromwich Albion,Wolverhampton Wanderers,1-2,1,2,1,1,3,-1,A
1904-03-12,1903,Blackburn Rovers,Manchester City,2-5,2,5,1,1,7,-3,A
1904-03-12,1903,Liverpool,Sheffield United,3-0,3,0,1,1,3,3,H
1904-03-12,1903,Middlesbrough,Newcastle United,1-3,1,3,1,1,4,-2,A
1904-03-12,1903,Nottingham Forest,Derby County,5-1,5,1,1,1,6,4,H
1904-03-12,1903,Sheffield Wednesday,Stoke City,1-0,1,0,1,1,1,1,H
1904-03-12,1903,Sunderland,Everton,2-0,2,0,1,1,2,2,H
1904-03-12,1903,West Bromwich Albion,Birmingham City,0-1,0,1,1,1,1,-1,A
1904-03-12,1903,Wolverhampton Wanderers,Aston Villa,3-2,3,2,1,1,5,1,H
1904-03-19,1903,Aston Villa,Middlesbrough,2-1,2,1,1,1,3,1,H
1904-03-19,1903,Birmingham City,Wolverhampton Wanderers,3-0,3,0,1,1,3,3,H
1904-03-19,1903,Newcastle United,Liverpool,1-1,1,1,1,1,2,0,D
1904-03-19,1903,Notts County,Blackburn Rovers,4-2,4,2,1,1,6,2,H
1904-03-19,1903,Sheffield United,Bury,0-0,0,0,1,1,0,0,D
1904-03-19,1903,Stoke City,Sunderland,3-1,3,1,1,1,4,2,H
1904-03-21,1903,Wolverhampton Wanderers,Manchester City,1-6,1,6,1,1,7,-5,A
1904-03-26,1903,Birmingham City,Everton,1-1,1,1,1,1,2,0,D
1904-03-26,1903,Blackburn Rovers,Sheffield United,3-0,3,0,1,1,3,3,H
1904-03-26,1903,Bury,Newcastle United,0-3,0,3,1,1,3,-3,A
1904-03-26,1903,Liverpool,Aston Villa,1-1,1,1,1,1,2,0,D
1904-03-26,1903,Sheffield Wednesday,Manchester City,1-0,1,0,1,1,1,1,H
1904-03-26,1903,Sunderland,Derby County,0-3,0,3,1,1,3,-3,A
1904-03-26,1903,West Bromwich Albion,Stoke City,3-0,3,0,1,1,3,3,H
1904-03-26,1903,Wolverhampton Wanderers,Middlesbrough,2-2,2,2,1,1,4,0,D
1904-03-28,1903,Sheffield United,Middlesbrough,3-0,3,0,1,1,3,3,H
1904-03-30,1903,Nottingham Forest,West Bromwich Albion,2-0,2,0,1,1,2,2,H
1904-04-01,1903,Everton,Liverpool,5-2,5,2,1,1,7,3,H
1904-04-01,1903,Manchester City,Newcastle United,1-3,1,3,1,1,4,-2,A
1904-04-01,1903,Notts County,Aston Villa,0-0,0,0,1,1,0,0,D
1904-04-01,1903,Sunderland,Wolverhampton Wanderers,2-1,2,1,1,1,3,1,H
1904-04-02,1903,Aston Villa,Bury,0-2,0,2,1,1,2,-2,A
1904-04-02,1903,Derby County,West Bromwich Albion,4-2,4,2,1,1,6,2,H
1904-04-02,1903,Everton,Wolverhampton Wanderers,2-0,2,0,1,1,2,2,H
1904-04-02,1903,Manchester City,Sunderland,2-1,2,1,1,1,3,1,H
1904-04-02,1903,Middlesbrough,Liverpool,1-0,1,0,1,1,1,1,H
1904-04-02,1903,Newcastle United,Blackburn Rovers,2-1,2,1,1,1,3,1,H
1904-04-02,1903,Notts County,Sheffield Wednesday,1-0,1,0,1,1,1,1,H
1904-04-02,1903,Sheffield United,Nottingham Forest,2-0,2,0,1,1,2,2,H
1904-04-02,1903,Stoke City,Birmingham City,1-0,1,0,1,1,1,1,H
1904-04-04,1903,Birmingham City,Bury,1-0,1,0,1,1,1,1,H
1904-04-04,1903,Everton,Sheffield Wednesday,2-0,2,0,1,1,2,2,H
1904-04-04,1903,Notts County,Sheffield United,2-1,2,1,1,1,3,1,H
1904-04-04,1903,Sunderland,Nottingham Forest,3-1,3,1,1,1,4,2,H
1904-04-04,1903,Wolverhampton Wanderers,Stoke City,0-0,0,0,1,1,0,0,D
1904-04-09,1903,Birmingham City,Derby County,1-0,1,0,1,1,1,1,H
1904-04-09,1903,Blackburn Rovers,Aston Villa,0-3,0,3,1,1,3,-3,A
1904-04-09,1903,Bury,Middlesbrough,1-1,1,1,1,1,2,0,D
1904-04-09,1903,Everton,Stoke City,0-1,0,1,1,1,1,-1,A
1904-04-09,1903,Nottingham Forest,Newcastle United,1-0,1,0,1,1,1,1,H
1904-04-09,1903,Sheffield Wednesday,Sheffield United,3-0,3,0,1,1,3,3,H
1904-04-09,1903,West Bromwich Albion,Manchester City,2-1,2,1,1,1,3,1,H
1904-04-11,1903,Derby County,Blackburn Rovers,3-0,3,0,1,1,3,3,H
1904-04-11,1903,Manchester City,Bury,3-0,3,0,1,1,3,3,H
1904-04-13,1903,Manchester City,Nottingham Forest,0-0,0,0,1,1,0,0,D
1904-04-16,1903,Aston Villa,Nottingham Forest,3-1,3,1,1,1,4,2,H
1904-04-16,1903,Derby County,Everton,0-1,0,1,1,1,1,-1,A
1904-04-16,1903,Liverpool,Bury,3-0,3,0,1,1,3,3,H
1904-04-16,1903,Manchester City,Birmingham City,4-0,4,0,1,1,4,4,H
1904-04-16,1903,Middlesbrough,Blackburn Rovers,0-2,0,2,1,1,2,-2,A
1904-04-16,1903,Newcastle United,Sheffield Wednesday,4-0,4,0,1,1,4,4,H
1904-04-16,1903,Sheffield United,Sunderland,1-2,1,2,1,1,3,-1,A
1904-04-18,1903,Everton,West Bromwich Albion,4-0,4,0,1,1,4,4,H
1904-04-23,1903,Birmingham City,Notts County,2-0,2,0,1,1,2,2,H
1904-04-23,1903,Blackburn Rovers,Liverpool,2-3,2,3,1,1,5,-1,A
1904-04-23,1903,Bury,Wolverhampton Wanderers,0-0,0,0,1,1,0,0,D
1904-04-23,1903,Nottingham Forest,Middlesbrough,1-1,1,1,1,1,2,0,D
1904-04-23,1903,Sheffield Wednesday,Aston Villa,4-2,4,2,1,1,6,2,H
1904-04-23,1903,Stoke City,Derby County,1-1,1,1,1,1,2,0,D
1904-04-23,1903,West Bromwich Albion,Sheffield United,2-2,2,2,1,1,4,0,D
1904-04-25,1903,Everton,Manchester City,1-0,1,0,1,1,1,1,H
1904-04-30,1903,Derby County,Sheffield Wednesday,0-2,0,2,1,1,2,-2,A
1904-09-01,1904,Aston Villa,Preston North End,1-2,1,2,1,1,3,-1,A
1904-09-01,1904,Stoke City,Derby County,1-2,1,2,1,1,3,-1,A
1904-09-03,1904,Aston Villa,Stoke City,3-0,3,0,1,1,3,3,H
1904-09-03,1904,Bury,Blackburn Rovers,0-2,0,2,1,1,2,-2,A
1904-09-03,1904,Manchester City,Birmingham City,2-1,2,1,1,1,3,1,H
1904-09-03,1904,Middlesbrough,Sheffield Wednesday,1-3,1,3,1,1,4,-2,A
1904-09-03,1904,Newcastle United,Arsenal,3-0,3,0,1,1,3,3,H
1904-09-03,1904,Notts County,Everton,1-2,1,2,1,1,3,-1,A
1904-09-03,1904,Preston North End,Sunderland,3-1,3,1,1,1,4,2,H
1904-09-03,1904,Sheffield United,Derby County,3-1,3,1,1,1,4,2,H
1904-09-03,1904,Wolverhampton Wanderers,Nottingham Forest,3-2,3,2,1,1,5,1,H
1904-09-05,1904,Sunderland,Notts County,5-0,5,0,1,1,5,5,H
1904-09-05,1904,Wolverhampton Wanderers,Sheffield United,4-2,4,2,1,1,6,2,H
1904-09-10,1904,Arsenal,Preston North End,0-0,0,0,1,1,0,0,D
1904-09-10,1904,Birmingham City,Notts County,1-2,1,2,1,1,3,-1,A
1904-09-10,1904,Blackburn Rovers,Aston Villa,4-0,4,0,1,1,4,4,H
1904-09-10,1904,Derby County,Newcastle United,1-1,1,1,1,1,2,0,D
1904-09-10,1904,Everton,Sheffield United,2-0,2,0,1,1,2,2,H
1904-09-10,1904,Nottingham Forest,Bury,5-1,5,1,1,1,6,4,H
1904-09-10,1904,Sheffield Wednesday,Wolverhampton Wanderers,4-0,4,0,1,1,4,4,H
1904-09-10,1904,Stoke City,Manchester City,1-0,1,0,1,1,1,1,H
1904-09-10,1904,Sunderland,Middlesbrough,1-1,1,1,1,1,2,0,D
1904-09-12,1904,Aston Villa,Everton,1-0,1,0,1,1,1,1,H
1904-09-17,1904,Aston Villa,Nottingham Forest,2-0,2,0,1,1,2,2,H
1904-09-17,1904,Blackburn Rovers,Stoke City,4-0,4,0,1,1,4,4,H
1904-09-17,1904,Bury,Sheffield Wednesday,1-4,1,4,1,1,5,-3,A
1904-09-17,1904,Middlesbrough,Arsenal,1-0,1,0,1,1,1,1,H
1904-09-17,1904,Newcastle United,Everton,3-2,3,2,1,1,5,1,H
1904-09-17,1904,Notts County,Manchester City,1-1,1,1,1,1,2,0,D
1904-09-17,1904,Preston North End,Derby County,2-0,2,0,1,1,2,2,H
1904-09-17,1904,Sheffield United,Birmingham City,2-1,2,1,1,1,3,1,H
1904-09-17,1904,Wolverhampton Wanderers,Sunderland,1-0,1,0,1,1,1,1,H
1904-09-24,1904,Arsenal,Wolverhampton Wanderers,2-0,2,0,1,1,2,2,H
1904-09-24,1904,Birmingham City,Newcastle United,2-1,2,1,1,1,3,1,H
1904-09-24,1904,Derby County,Middlesbrough,4-2,4,2,1,1,6,2,H
1904-09-24,1904,Everton,Preston North End,1-0,1,0,1,1,1,1,H
1904-09-24,1904,Manchester City,Sheffield United,1-1,1,1,1,1,2,0,D
1904-09-24,1904,Nottingham Forest,Blackburn Rovers,5-2,5,2,1,1,7,3,H
1904-09-24,1904,Sheffield Wednesday,Aston Villa,3-2,3,2,1,1,5,1,H
1904-09-24,1904,Stoke City,Notts County,0-2,0,2,1,1,2,-2,A
1904-09-24,1904,Sunderland,Bury,2-1,2,1,1,1,3,1,H
1904-10-01,1904,Aston Villa,Sunderland,2-2,2,2,1,1,4,0,D
1904-10-01,1904,Blackburn Rovers,Sheffield Wednesday,0-1,0,1,1,1,1,-1,A
1904-10-01,1904,Bury,Arsenal,1-1,1,1,1,1,2,0,D
1904-10-01,1904,Middlesbrough,Everton,1-0,1,0,1,1,1,1,H
1904-10-01,1904,Newcastle United,Manchester City,2-0,2,0,1,1,2,2,H
1904-10-01,1904,Nottingham Forest,Stoke City,0-1,0,1,1,1,1,-1,A
1904-10-01,1904,Preston North End,Birmingham City,2-2,2,2,1,1,4,0,D
1904-10-01,1904,Sheffield United,Notts County,2-1,2,1,1,1,3,1,H
1904-10-01,1904,Wolverhampton Wanderers,Derby County,2-0,2,0,1,1,2,2,H
1904-10-06,1904,Nottingham Forest,Preston North End,0-1,0,1,1,1,1,-1,A
1904-10-08,1904,Arsenal,Aston Villa,1-0,1,0,1,1,1,1,H
1904-10-08,1904,Birmingham City,Middlesbrough,2-1,2,1,1,1,3,1,H
1904-10-08,1904,Derby County,Bury,3-2,3,2,1,1,5,1,H
1904-10-08,1904,Everton,Wolverhampton Wanderers,2-1,2,1,1,1,3,1,H
1904-10-08,1904,Manchester City,Preston North End,6-1,6,1,1,1,7,5,H
1904-10-08,1904,Notts County,Newcastle United,0-3,0,3,1,1,3,-3,A
1904-10-08,1904,Sheffield Wednesday,Nottingham Forest,2-0,2,0,1,1,2,2,H
1904-10-08,1904,Stoke City,Sheffield United,2-1,2,1,1,1,3,1,H
1904-10-08,1904,Sunderland,Blackburn Rovers,2-1,2,1,1,1,3,1,H
1904-10-15,1904,Aston Villa,Derby County,0-2,0,2,1,1,2,-2,A
1904-10-15,1904,Blackburn Rovers,Arsenal,1-1,1,1,1,1,2,0,D
1904-10-15,1904,Bury,Everton,1-2,1,2,1,1,3,-1,A
1904-10-15,1904,Middlesbrough,Manchester City,0-1,0,1,1,1,1,-1,A
1904-10-15,1904,Newcastle United,Sheffield United,1-1,1,1,1,1,2,0,D
1904-10-15,1904,Nottingham Forest,Sunderland,2-3,2,3,1,1,5,-1,A
1904-10-15,1904,Preston North End,Notts County,3-1,3,1,1,1,4,2,H
1904-10-15,1904,Sheffield Wednesday,Stoke City,3-0,3,0,1,1,3,3,H
1904-10-15,1904,Wolverhampton Wanderers,Birmingham City,0-1,0,1,1,1,1,-1,A
1904-10-22,1904,Arsenal,Nottingham Forest,0-3,0,3,1,1,3,-3,A
1904-10-22,1904,Birmingham City,Bury,5-0,5,0,1,1,5,5,H
1904-10-22,1904,Derby County,Blackburn Rovers,1-1,1,1,1,1,2,0,D
1904-10-22,1904,Everton,Aston Villa,3-2,3,2,1,1,5,1,H
1904-10-22,1904,Notts County,Middlesbrough,0-0,0,0,1,1,0,0,D
1904-10-22,1904,Sheffield United,Preston North End,1-0,1,0,1,1,1,1,H
1904-10-22,1904,Stoke City,Newcastle United,1-0,1,0,1,1,1,1,H
1904-10-22,1904,Sunderland,Sheffield Wednesday,3-0,3,0,1,1,3,3,H
1904-10-29,1904,Aston Villa,Birmingham City,2-1,2,1,1,1,3,1,H
1904-10-29,1904,Blackburn Rovers,Everton,1-0,1,0,1,1,1,1,H
1904-10-29,1904,Bury,Manchester City,2-4,2,4,1,1,6,-2,A
1904-10-29,1904,Middlesbrough,Sheffield United,0-1,0,1,1,1,1,-1,A
1904-10-29,1904,Nottingham Forest,Derby County,0-1,0,1,1,1,1,-1,A
1904-10-29,1904,Preston North End,Newcastle United,1-0,1,0,1,1,1,1,H
1904-10-29,1904,Sheffield Wednesday,Arsenal,0-3,0,3,1,1,3,-3,A
1904-10-29,1904,Sunderland,Stoke City,3-1,3,1,1,1,4,2,H
1904-10-29,1904,Wolverhampton Wanderers,Notts County,3-1,3,1,1,1,4,2,H
1904-11-05,1904,Arsenal,Sunderland,0-0,0,0,1,1,0,0,D
1904-11-05,1904,Birmingham City,Blackburn Rovers,2-0,2,0,1,1,2,2,H
1904-11-05,1904,Derby County,Sheffield Wednesday,1-0,1,0,1,1,1,1,H
1904-11-05,1904,Everton,Nottingham Forest,5-1,5,1,1,1,6,4,H
1904-11-05,1904,Newcastle United,Middlesbrough,3-0,3,0,1,1,3,3,H
1904-11-05,1904,Notts County,Bury,0-1,0,1,1,1,1,-1,A
1904-11-05,1904,Sheffield United,Wolverhampton Wanderers,4-2,4,2,1,1,6,2,H
1904-11-05,1904,Stoke City,Preston North End,1-1,1,1,1,1,2,0,D
1904-11-09,1904,Manchester City,Aston Villa,2-1,2,1,1,1,3,1,H
1904-11-12,1904,Arsenal,Stoke City,2-1,2,1,1,1,3,1,H
1904-11-12,1904,Aston Villa,Notts County,4-2,4,2,1,1,6,2,H
1904-11-12,1904,Blackburn Rovers,Manchester City,3-1,3,1,1,1,4,2,H
1904-11-12,1904,Bury,Sheffield United,7-1,7,1,1,1,8,6,H
1904-11-12,1904,Middlesbrough,Preston North End,1-1,1,1,1,1,2,0,D
1904-11-12,1904,Nottingham Forest,Birmingham City,0-2,0,2,1,1,2,-2,A
1904-11-12,1904,Sheffield Wednesday,Everton,5-5,5,5,1,1,10,0,D
1904-11-12,1904,Sunderland,Derby County,3-0,3,0,1,1,3,3,H
1904-11-12,1904,Wolverhampton Wanderers,Newcastle United,1-3,1,3,1,1,4,-2,A
1904-11-14,1904,Manchester City,Wolverhampton Wanderers,5-1,5,1,1,1,6,4,H
1904-11-19,1904,Birmingham City,Sheffield Wednesday,2-1,2,1,1,1,3,1,H
1904-11-19,1904,Derby County,Arsenal,0-0,0,0,1,1,0,0,D
1904-11-19,1904,Everton,Sunderland,0-1,0,1,1,1,1,-1,A
1904-11-19,1904,Manchester City,Nottingham Forest,1-1,1,1,1,1,2,0,D
1904-11-19,1904,Newcastle United,Bury,3-1,3,1,1,1,4,2,H
1904-11-19,1904,Notts County,Blackburn Rovers,2-1,2,1,1,1,3,1,H
1904-11-19,1904,Preston North End,Wolverhampton Wanderers,2-2,2,2,1,1,4,0,D
1904-11-19,1904,Sheffield United,Aston Villa,0-3,0,3,1,1,3,-3,A
1904-11-19,1904,Stoke City,Middlesbrough,3-1,3,1,1,1,4,2,H
1904-11-26,1904,Aston Villa,Newcastle United,0-1,0,1,1,1,1,-1,A
1904-11-26,1904,Blackburn Rovers,Sheffield United,2-4,2,4,1,1,6,-2,A
1904-11-26,1904,Bury,Preston North End,0-1,0,1,1,1,1,-1,A
1904-11-26,1904,Derby County,Stoke City,3-0,3,0,1,1,3,3,H
1904-11-26,1904,Nottingham Forest,Notts County,2-1,2,1,1,1,3,1,H
1904-11-26,1904,Sheffield Wednesday,Manchester City,2-1,2,1,1,1,3,1,H
1904-11-26,1904,Sunderland,Birmingham City,1-4,1,4,1,1,5,-3,A
1904-11-26,1904,Wolverhampton Wanderers,Middlesbrough,5-3,5,3,1,1,8,2,H
1904-12-03,1904,Birmingham City,Arsenal,2-1,2,1,1,1,3,1,H
1904-12-03,1904,Everton,Derby County,0-0,0,0,1,1,0,0,D
1904-12-03,1904,Manchester City,Sunderland,5-2,5,2,1,1,7,3,H
1904-12-03,1904,Middlesbrough,Bury,2-2,2,2,1,1,4,0,D
1904-12-03,1904,Newcastle United,Blackburn Rovers,1-0,1,0,1,1,1,1,H
1904-12-03,1904,Notts County,Sheffield Wednesday,2-2,2,2,1,1,4,0,D
1904-12-03,1904,Preston North End,Aston Villa,2-3,2,3,1,1,5,-1,A
1904-12-03,1904,Sheffield United,Nottingham Forest,4-0,4,0,1,1,4,4,H
1904-12-03,1904,Stoke City,Wolverhampton Wanderers,2-1,2,1,1,1,3,1,H
1904-12-10,1904,Arsenal,Manchester City,1-0,1,0,1,1,1,1,H
1904-12-10,1904,Aston Villa,Middlesbrough,0-0,0,0,1,1,0,0,D
1904-12-10,1904,Blackburn Rovers,Preston North End,1-1,1,1,1,1,2,0,D
1904-12-10,1904,Bury,Wolverhampton Wanderers,3-1,3,1,1,1,4,2,H
1904-12-10,1904,Derby County,Birmingham City,3-0,3,0,1,1,3,3,H
1904-12-10,1904,Everton,Stoke City,4-1,4,1,1,1,5,3,H
1904-12-10,1904,Nottingham Forest,Newcastle United,1-3,1,3,1,1,4,-2,A
1904-12-10,1904,Sheffield Wednesday,Sheffield United,1-3,1,3,1,1,4,-2,A
1904-12-17,1904,Birmingham City,Everton,1-2,1,2,1,1,3,-1,A
1904-12-17,1904,Bury,Stoke City,3-1,3,1,1,1,4,2,H
1904-12-17,1904,Manchester City,Derby County,6-0,6,0,1,1,6,6,H
1904-12-17,1904,Middlesbrough,Blackburn Rovers,2-1,2,1,1,1,3,1,H
1904-12-17,1904,Newcastle United,Sheffield Wednesday,6-2,6,2,1,1,8,4,H
1904-12-17,1904,Notts County,Arsenal,1-5,1,5,1,1,6,-4,A
1904-12-17,1904,Preston North End,Nottingham Forest,0-1,0,1,1,1,1,-1,A
1904-12-17,1904,Sheffield United,Sunderland,1-0,1,0,1,1,1,1,H
1904-12-17,1904,Wolverhampton Wanderers,Aston Villa,1-1,1,1,1,1,2,0,D
1904-12-24,1904,Arsenal,Sheffield United,1-0,1,0,1,1,1,1,H
1904-12-24,1904,Aston Villa,Bury,2-0,2,0,1,1,2,2,H
1904-12-24,1904,Blackburn Rovers,Wolverhampton Wanderers,3-0,3,0,1,1,3,3,H
1904-12-24,1904,Derby County,Notts County,1-1,1,1,1,1,2,0,D
1904-12-24,1904,Everton,Manchester City,0-0,0,0,1,1,0,0,D
1904-12-24,1904,Nottingham Forest,Middlesbrough,1-1,1,1,1,1,2,0,D
1904-12-24,1904,Sunderland,Newcastle United,3-1,3,1,1,1,4,2,H
1904-12-26,1904,Aston Villa,Arsenal,3-1,3,1,1,1,4,2,H
1904-12-26,1904,Blackburn Rovers,Sunderland,2-1,2,1,1,1,3,1,H
1904-12-26,1904,Bury,Derby County,2-0,2,0,1,1,2,2,H
1904-12-26,1904,Middlesbrough,Birmingham City,0-1,0,1,1,1,1,-1,A
1904-12-26,1904,Nottingham Forest,Sheffield Wednesday,2-1,2,1,1,1,3,1,H
1904-12-26,1904,Preston North End,Manchester City,0-1,0,1,1,1,1,-1,A
1904-12-26,1904,Sheffield United,Stoke City,5-2,5,2,1,1,7,3,H
1904-12-26,1904,Wolverhampton Wanderers,Everton,0-3,0,3,1,1,3,-3,A
1904-12-27,1904,Derby County,Everton,1-2,1,2,1,1,3,-1,A
1904-12-27,1904,Nottingham Forest,Arsenal,0-3,0,3,1,1,3,-3,A
1904-12-27,1904,Sheffield Wednesday,Sunderland,1-1,1,1,1,1,2,0,D
1904-12-28,1904,Sheffield United,Arsenal,4-0,4,0,1,1,4,4,H
1904-12-31,1904,Arsenal,Newcastle United,0-2,0,2,1,1,2,-2,A
1904-12-31,1904,Birmingham City,Manchester City,3-1,3,1,1,1,4,2,H
1904-12-31,1904,Blackburn Rovers,Bury,0-2,0,2,1,1,2,-2,A
1904-12-31,1904,Derby County,Sheffield United,2-3,2,3,1,1,5,-1,A
1904-12-31,1904,Everton,Notts County,5-1,5,1,1,1,6,4,H
1904-12-31,1904,Nottingham Forest,Wolverhampton Wanderers,2-2,2,2,1,1,4,0,D
1904-12-31,1904,Sheffield Wednesday,Middlesbrough,5-0,5,0,1,1,5,5,H
1904-12-31,1904,Stoke City,Aston Villa,1-4,1,4,1,1,5,-3,A
1904-12-31,1904,Sunderland,Preston North End,3-2,3,2,1,1,5,1,H
1905-01-02,1904,Blackburn Rovers,Derby County,3-1,3,1,1,1,4,2,H
1905-01-02,1904,Bury,Birmingham City,1-1,1,1,1,1,2,0,D
1905-01-02,1904,Newcastle United,Notts County,1-0,1,0,1,1,1,1,H
1905-01-02,1904,Sheffield Wednesday,Preston North End,2-0,2,0,1,1,2,2,H
1905-01-02,1904,Sunderland,Nottingham Forest,1-0,1,0,1,1,1,1,H
1905-01-07,1904,Aston Villa,Blackburn Rovers,3-0,3,0,1,1,3,3,H
1905-01-07,1904,Bury,Nottingham Forest,5-1,5,1,1,1,6,4,H
1905-01-07,1904,Manchester City,Stoke City,1-0,1,0,1,1,1,1,H
1905-01-07,1904,Middlesbrough,Sunderland,1-3,1,3,1,1,4,-2,A
1905-01-07,1904,Newcastle United,Derby County,2-0,2,0,1,1,2,2,H
1905-01-07,1904,Notts County,Birmingham City,0-0,0,0,1,1,0,0,D
1905-01-07,1904,Preston North End,Arsenal,3-0,3,0,1,1,3,3,H
1905-01-07,1904,Sheffield United,Everton,1-0,1,0,1,1,1,1,H
1905-01-07,1904,Wolverhampton Wanderers,Sheffield Wednesday,1-0,1,0,1,1,1,1,H
1905-01-14,1904,Arsenal,Middlesbrough,1-1,1,1,1,1,2,0,D
1905-01-14,1904,Birmingham City,Sheffield United,2-0,2,0,1,1,2,2,H
1905-01-14,1904,Derby County,Preston North End,3-1,3,1,1,1,4,2,H
1905-01-14,1904,Everton,Newcastle United,2-1,2,1,1,1,3,1,H
1905-01-14,1904,Manchester City,Notts County,2-1,2,1,1,1,3,1,H
1905-01-14,1904,Nottingham Forest,Aston Villa,1-1,1,1,1,1,2,0,D
1905-01-14,1904,Sheffield Wednesday,Bury,4-0,4,0,1,1,4,4,H
1905-01-14,1904,Stoke City,Blackburn Rovers,4-0,4,0,1,1,4,4,H
1905-01-14,1904,Sunderland,Wolverhampton Wanderers,3-0,3,0,1,1,3,3,H
1905-01-21,1904,Aston Villa,Sheffield Wednesday,0-2,0,2,1,1,2,-2,A
1905-01-21,1904,Blackburn Rovers,Nottingham Forest,0-0,0,0,1,1,0,0,D
1905-01-21,1904,Bury,Sunderland,1-0,1,0,1,1,1,1,H
1905-01-21,1904,Middlesbrough,Derby County,2-0,2,0,1,1,2,2,H
1905-01-21,1904,Newcastle United,Birmingham City,0-1,0,1,1,1,1,-1,A
1905-01-21,1904,Notts County,Stoke City,0-0,0,0,1,1,0,0,D
1905-01-21,1904,Preston North End,Everton,1-1,1,1,1,1,2,0,D
1905-01-21,1904,Sheffield United,Manchester City,0-3,0,3,1,1,3,-3,A
1905-01-21,1904,Wolverhampton Wanderers,Arsenal,4-1,4,1,1,1,5,3,H
1905-01-28,1904,Arsenal,Bury,2-1,2,1,1,1,3,1,H
1905-01-28,1904,Birmingham City,Preston North End,2-0,2,0,1,1,2,2,H
1905-01-28,1904,Derby County,Wolverhampton Wanderers,2-1,2,1,1,1,3,1,H
1905-01-28,1904,Everton,Middlesbrough,1-0,1,0,1,1,1,1,H
1905-01-28,1904,Manchester City,Newcastle United,3-2,3,2,1,1,5,1,H
1905-01-28,1904,Notts County,Sheffield United,1-5,1,5,1,1,6,-4,A
1905-01-28,1904,Sheffield Wednesday,Blackburn Rovers,1-2,1,2,1,1,3,-1,A
1905-01-28,1904,Stoke City,Nottingham Forest,0-0,0,0,1,1,0,0,D
1905-01-28,1904,Sunderland,Aston Villa,2-3,2,3,1,1,5,-1,A
1905-02-11,1904,Arsenal,Blackburn Rovers,2-0,2,0,1,1,2,2,H
1905-02-11,1904,Birmingham City,Wolverhampton Wanderers,4-1,4,1,1,1,5,3,H
1905-02-11,1904,Derby County,Aston Villa,0-2,0,2,1,1,2,-2,A
1905-02-11,1904,Everton,Bury,2-0,2,0,1,1,2,2,H
1905-02-11,1904,Manchester City,Middlesbrough,3-2,3,2,1,1,5,1,H
1905-02-11,1904,Notts County,Preston North End,1-3,1,3,1,1,4,-2,A
1905-02-11,1904,Sheffield United,Newcastle United,1-3,1,3,1,1,4,-2,A
1905-02-11,1904,Stoke City,Sheffield Wednesday,2-1,2,1,1,1,3,1,H
1905-02-18,1904,Notts County,Derby County,0-0,0,0,1,1,0,0,D
1905-02-25,1904,Arsenal,Sheffield Wednesday,3-0,3,0,1,1,3,3,H
1905-02-25,1904,Birmingham City,Aston Villa,0-3,0,3,1,1,3,-3,A
1905-02-25,1904,Derby County,Nottingham Forest,3-2,3,2,1,1,5,1,H
1905-02-25,1904,Everton,Blackburn Rovers,1-0,1,0,1,1,1,1,H
1905-02-25,1904,Manchester City,Bury,3-2,3,2,1,1,5,1,H
1905-02-25,1904,Newcastle United,Preston North End,1-0,1,0,1,1,1,1,H
1905-02-25,1904,Notts County,Wolverhampton Wanderers,3-4,3,4,1,1,7,-1,A
1905-02-25,1904,Sheffield United,Middlesbrough,0-1,0,1,1,1,1,-1,A
1905-02-25,1904,Stoke City,Sunderland,1-3,1,3,1,1,4,-2,A
1905-03-04,1904,Blackburn Rovers,Birmingham City,1-4,1,4,1,1,5,-3,A
1905-03-04,1904,Derby County,Manchester City,0-1,0,1,1,1,1,-1,A
1905-03-04,1904,Middlesbrough,Nottingham Forest,0-0,0,0,1,1,0,0,D
1905-03-04,1904,Sunderland,Arsenal,1-1,1,1,1,1,2,0,D
1905-03-11,1904,Birmingham City,Nottingham Forest,1-2,1,2,1,1,3,-1,A
1905-03-11,1904,Derby County,Sunderland,1-0,1,0,1,1,1,1,H
1905-03-11,1904,Everton,Sheffield Wednesday,5-2,5,2,1,1,7,3,H
1905-03-11,1904,Manchester City,Blackburn Rovers,2-1,2,1,1,1,3,1,H
1905-03-11,1904,Newcastle United,Wolverhampton Wanderers,3-0,3,0,1,1,3,3,H
1905-03-11,1904,Notts County,Aston Villa,1-2,1,2,1,1,3,-1,A
1905-03-11,1904,Preston North End,Middlesbrough,2-0,2,0,1,1,2,2,H
1905-03-11,1904,Sheffield United,Bury,4-0,4,0,1,1,4,4,H
1905-03-11,1904,Stoke City,Arsenal,2-0,2,0,1,1,2,2,H
1905-03-18,1904,Arsenal,Derby County,0-0,0,0,1,1,0,0,D
1905-03-18,1904,Aston Villa,Sheffield United,3-0,3,0,1,1,3,3,H
1905-03-18,1904,Blackburn Rovers,Notts County,1-0,1,0,1,1,1,1,H
1905-03-18,1904,Bury,Newcastle United,2-4,2,4,1,1,6,-2,A
1905-03-18,1904,Middlesbrough,Stoke City,2-1,2,1,1,1,3,1,H
1905-03-18,1904,Nottingham Forest,Manchester City,2-1,2,1,1,1,3,1,H
1905-03-18,1904,Sheffield Wednesday,Birmingham City,3-1,3,1,1,1,4,2,H
1905-03-18,1904,Sunderland,Everton,2-3,2,3,1,1,5,-1,A
1905-03-18,1904,Wolverhampton Wanderers,Preston North End,0-0,0,0,1,1,0,0,D
1905-03-25,1904,Birmingham City,Sunderland,1-1,1,1,1,1,2,0,D
1905-03-25,1904,Middlesbrough,Wolverhampton Wanderers,3-1,3,1,1,1,4,2,H
1905-03-25,1904,Notts County,Nottingham Forest,1-2,1,2,1,1,3,-1,A
1905-03-25,1904,Preston North End,Bury,0-0,0,0,1,1,0,0,D
1905-03-25,1904,Sheffield United,Blackburn Rovers,3-1,3,1,1,1,4,2,H
1905-04-01,1904,Arsenal,Birmingham City,1-1,1,1,1,1,2,0,D
1905-04-01,1904,Blackburn Rovers,Newcastle United,2-0,2,0,1,1,2,2,H
1905-04-01,1904,Bury,Middlesbrough,1-0,1,0,1,1,1,1,H
1905-04-01,1904,Nottingham Forest,Sheffield United,1-2,1,2,1,1,3,-1,A
1905-04-01,1904,Sheffield Wednesday,Notts County,1-0,1,0,1,1,1,1,H
1905-04-01,1904,Sunderland,Manchester City,0-0,0,0,1,1,0,0,D
1905-04-01,1904,Wolverhampton Wanderers,Stoke City,1-3,1,3,1,1,4,-2,A
1905-04-03,1904,Sheffield Wednesday,Derby County,1-1,1,1,1,1,2,0,D
1905-04-05,1904,Everton,Arsenal,1-0,1,0,1,1,1,1,H
1905-04-05,1904,Newcastle United,Aston Villa,2-0,2,0,1,1,2,2,H
1905-04-08,1904,Birmingham City,Derby County,2-0,2,0,1,1,2,2,H
1905-04-08,1904,Manchester City,Arsenal,1-0,1,0,1,1,1,1,H
1905-04-08,1904,Middlesbrough,Aston Villa,3-1,3,1,1,1,4,2,H
1905-04-08,1904,Newcastle United,Nottingham Forest,5-1,5,1,1,1,6,4,H
1905-04-08,1904,Notts County,Sunderland,2-2,2,2,1,1,4,0,D
1905-04-08,1904,Preston North End,Blackburn Rovers,0-0,0,0,1,1,0,0,D
1905-04-08,1904,Sheffield United,Sheffield Wednesday,4-2,4,2,1,1,6,2,H
1905-04-08,1904,Stoke City,Everton,2-2,2,2,1,1,4,0,D
1905-04-08,1904,Wolverhampton Wanderers,Bury,2-0,2,0,1,1,2,2,H
1905-04-10,1904,Preston North End,Stoke City,2-1,2,1,1,1,3,1,H
1905-04-15,1904,Arsenal,Notts County,1-2,1,2,1,1,3,-1,A
1905-04-15,1904,Blackburn Rovers,Middlesbrough,0-2,0,2,1,1,2,-2,A
1905-04-15,1904,Everton,Birmingham City,2-1,2,1,1,1,3,1,H
1905-04-15,1904,Manchester City,Sheffield Wednesday,1-1,1,1,1,1,2,0,D
1905-04-15,1904,Stoke City,Bury,2-0,2,0,1,1,2,2,H
1905-04-21,1904,Bury,Notts County,2-0,2,0,1,1,2,2,H
1905-04-21,1904,Manchester City,Everton,2-0,2,0,1,1,2,2,H
1905-04-21,1904,Newcastle United,Stoke City,4-1,4,1,1,1,5,3,H
1905-04-21,1904,Preston North End,Sheffield United,4-0,4,0,1,1,4,4,H
1905-04-22,1904,Arsenal,Everton,2-1,2,1,1,1,3,1,H
1905-04-22,1904,Birmingham City,Stoke City,0-1,0,1,1,1,1,-1,A
1905-04-22,1904,Bury,Aston Villa,2-3,2,3,1,1,5,-1,A
1905-04-22,1904,Newcastle United,Sunderland,1-3,1,3,1,1,4,-2,A
1905-04-22,1904,Preston North End,Sheffield Wednesday,1-0,1,0,1,1,1,1,H
1905-04-22,1904,Wolverhampton Wanderers,Blackburn Rovers,2-0,2,0,1,1,2,2,H
1905-04-24,1904,Middlesbrough,Notts County,2-5,2,5,1,1,7,-3,A
1905-04-24,1904,Nottingham Forest,Everton,0-2,0,2,1,1,2,-2,A
1905-04-24,1904,Sunderland,Sheffield United,2-1,2,1,1,1,3,1,H
1905-04-24,1904,Wolverhampton Wanderers,Manchester City,0-3,0,3,1,1,3,-3,A
1905-04-26,1904,Sheffield Wednesday,Newcastle United,1-3,1,3,1,1,4,-2,A
1905-04-27,1904,Aston Villa,Wolverhampton Wanderers,3-0,3,0,1,1,3,3,H
1905-04-29,1904,Aston Villa,Manchester City,3-2,3,2,1,1,5,1,H
1905-04-29,1904,Middlesbrough,Newcastle United,0-3,0,3,1,1,3,-3,A
1905-04-29,1904,Stoke City,Birmingham City,1-0,1,0,1,1,1,1,H
1905-09-02,1905,Arsenal,Liverpool,3-1,3,1,1,1,4,2,H
1905-09-02,1905,Birmingham City,Preston North End,1-1,1,1,1,1,2,0,D
1905-09-02,1905,Blackburn Rovers,Aston Villa,1-1,1,1,1,1,2,0,D
1905-09-02,1905,Bolton Wanderers,Sheffield United,1-2,1,2,1,1,3,-1,A
1905-09-02,1905,Derby County,Bury,3-1,3,1,1,1,4,2,H
1905-09-02,1905,Everton,Middlesbrough,4-1,4,1,1,1,5,3,H
1905-09-02,1905,Nottingham Forest,Wolverhampton Wanderers,3-1,3,1,1,1,4,2,H
1905-09-02,1905,Sheffield Wednesday,Manchester City,1-0,1,0,1,1,1,1,H
1905-09-02,1905,Stoke City,Notts County,3-0,3,0,1,1,3,3,H
1905-09-02,1905,Sunderland,Newcastle United,3-2,3,2,1,1,5,1,H
1905-09-04,1905,Preston North End,Nottingham Forest,3-1,3,1,1,1,4,2,H
1905-09-04,1905,Stoke City,Blackburn Rovers,3-0,3,0,1,1,3,3,H
1905-09-04,1905,Wolverhampton Wanderers,Sheffield Wednesday,0-0,0,0,1,1,0,0,D
1905-09-06,1905,Newcastle United,Manchester City,2-2,2,2,1,1,4,0,D
1905-09-09,1905,Aston Villa,Sunderland,2-1,2,1,1,1,3,1,H
1905-09-09,1905,Bury,Sheffield Wednesday,2-2,2,2,1,1,4,0,D
1905-09-09,1905,Liverpool,Blackburn Rovers,1-3,1,3,1,1,4,-2,A
1905-09-09,1905,Manchester City,Nottingham Forest,5-0,5,0,1,1,5,5,H
1905-09-09,1905,Middlesbrough,Derby County,0-1,0,1,1,1,1,-1,A
1905-09-09,1905,Newcastle United,Birmingham City,2-2,2,2,1,1,4,0,D
1905-09-09,1905,Notts County,Bolton Wanderers,3-3,3,3,1,1,6,0,D
1905-09-09,1905,Preston North End,Everton,1-1,1,1,1,1,2,0,D
1905-09-09,1905,Sheffield United,Arsenal,3-1,3,1,1,1,4,2,H
1905-09-09,1905,Wolverhampton Wanderers,Stoke City,1-2,1,2,1,1,3,-1,A
1905-09-11,1905,Aston Villa,Liverpool,5-0,5,0,1,1,5,5,H
1905-09-11,1905,Wolverhampton Wanderers,Bury,2-2,2,2,1,1,4,0,D
1905-09-13,1905,Newcastle United,Sheffield Wednesday,0-3,0,3,1,1,3,-3,A
1905-09-16,1905,Arsenal,Notts County,1-1,1,1,1,1,2,0,D
1905-09-16,1905,Birmingham City,Aston Villa,2-0,2,0,1,1,2,2,H
1905-09-16,1905,Blackburn Rovers,Sheffield United,2-1,2,1,1,1,3,1,H
1905-09-16,1905,Bolton Wanderers,Stoke City,1-2,1,2,1,1,3,-1,A
1905-09-16,1905,Derby County,Preston North End,3-0,3,0,1,1,3,3,H
1905-09-16,1905,Everton,Newcastle United,1-2,1,2,1,1,3,-1,A
1905-09-16,1905,Manchester City,Wolverhampton Wanderers,4-0,4,0,1,1,4,4,H
1905-09-16,1905,Nottingham Forest,Bury,3-2,3,2,1,1,5,1,H
1905-09-16,1905,Sheffield Wednesday,Middlesbrough,3-0,3,0,1,1,3,3,H
1905-09-16,1905,Sunderland,Liverpool,1-2,1,2,1,1,3,-1,A
1905-09-18,1905,Arsenal,Preston North End,2-2,2,2,1,1,4,0,D
1905-09-23,1905,Aston Villa,Everton,4-0,4,0,1,1,4,4,H
1905-09-23,1905,Bury,Manchester City,2-4,2,4,1,1,6,-2,A
1905-09-23,1905,Liverpool,Birmingham City,2-0,2,0,1,1,2,2,H
1905-09-23,1905,Middlesbrough,Nottingham Forest,2-0,2,0,1,1,2,2,H
1905-09-23,1905,Newcastle United,Derby County,0-1,0,1,1,1,1,-1,A
1905-09-23,1905,Notts County,Blackburn Rovers,1-1,1,1,1,1,2,0,D
1905-09-23,1905,Preston North End,Sheffield Wednesday,0-1,0,1,1,1,1,-1,A
1905-09-23,1905,Sheffield United,Sunderland,4-1,4,1,1,1,5,3,H
1905-09-23,1905,Stoke City,Arsenal,2-1,2,1,1,1,3,1,H
1905-09-23,1905,Wolverhampton Wanderers,Bolton Wanderers,2-0,2,0,1,1,2,2,H
1905-09-30,1905,Arsenal,Bolton Wanderers,0-0,0,0,1,1,0,0,D
1905-09-30,1905,Birmingham City,Sheffield United,2-0,2,0,1,1,2,2,H
1905-09-30,1905,Blackburn Rovers,Stoke City,3-0,3,0,1,1,3,3,H
1905-09-30,1905,Bury,Wolverhampton Wanderers,0-1,0,1,1,1,1,-1,A
1905-09-30,1905,Derby County,Aston Villa,1-0,1,0,1,1,1,1,H
1905-09-30,1905,Everton,Liverpool,4-2,4,2,1,1,6,2,H
1905-09-30,1905,Manchester City,Middlesbrough,4-0,4,0,1,1,4,4,H
1905-09-30,1905,Nottingham Forest,Preston North End,1-0,1,0,1,1,1,1,H
1905-09-30,1905,Sheffield Wednesday,Newcastle United,1-1,1,1,1,1,2,0,D
1905-09-30,1905,Sunderland,Notts County,1-3,1,3,1,1,4,-2,A
1905-10-05,1905,Notts County,Wolverhampton Wanderers,5-2,5,2,1,1,7,3,H
1905-10-07,1905,Aston Villa,Sheffield Wednesday,3-0,3,0,1,1,3,3,H
1905-10-07,1905,Bolton Wanderers,Blackburn Rovers,1-0,1,0,1,1,1,1,H
1905-10-07,1905,Liverpool,Derby County,4-1,4,1,1,1,5,3,H
1905-10-07,1905,Middlesbrough,Bury,5-1,5,1,1,1,6,4,H
1905-10-07,1905,Newcastle United,Nottingham Forest,3-2,3,2,1,1,5,1,H
1905-10-07,1905,Notts County,Birmingham City,0-0,0,0,1,1,0,0,D
1905-10-07,1905,Preston North End,Manchester City,2-0,2,0,1,1,2,2,H
1905-10-07,1905,Sheffield United,Everton,3-2,3,2,1,1,5,1,H
1905-10-07,1905,Stoke City,Sunderland,1-0,1,0,1,1,1,1,H
1905-10-07,1905,Wolverhampton Wanderers,Arsenal,0-2,0,2,1,1,2,-2,A
1905-10-14,1905,Birmingham City,Stoke City,2-0,2,0,1,1,2,2,H
1905-10-14,1905,Blackburn Rovers,Arsenal,2-0,2,0,1,1,2,2,H
1905-10-14,1905,Bury,Preston North End,1-1,1,1,1,1,2,0,D
1905-10-14,1905,Derby County,Sheffield United,1-0,1,0,1,1,1,1,H
1905-10-14,1905,Everton,Notts County,6-2,6,2,1,1,8,4,H
1905-10-14,1905,Middlesbrough,Wolverhampton Wanderers,3-1,3,1,1,1,4,2,H
1905-10-14,1905,Nottingham Forest,Aston Villa,2-2,2,2,1,1,4,0,D
1905-10-14,1905,Sheffield Wednesday,Liverpool,3-2,3,2,1,1,5,1,H
1905-10-14,1905,Sunderland,Bolton Wanderers,3-3,3,3,1,1,6,0,D
1905-10-21,1905,Arsenal,Sunderland,2-0,2,0,1,1,2,2,H
1905-10-21,1905,Aston Villa,Manchester City,2-1,2,1,1,1,3,1,H
1905-10-21,1905,Bolton Wanderers,Birmingham City,0-1,0,1,1,1,1,-1,A
1905-10-21,1905,Liverpool,Nottingham Forest,4-1,4,1,1,1,5,3,H
1905-10-21,1905,Newcastle United,Bury,3-1,3,1,1,1,4,2,H
1905-10-21,1905,Notts County,Derby County,1-0,1,0,1,1,1,1,H
1905-10-21,1905,Preston North End,Middlesbrough,2-1,2,1,1,1,3,1,H
1905-10-21,1905,Sheffield United,Sheffield Wednesday,0-2,0,2,1,1,2,-2,A
1905-10-21,1905,Stoke City,Everton,2-2,2,2,1,1,4,0,D
1905-10-21,1905,Wolverhampton Wanderers,Blackburn Rovers,2-1,2,1,1,1,3,1,H
1905-10-28,1905,Birmingham City,Arsenal,2-1,2,1,1,1,3,1,H
1905-10-28,1905,Bury,Aston Villa,0-1,0,1,1,1,1,-1,A
1905-10-28,1905,Derby County,Stoke City,1-0,1,0,1,1,1,1,H
1905-10-28,1905,Everton,Bolton Wanderers,3-1,3,1,1,1,4,2,H
1905-10-28,1905,Manchester City,Liverpool,0-1,0,1,1,1,1,-1,A
1905-10-28,1905,Newcastle United,Middlesbrough,4-1,4,1,1,1,5,3,H
1905-10-28,1905,Nottingham Forest,Sheffield United,4-1,4,1,1,1,5,3,H
1905-10-28,1905,Preston North End,Wolverhampton Wanderers,3-2,3,2,1,1,5,1,H
1905-10-28,1905,Sheffield Wednesday,Notts County,3-1,3,1,1,1,4,2,H
1905-10-28,1905,Sunderland,Blackburn Rovers,3-0,3,0,1,1,3,3,H
1905-11-04,1905,Arsenal,Everton,1-2,1,2,1,1,3,-1,A
1905-11-04,1905,Aston Villa,Middlesbrough,4-1,4,1,1,1,5,3,H
1905-11-04,1905,Blackburn Rovers,Birmingham City,5-1,5,1,1,1,6,4,H
1905-11-04,1905,Bolton Wanderers,Derby County,5-0,5,0,1,1,5,5,H
1905-11-04,1905,Liverpool,Bury,3-1,3,1,1,1,4,2,H
1905-11-04,1905,Newcastle United,Preston North End,1-0,1,0,1,1,1,1,H
1905-11-04,1905,Notts County,Nottingham Forest,1-1,1,1,1,1,2,0,D
1905-11-04,1905,Sheffield United,Manchester City,1-3,1,3,1,1,4,-2,A
1905-11-04,1905,Stoke City,Sheffield Wednesday,4-0,4,0,1,1,4,4,H
1905-11-04,1905,Wolverhampton Wanderers,Sunderland,5-2,5,2,1,1,7,3,H
1905-11-11,1905,Birmingham City,Sunderland,3-0,3,0,1,1,3,3,H
1905-11-11,1905,Bury,Sheffield United,2-5,2,5,1,1,7,-3,A
1905-11-11,1905,Derby County,Arsenal,5-1,5,1,1,1,6,4,H
1905-11-11,1905,Everton,Blackburn Rovers,3-2,3,2,1,1,5,1,H
1905-11-11,1905,Manchester City,Notts County,5-1,5,1,1,1,6,4,H
1905-11-11,1905,Middlesbrough,Liverpool,1-5,1,5,1,1,6,-4,A
1905-11-11,1905,Newcastle United,Wolverhampton Wanderers,8-0,8,0,1,1,8,8,H
1905-11-11,1905,Nottingham Forest,Stoke City,3-1,3,1,1,1,4,2,H
1905-11-11,1905,Preston North End,Aston Villa,2-0,2,0,1,1,2,2,H
1905-11-11,1905,Sheffield Wednesday,Bolton Wanderers,1-2,1,2,1,1,3,-1,A
1905-11-13,1905,Stoke City,Aston Villa,0-1,0,1,1,1,1,-1,A
1905-11-18,1905,Arsenal,Sheffield Wednesday,0-2,0,2,1,1,2,-2,A
1905-11-18,1905,Aston Villa,Newcastle United,0-3,0,3,1,1,3,-3,A
1905-11-18,1905,Blackburn Rovers,Derby County,3-0,3,0,1,1,3,3,H
1905-11-18,1905,Bolton Wanderers,Nottingham Forest,6-0,6,0,1,1,6,6,H
1905-11-18,1905,Liverpool,Preston North End,1-1,1,1,1,1,2,0,D
1905-11-18,1905,Notts County,Bury,2-2,2,2,1,1,4,0,D
1905-11-18,1905,Sheffield United,Middlesbrough,1-0,1,0,1,1,1,1,H
1905-11-18,1905,Stoke City,Manchester City,0-0,0,0,1,1,0,0,D
1905-11-18,1905,Sunderland,Everton,2-1,2,1,1,1,3,1,H
1905-11-18,1905,Wolverhampton Wanderers,Birmingham City,0-0,0,0,1,1,0,0,D
1905-11-25,1905,Aston Villa,Wolverhampton Wanderers,6-0,6,0,1,1,6,6,H
1905-11-25,1905,Bury,Stoke City,3-0,3,0,1,1,3,3,H
1905-11-25,1905,Derby County,Sunderland,1-0,1,0,1,1,1,1,H
1905-11-25,1905,Everton,Birmingham City,1-2,1,2,1,1,3,-1,A
1905-11-25,1905,Manchester City,Bolton Wanderers,3-1,3,1,1,1,4,2,H
1905-11-25,1905,Middlesbrough,Notts County,4-1,4,1,1,1,5,3,H
1905-11-25,1905,Newcastle United,Liverpool,2-3,2,3,1,1,5,-1,A
1905-11-25,1905,Nottingham Forest,Arsenal,3-1,3,1,1,1,4,2,H
1905-11-25,1905,Preston North End,Sheffield United,1-1,1,1,1,1,2,0,D
1905-11-25,1905,Sheffield Wednesday,Blackburn Rovers,0-1,0,1,1,1,1,-1,A
1905-12-02,1905,Arsenal,Manchester City,2-0,2,0,1,1,2,2,H
1905-12-02,1905,Birmingham City,Derby County,3-1,3,1,1,1,4,2,H
1905-12-02,1905,Blackburn Rovers,Nottingham Forest,1-1,1,1,1,1,2,0,D
1905-12-02,1905,Bolton Wanderers,Bury,4-0,4,0,1,1,4,4,H
1905-12-02,1905,Liverpool,Aston Villa,3-0,3,0,1,1,3,3,H
1905-12-02,1905,Notts County,Preston North End,2-2,2,2,1,1,4,0,D
1905-12-02,1905,Sheffield United,Newcastle United,2-0,2,0,1,1,2,2,H
1905-12-02,1905,Stoke City,Middlesbrough,1-1,1,1,1,1,2,0,D
1905-12-02,1905,Sunderland,Sheffield Wednesday,2-0,2,0,1,1,2,2,H
1905-12-02,1905,Wolverhampton Wanderers,Everton,2-5,2,5,1,1,7,-3,A
1905-12-09,1905,Aston Villa,Sheffield United,4-1,4,1,1,1,5,3,H
1905-12-09,1905,Bury,Arsenal,2-0,2,0,1,1,2,2,H
1905-12-09,1905,Derby County,Everton,0-0,0,0,1,1,0,0,D
1905-12-09,1905,Liverpool,Wolverhampton Wanderers,4-0,4,0,1,1,4,4,H
1905-12-09,1905,Manchester City,Blackburn Rovers,1-1,1,1,1,1,2,0,D
1905-12-09,1905,Middlesbrough,Bolton Wanderers,4-4,4,4,1,1,8,0,D
1905-12-09,1905,Newcastle United,Notts County,3-1,3,1,1,1,4,2,H
1905-12-09,1905,Nottingham Forest,Sunderland,1-2,1,2,1,1,3,-1,A
1905-12-09,1905,Preston North End,Stoke City,2-0,2,0,1,1,2,2,H
1905-12-09,1905,Sheffield Wednesday,Birmingham City,4-2,4,2,1,1,6,2,H
1905-12-16,1905,Arsenal,Middlesbrough,2-2,2,2,1,1,4,0,D
1905-12-16,1905,Birmingham City,Nottingham Forest,5-0,5,0,1,1,5,5,H
1905-12-16,1905,Blackburn Rovers,Bury,3-0,3,0,1,1,3,3,H
1905-12-16,1905,Bolton Wanderers,Preston North End,1-2,1,2,1,1,3,-1,A
1905-12-16,1905,Derby County,Wolverhampton Wanderers,2-0,2,0,1,1,2,2,H
1905-12-16,1905,Everton,Sheffield Wednesday,2-0,2,0,1,1,2,2,H
1905-12-16,1905,Notts County,Aston Villa,2-1,2,1,1,1,3,1,H
1905-12-16,1905,Sheffield United,Liverpool,1-2,1,2,1,1,3,-1,A
1905-12-16,1905,Stoke City,Newcastle United,1-0,1,0,1,1,1,1,H
1905-12-16,1905,Sunderland,Manchester City,2-0,2,0,1,1,2,2,H
1905-12-23,1905,Aston Villa,Stoke City,3-0,3,0,1,1,3,3,H
1905-12-23,1905,Bury,Sunderland,3-1,3,1,1,1,4,2,H
1905-12-23,1905,Liverpool,Notts County,2-0,2,0,1,1,2,2,H
1905-12-23,1905,Manchester City,Birmingham City,4-1,4,1,1,1,5,3,H
1905-12-23,1905,Middlesbrough,Blackburn Rovers,1-1,1,1,1,1,2,0,D
1905-12-23,1905,Newcastle United,Bolton Wanderers,2-1,2,1,1,1,3,1,H
1905-12-23,1905,Nottingham Forest,Everton,4-3,4,3,1,1,7,1,H
1905-12-23,1905,Preston North End,Arsenal,2-2,2,2,1,1,4,0,D
1905-12-23,1905,Sheffield Wednesday,Derby County,1-0,1,0,1,1,1,1,H
1905-12-23,1905,Wolverhampton Wanderers,Sheffield United,1-1,1,1,1,1,2,0,D
1905-12-25,1905,Arsenal,Newcastle United,4-3,4,3,1,1,7,1,H
1905-12-25,1905,Bury,Everton,3-2,3,2,1,1,5,1,H
1905-12-25,1905,Derby County,Manchester City,1-2,1,2,1,1,3,-1,A
1905-12-25,1905,Liverpool,Bolton Wanderers,2-2,2,2,1,1,4,0,D
1905-12-25,1905,Middlesbrough,Birmingham City,1-0,1,0,1,1,1,1,H
1905-12-25,1905,Nottingham Forest,Notts County,1-2,1,2,1,1,3,-1,A
1905-12-25,1905,Preston North End,Sunderland,1-1,1,1,1,1,2,0,D
1905-12-25,1905,Sheffield United,Stoke City,1-1,1,1,1,1,2,0,D
1905-12-26,1905,Aston Villa,Bolton Wanderers,1-1,1,1,1,1,2,0,D
1905-12-26,1905,Birmingham City,Middlesbrough,7-0,7,0,1,1,7,7,H
1905-12-26,1905,Derby County,Nottingham Forest,2-2,2,2,1,1,4,0,D
1905-12-26,1905,Everton,Bury,1-2,1,2,1,1,3,-1,A
1905-12-26,1905,Manchester City,Newcastle United,1-4,1,4,1,1,5,-3,A
1905-12-26,1905,Notts County,Sheffield United,2-3,2,3,1,1,5,-1,A
1905-12-26,1905,Sheffield Wednesday,Wolverhampton Wanderers,5-1,5,1,1,1,6,4,H
1905-12-26,1905,Stoke City,Liverpool,2-1,2,1,1,1,3,1,H
1905-12-27,1905,Aston Villa,Arsenal,2-1,2,1,1,1,3,1,H
1905-12-27,1905,Notts County,Sunderland,4-1,4,1,1,1,5,3,H
1905-12-27,1905,Sheffield Wednesday,Nottingham Forest,1-0,1,0,1,1,1,1,H
1905-12-28,1905,Sheffield United,Birmingham City,3-0,3,0,1,1,3,3,H
1905-12-30,1905,Aston Villa,Blackburn Rovers,0-1,0,1,1,1,1,-1,A
1905-12-30,1905,Bury,Derby County,0-2,0,2,1,1,2,-2,A
1905-12-30,1905,Liverpool,Arsenal,3-0,3,0,1,1,3,3,H
1905-12-30,1905,Manchester City,Sheffield Wednesday,2-1,2,1,1,1,3,1,H
1905-12-30,1905,Middlesbrough,Everton,0-0,0,0,1,1,0,0,D
1905-12-30,1905,Newcastle United,Sunderland,1-1,1,1,1,1,2,0,D
1905-12-30,1905,Notts County,Stoke City,1-1,1,1,1,1,2,0,D
1905-12-30,1905,Preston North End,Birmingham City,3-0,3,0,1,1,3,3,H
1905-12-30,1905,Sheffield United,Bolton Wanderers,5-2,5,2,1,1,7,3,H
1905-12-30,1905,Wolverhampton Wanderers,Nottingham Forest,2-1,2,1,1,1,3,1,H
1906-01-01,1905,Blackburn Rovers,Newcastle United,1-0,1,0,1,1,1,1,H
1906-01-01,1905,Bolton Wanderers,Arsenal,6-1,6,1,1,1,7,5,H
1906-01-01,1905,Bury,Birmingham City,1-0,1,0,1,1,1,1,H
1906-01-01,1905,Liverpool,Stoke City,3-1,3,1,1,1,4,2,H
1906-01-01,1905,Manchester City,Everton,1-0,1,0,1,1,1,1,H
1906-01-01,1905,Sheffield United,Notts County,1-0,1,0,1,1,1,1,H
1906-01-01,1905,Sunderland,Middlesbrough,2-1,2,1,1,1,3,1,H
1906-01-02,1905,Bolton Wanderers,Aston Villa,4-1,4,1,1,1,5,3,H
1906-01-06,1905,Arsenal,Sheffield United,5-1,5,1,1,1,6,4,H
1906-01-06,1905,Birmingham City,Newcastle United,0-1,0,1,1,1,1,-1,A
1906-01-06,1905,Blackburn Rovers,Liverpool,0-0,0,0,1,1,0,0,D
1906-01-06,1905,Derby County,Middlesbrough,1-1,1,1,1,1,2,0,D
1906-01-06,1905,Everton,Preston North End,1-0,1,0,1,1,1,1,H
1906-01-06,1905,Nottingham Forest,Manchester City,0-1,0,1,1,1,1,-1,A
1906-01-06,1905,Sheffield Wednesday,Bury,1-1,1,1,1,1,2,0,D
1906-01-06,1905,Stoke City,Wolverhampton Wanderers,4-0,4,0,1,1,4,4,H
1906-01-20,1905,Aston Villa,Birmingham City,1-3,1,3,1,1,4,-2,A
1906-01-20,1905,Bury,Nottingham Forest,2-1,2,1,1,1,3,1,H
1906-01-20,1905,Liverpool,Sunderland,2-0,2,0,1,1,2,2,H
1906-01-20,1905,Middlesbrough,Sheffield Wednesday,2-2,2,2,1,1,4,0,D
1906-01-20,1905,Newcastle United,Everton,4-2,4,2,1,1,6,2,H
1906-01-20,1905,Notts County,Arsenal,1-0,1,0,1,1,1,1,H
1906-01-20,1905,Preston North End,Derby County,3-1,3,1,1,1,4,2,H
1906-01-20,1905,Sheffield United,Blackburn Rovers,0-2,0,2,1,1,2,-2,A
1906-01-20,1905,Stoke City,Bolton Wanderers,1-2,1,2,1,1,3,-1,A
1906-01-20,1905,Wolverhampton Wanderers,Manchester City,2-3,2,3,1,1,5,-1,A
1906-01-27,1905,Arsenal,Stoke City,1-2,1,2,1,1,3,-1,A
1906-01-27,1905,Birmingham City,Liverpool,1-0,1,0,1,1,1,1,H
1906-01-27,1905,Blackburn Rovers,Notts County,1-3,1,3,1,1,4,-2,A
1906-01-27,1905,Bolton Wanderers,Wolverhampton Wanderers,3-2,3,2,1,1,5,1,H
1906-01-27,1905,Derby County,Newcastle United,2-1,2,1,1,1,3,1,H
1906-01-27,1905,Everton,Aston Villa,4-2,4,2,1,1,6,2,H
1906-01-27,1905,Manchester City,Bury,5-2,5,2,1,1,7,3,H
1906-01-27,1905,Nottingham Forest,Middlesbrough,2-1,2,1,1,1,3,1,H
1906-01-27,1905,Sheffield Wednesday,Preston North End,1-1,1,1,1,1,2,0,D
1906-01-27,1905,Sunderland,Sheffield United,2-0,2,0,1,1,2,2,H
1906-02-03,1905,Bolton Wanderers,Notts County,2-0,2,0,1,1,2,2,H
1906-02-03,1905,Preston North End,Blackburn Rovers,2-1,2,1,1,1,3,1,H
1906-02-10,1905,Arsenal,Wolverhampton Wanderers,2-1,2,1,1,1,3,1,H
1906-02-10,1905,Birmingham City,Notts County,4-2,4,2,1,1,6,2,H
1906-02-10,1905,Bury,Middlesbrough,1-1,1,1,1,1,2,0,D
1906-02-10,1905,Derby County,Liverpool,0-3,0,3,1,1,3,-3,A
1906-02-10,1905,Everton,Sheffield United,3-2,3,2,1,1,5,1,H
1906-02-10,1905,Manchester City,Preston North End,0-0,0,0,1,1,0,0,D
1906-02-10,1905,Nottingham Forest,Newcastle United,2-1,2,1,1,1,3,1,H
1906-02-10,1905,Sheffield Wednesday,Aston Villa,2-2,2,2,1,1,4,0,D
1906-02-10,1905,Sunderland,Stoke City,1-0,1,0,1,1,1,1,H
1906-02-17,1905,Arsenal,Blackburn Rovers,3-2,3,2,1,1,5,1,H
1906-02-17,1905,Aston Villa,Nottingham Forest,3-1,3,1,1,1,4,2,H
1906-02-17,1905,Bolton Wanderers,Sunderland,6-2,6,2,1,1,8,4,H
1906-02-17,1905,Liverpool,Sheffield Wednesday,2-1,2,1,1,1,3,1,H
1906-02-17,1905,Notts County,Everton,0-0,0,0,1,1,0,0,D
1906-02-17,1905,Preston North End,Bury,1-0,1,0,1,1,1,1,H
1906-02-17,1905,Sheffield United,Derby County,1-0,1,0,1,1,1,1,H
1906-02-17,1905,Stoke City,Birmingham City,2-2,2,2,1,1,4,0,D
1906-02-17,1905,Wolverhampton Wanderers,Middlesbrough,0-0,0,0,1,1,0,0,D
1906-02-24,1905,Blackburn Rovers,Wolverhampton Wanderers,3-1,3,1,1,1,4,2,H
1906-02-24,1905,Derby County,Notts County,1-1,1,1,1,1,2,0,D
1906-02-28,1905,Sunderland,Aston Villa,2-0,2,0,1,1,2,2,H
1906-03-03,1905,Arsenal,Birmingham City,5-0,5,0,1,1,5,5,H
1906-03-03,1905,Aston Villa,Bury,3-3,3,3,1,1,6,0,D
1906-03-03,1905,Blackburn Rovers,Sunderland,0-3,0,3,1,1,3,-3,A
1906-03-03,1905,Bolton Wanderers,Everton,3-2,3,2,1,1,5,1,H
1906-03-03,1905,Liverpool,Manchester City,0-1,0,1,1,1,1,-1,A
1906-03-03,1905,Middlesbrough,Newcastle United,1-0,1,0,1,1,1,1,H
1906-03-03,1905,Notts County,Sheffield Wednesday,1-3,1,3,1,1,4,-2,A
1906-03-03,1905,Sheffield United,Nottingham Forest,1-4,1,4,1,1,5,-3,A
1906-03-03,1905,Stoke City,Derby County,2-2,2,2,1,1,4,0,D
1906-03-03,1905,Wolverhampton Wanderers,Preston North End,2-3,2,3,1,1,5,-1,A
1906-03-10,1905,Derby County,Bolton Wanderers,0-1,0,1,1,1,1,-1,A
1906-03-10,1905,Manchester City,Sheffield United,1-2,1,2,1,1,3,-1,A
1906-03-10,1905,Middlesbrough,Aston Villa,1-2,1,2,1,1,3,-1,A
1906-03-10,1905,Sunderland,Wolverhampton Wanderers,7-2,7,2,1,1,9,5,H
1906-03-14,1905,Manchester City,Aston Villa,1-4,1,4,1,1,5,-3,A
1906-03-14,1905,Middlesbrough,Preston North End,1-2,1,2,1,1,3,-1,A
1906-03-14,1905,Nottingham Forest,Liverpool,1-2,1,2,1,1,3,-1,A
1906-03-17,1905,Arsenal,Derby County,1-0,1,0,1,1,1,1,H
1906-03-17,1905,Aston Villa,Preston North End,0-1,0,1,1,1,1,-1,A
1906-03-17,1905,Blackburn Rovers,Everton,1-2,1,2,1,1,3,-1,A
1906-03-17,1905,Bolton Wanderers,Sheffield Wednesday,1-0,1,0,1,1,1,1,H
1906-03-17,1905,Liverpool,Middlesbrough,6-1,6,1,1,1,7,5,H
1906-03-17,1905,Notts County,Manchester City,3-0,3,0,1,1,3,3,H
1906-03-17,1905,Sheffield United,Bury,1-1,1,1,1,1,2,0,D
1906-03-17,1905,Stoke City,Nottingham Forest,4-0,4,0,1,1,4,4,H
1906-03-17,1905,Sunderland,Birmingham City,3-1,3,1,1,1,4,2,H
1906-03-17,1905,Wolverhampton Wanderers,Newcastle United,0-2,0,2,1,1,2,-2,A
1906-03-19,1905,Sheffield United,Wolverhampton Wanderers,4-1,4,1,1,1,5,3,H
1906-03-21,1905,Everton,Arsenal,0-1,0,1,1,1,1,-1,A
1906-03-21,1905,Notts County,Liverpool,3-0,3,0,1,1,3,3,H
1906-03-24,1905,Birmingham City,Wolverhampton Wanderers,3-3,3,3,1,1,6,0,D
1906-03-24,1905,Bury,Notts County,0-0,0,0,1,1,0,0,D
1906-03-24,1905,Derby County,Blackburn Rovers,1-2,1,2,1,1,3,-1,A
1906-03-24,1905,Everton,Sunderland,3-1,3,1,1,1,4,2,H
1906-03-24,1905,Manchester City,Stoke City,2-0,2,0,1,1,2,2,H
1906-03-24,1905,Middlesbrough,Sheffield United,0-1,0,1,1,1,1,-1,A
1906-03-24,1905,Newcastle United,Aston Villa,3-1,3,1,1,1,4,2,H
1906-03-24,1905,Nottingham Forest,Bolton Wanderers,4-0,4,0,1,1,4,4,H
1906-03-24,1905,Preston North End,Liverpool,1-2,1,2,1,1,3,-1,A
1906-03-24,1905,Sheffield Wednesday,Arsenal,4-2,4,2,1,1,6,2,H
1906-03-26,1905,Birmingham City,Bolton Wanderers,2-5,2,5,1,1,7,-3,A
1906-03-26,1905,Stoke City,Bury,4-2,4,2,1,1,6,2,H
1906-03-31,1905,Blackburn Rovers,Sheffield Wednesday,1-0,1,0,1,1,1,1,H
1906-03-31,1905,Bolton Wanderers,Manchester City,1-3,1,3,1,1,4,-2,A
1906-03-31,1905,Notts County,Middlesbrough,1-1,1,1,1,1,2,0,D
1906-03-31,1905,Sheffield United,Preston North End,0-0,0,0,1,1,0,0,D
1906-03-31,1905,Sunderland,Derby County,2-0,2,0,1,1,2,2,H
1906-03-31,1905,Wolverhampton Wanderers,Aston Villa,4-1,4,1,1,1,5,3,H
1906-04-02,1905,Arsenal,Nottingham Forest,3-1,3,1,1,1,4,2,H
1906-04-02,1905,Blackburn Rovers,Bolton Wanderers,4-1,4,1,1,1,5,3,H
1906-04-02,1905,Bury,Liverpool,0-0,0,0,1,1,0,0,D
1906-04-03,1905,Everton,Stoke City,0-3,0,3,1,1,3,-3,A
1906-04-04,1905,Newcastle United,Sheffield United,2-1,2,1,1,1,3,1,H
1906-04-07,1905,Bury,Bolton Wanderers,2-1,2,1,1,1,3,1,H
1906-04-07,1905,Derby County,Birmingham City,0-0,0,0,1,1,0,0,D
1906-04-07,1905,Everton,Wolverhampton Wanderers,2-2,2,2,1,1,4,0,D
1906-04-07,1905,Manchester City,Arsenal,1-2,1,2,1,1,3,-1,A
1906-04-07,1905,Middlesbrough,Stoke City,5-0,5,0,1,1,5,5,H
1906-04-07,1905,Nottingham Forest,Blackburn Rovers,1-2,1,2,1,1,3,-1,A
1906-04-07,1905,Preston North End,Notts County,4-1,4,1,1,1,5,3,H
1906-04-07,1905,Sheffield Wednesday,Sunderland,3-3,3,3,1,1,6,0,D
1906-04-09,1905,Birmingham City,Everton,1-0,1,0,1,1,1,1,H
1906-04-09,1905,Liverpool,Newcastle United,3-0,3,0,1,1,3,3,H
1906-04-09,1905,Sheffield Wednesday,Stoke City,2-0,2,0,1,1,2,2,H
1906-04-13,1905,Arsenal,Aston Villa,2-1,2,1,1,1,3,1,H
1906-04-13,1905,Blackburn Rovers,Preston North End,1-2,1,2,1,1,3,-1,A
1906-04-13,1905,Bury,Newcastle United,1-4,1,4,1,1,5,-3,A
1906-04-13,1905,Liverpool,Everton,1-1,1,1,1,1,2,0,D
1906-04-13,1905,Manchester City,Derby County,1-2,1,2,1,1,3,-1,A
1906-04-13,1905,Middlesbrough,Sunderland,2-1,2,1,1,1,3,1,H
1906-04-14,1905,Arsenal,Bury,4-0,4,0,1,1,4,4,H
1906-04-14,1905,Birmingham City,Sheffield Wednesday,5-1,5,1,1,1,6,4,H
1906-04-14,1905,Blackburn Rovers,Manchester City,1-1,1,1,1,1,2,0,D
1906-04-14,1905,Bolton Wanderers,Middlesbrough,2-1,2,1,1,1,3,1,H
1906-04-14,1905,Everton,Derby County,2-1,2,1,1,1,3,1,H
1906-04-14,1905,Notts County,Newcastle United,1-0,1,0,1,1,1,1,H
1906-04-14,1905,Sheffield United,Aston Villa,1-1,1,1,1,1,2,0,D
1906-04-14,1905,Stoke City,Preston North End,3-0,3,0,1,1,3,3,H
1906-04-14,1905,Sunderland,Nottingham Forest,0-1,0,1,1,1,1,-1,A
1906-04-14,1905,Wolverhampton Wanderers,Liverpool,0-2,0,2,1,1,2,-2,A
1906-04-16,1905,Aston Villa,Derby County,6-0,6,0,1,1,6,6,H
1906-04-16,1905,Birmingham City,Bury,0-3,0,3,1,1,3,-3,A
1906-04-16,1905,Bolton Wanderers,Liverpool,3-2,3,2,1,1,5,1,H
1906-04-16,1905,Everton,Manchester City,0-3,0,3,1,1,3,-3,A
1906-04-16,1905,Newcastle United,Arsenal,1-1,1,1,1,1,2,0,D
1906-04-16,1905,Nottingham Forest,Sheffield Wednesday,3-4,3,4,1,1,7,-1,A
1906-04-16,1905,Stoke City,Sheffield United,2-1,2,1,1,1,3,1,H
1906-04-16,1905,Sunderland,Preston North End,2-0,2,0,1,1,2,2,H
1906-04-16,1905,Wolverhampton Wanderers,Notts County,6-1,6,1,1,1,7,5,H
1906-04-17,1905,Middlesbrough,Manchester City,6-1,6,1,1,1,7,5,H
1906-04-17,1905,Nottingham Forest,Derby County,0-0,0,0,1,1,0,0,D
1906-04-18,1905,Sheffield Wednesday,Sheffield United,1-0,1,0,1,1,1,1,H
1906-04-21,1905,Aston Villa,Notts County,2-1,2,1,1,1,3,1,H
1906-04-21,1905,Bury,Blackburn Rovers,5-0,5,0,1,1,5,5,H
1906-04-21,1905,Liverpool,Sheffield United,3-1,3,1,1,1,4,2,H
1906-04-21,1905,Manchester City,Sunderland,5-1,5,1,1,1,6,4,H
1906-04-21,1905,Middlesbrough,Arsenal,2-0,2,0,1,1,2,2,H
1906-04-21,1905,Nottingham Forest,Birmingham City,2-1,2,1,1,1,3,1,H
1906-04-21,1905,Preston North End,Bolton Wanderers,3-0,3,0,1,1,3,3,H
1906-04-21,1905,Wolverhampton Wanderers,Derby County,7-0,7,0,1,1,7,7,H
1906-04-23,1905,Birmingham City,Blackburn Rovers,3-0,3,0,1,1,3,3,H
1906-04-23,1905,Sheffield Wednesday,Everton,3-1,3,1,1,1,4,2,H
1906-04-24,1905,Newcastle United,Stoke City,5-0,5,0,1,1,5,5,H
1906-04-25,1905,Sunderland,Arsenal,2-2,2,2,1,1,4,0,D
1906-04-26,1905,Preston North End,Newcastle United,0-0,0,0,1,1,0,0,D
1906-04-28,1905,Birmingham City,Manchester City,3-2,3,2,1,1,5,1,H
1906-04-28,1905,Blackburn Rovers,Middlesbrough,1-1,1,1,1,1,2,0,D
1906-04-28,1905,Bolton Wanderers,Newcastle United,1-1,1,1,1,1,2,0,D
1906-04-28,1905,Derby County,Sheffield Wednesday,2-1,2,1,1,1,3,1,H
1906-04-28,1905,Everton,Nottingham Forest,4-1,4,1,1,1,5,3,H
1906-04-28,1905,Sunderland,Bury,0-3,0,3,1,1,3,-3,A
1906-04-30,1905,Newcastle United,Blackburn Rovers,3-0,3,0,1,1,3,3,H
1906-09-01,1906,Aston Villa,Blackburn Rovers,4-2,4,2,1,1,6,2,H
1906-09-01,1906,Bristol City,Manchester United,1-2,1,2,1,1,3,-1,A
1906-09-01,1906,Bury,Sheffield Wednesday,0-0,0,0,1,1,0,0,D
1906-09-01,1906,Liverpool,Stoke City,1-0,1,0,1,1,1,1,H
1906-09-01,1906,Manchester City,Arsenal,1-4,1,4,1,1,5,-3,A
1906-09-01,1906,Middlesbrough,Everton,2-2,2,2,1,1,4,0,D
1906-09-01,1906,Newcastle United,Sunderland,4-2,4,2,1,1,6,2,H
1906-09-01,1906,Notts County,Bolton Wanderers,0-0,0,0,1,1,0,0,D
1906-09-01,1906,Preston North End,Birmingham City,2-0,2,0,1,1,2,2,H
1906-09-01,1906,Sheffield United,Derby County,2-0,2,0,1,1,2,2,H
1906-09-03,1906,Birmingham City,Bristol City,2-2,2,2,1,1,4,0,D
1906-09-03,1906,Bury,Arsenal,4-1,4,1,1,1,5,3,H
1906-09-03,1906,Derby County,Manchester United,2-2,2,2,1,1,4,0,D
1906-09-03,1906,Everton,Manchester City,9-1,9,1,1,1,10,8,H
1906-09-03,1906,Sheffield Wednesday,Newcastle United,2-2,2,2,1,1,4,0,D
1906-09-03,1906,Stoke City,Aston Villa,0-2,0,2,1,1,2,-2,A
1906-09-08,1906,Arsenal,Middlesbrough,2-0,2,0,1,1,2,2,H
1906-09-08,1906,Birmingham City,Newcastle United,2-4,2,4,1,1,6,-2,A
1906-09-08,1906,Blackburn Rovers,Liverpool,1-1,1,1,1,1,2,0,D
1906-09-08,1906,Bolton Wanderers,Sheffield United,6-1,6,1,1,1,7,5,H
1906-09-08,1906,Derby County,Bury,2-1,2,1,1,1,3,1,H
1906-09-08,1906,Everton,Preston North End,1-0,1,0,1,1,1,1,H
1906-09-08,1906,Manchester United,Notts County,0-0,0,0,1,1,0,0,D
1906-09-08,1906,Sheffield Wednesday,Manchester City,3-1,3,1,1,1,4,2,H
1906-09-08,1906,Stoke City,Bristol City,0-3,0,3,1,1,3,-3,A
1906-09-08,1906,Sunderland,Aston Villa,2-1,2,1,1,1,3,1,H
1906-09-10,1906,Aston Villa,Stoke City,1-0,1,0,1,1,1,1,H
1906-09-10,1906,Liverpool,Bury,2-2,2,2,1,1,4,0,D
1906-09-15,1906,Aston Villa,Birmingham City,4-1,4,1,1,1,5,3,H
1906-09-15,1906,Bolton Wanderers,Derby County,1-0,1,0,1,1,1,1,H
1906-09-15,1906,Bristol City,Blackburn Rovers,3-0,3,0,1,1,3,3,H
1906-09-15,1906,Liverpool,Sunderland,1-2,1,2,1,1,3,-1,A
1906-09-15,1906,Manchester City,Bury,2-2,2,2,1,1,4,0,D
1906-09-15,1906,Middlesbrough,Sheffield Wednesday,1-3,1,3,1,1,4,-2,A
1906-09-15,1906,Newcastle United,Everton,1-0,1,0,1,1,1,1,H
1906-09-15,1906,Notts County,Stoke City,2-2,2,2,1,1,4,0,D
1906-09-15,1906,Preston North End,Arsenal,0-3,0,3,1,1,3,-3,A
1906-09-15,1906,Sheffield United,Manchester United,0-2,0,2,1,1,2,-2,A
1906-09-17,1906,Everton,Notts County,2-2,2,2,1,1,4,0,D
1906-09-22,1906,Arsenal,Newcastle United,2-0,2,0,1,1,2,2,H
1906-09-22,1906,Birmingham City,Liverpool,2-1,2,1,1,1,3,1,H
1906-09-22,1906,Blackburn Rovers,Notts County,0-2,0,2,1,1,2,-2,A
1906-09-22,1906,Bury,Middlesbrough,1-1,1,1,1,1,2,0,D
1906-09-22,1906,Derby County,Manchester City,2-2,2,2,1,1,4,0,D
1906-09-22,1906,Everton,Aston Villa,1-2,1,2,1,1,3,-1,A
1906-09-22,1906,Manchester United,Bolton Wanderers,1-2,1,2,1,1,3,-1,A
1906-09-22,1906,Sheffield Wednesday,Preston North End,2-1,2,1,1,1,3,1,H
1906-09-22,1906,Stoke City,Sheffield United,1-1,1,1,1,1,2,0,D
1906-09-22,1906,Sunderland,Bristol City,3-3,3,3,1,1,6,0,D
1906-09-29,1906,Aston Villa,Arsenal,2-2,2,2,1,1,4,0,D
1906-09-29,1906,Bolton Wanderers,Stoke City,1-1,1,1,1,1,2,0,D
1906-09-29,1906,Bristol City,Birmingham City,0-0,0,0,1,1,0,0,D
1906-09-29,1906,Liverpool,Everton,1-2,1,2,1,1,3,-1,A
1906-09-29,1906,Manchester United,Derby County,1-1,1,1,1,1,2,0,D
1906-09-29,1906,Middlesbrough,Manchester City,2-3,2,3,1,1,5,-1,A
1906-09-29,1906,Newcastle United,Sheffield Wednesday,5-1,5,1,1,1,6,4,H
1906-09-29,1906,Notts County,Sunderland,0-0,0,0,1,1,0,0,D
1906-09-29,1906,Preston North End,Bury,3-2,3,2,1,1,5,1,H
1906-09-29,1906,Sheffield United,Blackburn Rovers,3-0,3,0,1,1,3,3,H
1906-10-06,1906,Arsenal,Liverpool,2-1,2,1,1,1,3,1,H
1906-10-06,1906,Birmingham City,Notts County,2-0,2,0,1,1,2,2,H
1906-10-06,1906,Blackburn Rovers,Bolton Wanderers,2-3,2,3,1,1,5,-1,A
1906-10-06,1906,Bury,Newcastle United,3-2,3,2,1,1,5,1,H
1906-10-06,1906,Derby County,Middlesbrough,1-0,1,0,1,1,1,1,H
1906-10-06,1906,Everton,Bristol City,2-0,2,0,1,1,2,2,H
1906-10-06,1906,Manchester City,Preston North End,1-1,1,1,1,1,2,0,D
1906-10-06,1906,Sheffield Wednesday,Aston Villa,2-1,2,1,1,1,3,1,H
1906-10-06,1906,Stoke City,Manchester United,1-2,1,2,1,1,3,-1,A
1906-10-06,1906,Sunderland,Sheffield United,1-2,1,2,1,1,3,-1,A
1906-10-13,1906,Aston Villa,Bury,3-1,3,1,1,1,4,2,H
1906-10-13,1906,Bolton Wanderers,Sunderland,1-0,1,0,1,1,1,1,H
1906-10-13,1906,Bristol City,Arsenal,1-3,1,3,1,1,4,-2,A
1906-10-13,1906,Liverpool,Sheffield Wednesday,1-2,1,2,1,1,3,-1,A
1906-10-13,1906,Manchester United,Blackburn Rovers,1-1,1,1,1,1,2,0,D
1906-10-13,1906,Newcastle United,Manchester City,2-0,2,0,1,1,2,2,H
1906-10-13,1906,Notts County,Everton,0-1,0,1,1,1,1,-1,A
1906-10-13,1906,Preston North End,Middlesbrough,4-2,4,2,1,1,6,2,H
1906-10-13,1906,Sheffield United,Birmingham City,2-0,2,0,1,1,2,2,H
1906-10-13,1906,Stoke City,Derby County,2-1,2,1,1,1,3,1,H
1906-10-20,1906,Arsenal,Notts County,1-0,1,0,1,1,1,1,H
1906-10-20,1906,Birmingham City,Bolton Wanderers,4-2,4,2,1,1,6,2,H
1906-10-20,1906,Blackburn Rovers,Stoke City,3-1,3,1,1,1,4,2,H
1906-10-20,1906,Bury,Liverpool,1-3,1,3,1,1,4,-2,A
1906-10-20,1906,Derby County,Preston North End,3-0,3,0,1,1,3,3,H
1906-10-20,1906,Everton,Sheffield United,4-2,4,2,1,1,6,2,H
1906-10-20,1906,Manchester City,Aston Villa,4-2,4,2,1,1,6,2,H
1906-10-20,1906,Middlesbrough,Newcastle United,0-3,0,3,1,1,3,-3,A
1906-10-20,1906,Sheffield Wednesday,Bristol City,3-0,3,0,1,1,3,3,H
1906-10-20,1906,Sunderland,Manchester United,4-1,4,1,1,1,5,3,H
1906-10-27,1906,Aston Villa,Middlesbrough,2-3,2,3,1,1,5,-1,A
1906-10-27,1906,Blackburn Rovers,Derby County,5-1,5,1,1,1,6,4,H
1906-10-27,1906,Bolton Wanderers,Everton,1-3,1,3,1,1,4,-2,A
1906-10-27,1906,Bristol City,Bury,2-0,2,0,1,1,2,2,H
1906-10-27,1906,Liverpool,Manchester City,5-4,5,4,1,1,9,1,H
1906-10-27,1906,Manchester United,Birmingham City,2-1,2,1,1,1,3,1,H
1906-10-27,1906,Newcastle United,Preston North End,2-1,2,1,1,1,3,1,H
1906-10-27,1906,Notts County,Sheffield Wednesday,2-2,2,2,1,1,4,0,D
1906-10-27,1906,Sheffield United,Arsenal,4-2,4,2,1,1,6,2,H
1906-10-27,1906,Stoke City,Sunderland,2-2,2,2,1,1,4,0,D
1906-11-03,1906,Arsenal,Bolton Wanderers,2-2,2,2,1,1,4,0,D
1906-11-03,1906,Birmingham City,Stoke City,2-1,2,1,1,1,3,1,H
1906-11-03,1906,Bury,Notts County,3-0,3,0,1,1,3,3,H
1906-11-03,1906,Derby County,Newcastle United,0-0,0,0,1,1,0,0,D
1906-11-03,1906,Everton,Manchester United,3-0,3,0,1,1,3,3,H
1906-11-03,1906,Manchester City,Bristol City,0-1,0,1,1,1,1,-1,A
1906-11-03,1906,Middlesbrough,Liverpool,0-1,0,1,1,1,1,-1,A
1906-11-03,1906,Preston North End,Aston Villa,2-0,2,0,1,1,2,2,H
1906-11-03,1906,Sheffield Wednesday,Sheffield United,2-2,2,2,1,1,4,0,D
1906-11-03,1906,Sunderland,Blackburn Rovers,1-0,1,0,1,1,1,1,H
1906-11-10,1906,Aston Villa,Newcastle United,0-0,0,0,1,1,0,0,D
1906-11-10,1906,Blackburn Rovers,Birmingham City,1-0,1,0,1,1,1,1,H
1906-11-10,1906,Bolton Wanderers,Sheffield Wednesday,0-0,0,0,1,1,0,0,D
1906-11-10,1906,Bristol City,Middlesbrough,3-0,3,0,1,1,3,3,H
1906-11-10,1906,Liverpool,Preston North End,6-1,6,1,1,1,7,5,H
1906-11-10,1906,Manchester United,Arsenal,1-0,1,0,1,1,1,1,H
1906-11-10,1906,Notts County,Manchester City,0-0,0,0,1,1,0,0,D
1906-11-10,1906,Sheffield United,Bury,3-0,3,0,1,1,3,3,H
1906-11-10,1906,Stoke City,Everton,2-0,2,0,1,1,2,2,H
1906-11-10,1906,Sunderland,Derby County,0-2,0,2,1,1,2,-2,A
1906-11-12,1906,Stoke City,Blackburn Rovers,1-1,1,1,1,1,2,0,D
1906-11-17,1906,Arsenal,Stoke City,2-1,2,1,1,1,3,1,H
1906-11-17,1906,Birmingham City,Sunderland,2-0,2,0,1,1,2,2,H
1906-11-17,1906,Bury,Bolton Wanderers,2-3,2,3,1,1,5,-1,A
1906-11-17,1906,Derby County,Aston Villa,0-1,0,1,1,1,1,-1,A
1906-11-17,1906,Everton,Blackburn Rovers,2-0,2,0,1,1,2,2,H
1906-11-17,1906,Manchester City,Sheffield United,0-2,0,2,1,1,2,-2,A
1906-11-17,1906,Middlesbrough,Notts County,2-0,2,0,1,1,2,2,H
1906-11-17,1906,Newcastle United,Liverpool,2-0,2,0,1,1,2,2,H
1906-11-17,1906,Preston North End,Bristol City,3-1,3,1,1,1,4,2,H
1906-11-17,1906,Sheffield Wednesday,Manchester United,5-2,5,2,1,1,7,3,H
1906-11-24,1906,Birmingham City,Derby County,2-1,2,1,1,1,3,1,H
1906-11-24,1906,Blackburn Rovers,Arsenal,2-3,2,3,1,1,5,-1,A
1906-11-24,1906,Bolton Wanderers,Manchester City,1-1,1,1,1,1,2,0,D
1906-11-24,1906,Bristol City,Newcastle United,2-1,2,1,1,1,3,1,H
1906-11-24,1906,Liverpool,Aston Villa,5-2,5,2,1,1,7,3,H
1906-11-24,1906,Manchester United,Bury,2-4,2,4,1,1,6,-2,A
1906-11-24,1906,Notts County,Preston North End,0-0,0,0,1,1,0,0,D
1906-11-24,1906,Sheffield United,Middlesbrough,1-1,1,1,1,1,2,0,D
1906-11-24,1906,Stoke City,Sheffield Wednesday,1-1,1,1,1,1,2,0,D
1906-11-24,1906,Sunderland,Everton,1-0,1,0,1,1,1,1,H
1906-12-01,1906,Arsenal,Sunderland,0-1,0,1,1,1,1,-1,A
1906-12-01,1906,Aston Villa,Bristol City,3-2,3,2,1,1,5,1,H
1906-12-01,1906,Bury,Stoke City,2-0,2,0,1,1,2,2,H
1906-12-01,1906,Derby County,Liverpool,0-1,0,1,1,1,1,-1,A
1906-12-01,1906,Everton,Birmingham City,3-0,3,0,1,1,3,3,H
1906-12-01,1906,Manchester City,Manchester United,3-0,3,0,1,1,3,3,H
1906-12-01,1906,Middlesbrough,Bolton Wanderers,0-0,0,0,1,1,0,0,D
1906-12-01,1906,Newcastle United,Notts County,4-3,4,3,1,1,7,1,H
1906-12-01,1906,Preston North End,Sheffield United,2-1,2,1,1,1,3,1,H
1906-12-01,1906,Sheffield Wednesday,Blackburn Rovers,3-1,3,1,1,1,4,2,H
1906-12-08,1906,Birmingham City,Arsenal,5-1,5,1,1,1,6,4,H
1906-12-08,1906,Blackburn Rovers,Bury,4-1,4,1,1,1,5,3,H
1906-12-08,1906,Bristol City,Liverpool,3-1,3,1,1,1,4,2,H
1906-12-08,1906,Everton,Derby County,2-0,2,0,1,1,2,2,H
1906-12-08,1906,Manchester United,Middlesbrough,3-1,3,1,1,1,4,2,H
1906-12-08,1906,Notts County,Aston Villa,1-1,1,1,1,1,2,0,D
1906-12-08,1906,Preston North End,Bolton Wanderers,3-1,3,1,1,1,4,2,H
1906-12-08,1906,Sheffield United,Newcastle United,0-0,0,0,1,1,0,0,D
1906-12-08,1906,Stoke City,Manchester City,3-0,3,0,1,1,3,3,H
1906-12-08,1906,Sunderland,Sheffield Wednesday,1-1,1,1,1,1,2,0,D
1906-12-15,1906,Arsenal,Everton,3-1,3,1,1,1,4,2,H
1906-12-15,1906,Aston Villa,Sheffield United,5-1,5,1,1,1,6,4,H
1906-12-15,1906,Bristol City,Derby County,3-0,3,0,1,1,3,3,H
1906-12-15,1906,Bury,Sunderland,2-3,2,3,1,1,5,-1,A
1906-12-15,1906,Liverpool,Notts County,5-1,5,1,1,1,6,4,H
1906-12-15,1906,Manchester City,Blackburn Rovers,0-0,0,0,1,1,0,0,D
1906-12-15,1906,Middlesbrough,Stoke City,5-0,5,0,1,1,5,5,H
1906-12-15,1906,Newcastle United,Bolton Wanderers,4-0,4,0,1,1,4,4,H
1906-12-15,1906,Preston North End,Manchester United,2-0,2,0,1,1,2,2,H
1906-12-15,1906,Sheffield Wednesday,Birmingham City,0-1,0,1,1,1,1,-1,A
1906-12-22,1906,Birmingham City,Bury,3-1,3,1,1,1,4,2,H
1906-12-22,1906,Blackburn Rovers,Middlesbrough,4-1,4,1,1,1,5,3,H
1906-12-22,1906,Bolton Wanderers,Aston Villa,1-2,1,2,1,1,3,-1,A
1906-12-22,1906,Derby County,Arsenal,0-0,0,0,1,1,0,0,D
1906-12-22,1906,Everton,Sheffield Wednesday,2-0,2,0,1,1,2,2,H
1906-12-22,1906,Manchester United,Newcastle United,1-3,1,3,1,1,4,-2,A
1906-12-22,1906,Notts County,Bristol City,2-3,2,3,1,1,5,-1,A
1906-12-22,1906,Sheffield United,Liverpool,1-0,1,0,1,1,1,1,H
1906-12-22,1906,Stoke City,Preston North End,0-2,0,2,1,1,2,-2,A
1906-12-22,1906,Sunderland,Manchester City,1-1,1,1,1,1,2,0,D
1906-12-24,1906,Aston Villa,Preston North End,3-0,3,0,1,1,3,3,H
1906-12-24,1906,Bristol City,Sheffield United,3-3,3,3,1,1,6,0,D
1906-12-24,1906,Derby County,Notts County,3-0,3,0,1,1,3,3,H
1906-12-24,1906,Stoke City,Bolton Wanderers,3-0,3,0,1,1,3,3,H
1906-12-25,1906,Blackburn Rovers,Newcastle United,4-0,4,0,1,1,4,4,H
1906-12-25,1906,Bury,Everton,1-2,1,2,1,1,3,-1,A
1906-12-25,1906,Manchester City,Birmingham City,1-0,1,0,1,1,1,1,H
1906-12-25,1906,Manchester United,Liverpool,0-0,0,0,1,1,0,0,D
1906-12-25,1906,Middlesbrough,Sunderland,2-1,2,1,1,1,3,1,H
1906-12-25,1906,Sheffield Wednesday,Derby County,1-1,1,1,1,1,2,0,D
1906-12-26,1906,Arsenal,Bury,3-1,3,1,1,1,4,2,H
1906-12-26,1906,Aston Villa,Manchester United,2-0,2,0,1,1,2,2,H
1906-12-26,1906,Birmingham City,Middlesbrough,0-0,0,0,1,1,0,0,D
1906-12-26,1906,Liverpool,Bolton Wanderers,0-2,0,2,1,1,2,-2,A
1906-12-26,1906,Manchester City,Everton,3-1,3,1,1,1,4,2,H
1906-12-26,1906,Preston North End,Blackburn Rovers,1-0,1,0,1,1,1,1,H
1906-12-26,1906,Sheffield United,Notts County,2-1,2,1,1,1,3,1,H
1906-12-26,1906,Stoke City,Newcastle United,1-2,1,2,1,1,3,-1,A
1906-12-29,1906,Arsenal,Manchester City,4-1,4,1,1,1,5,3,H
1906-12-29,1906,Birmingham City,Preston North End,3-0,3,0,1,1,3,3,H
1906-12-29,1906,Blackburn Rovers,Aston Villa,2-1,2,1,1,1,3,1,H
1906-12-29,1906,Bolton Wanderers,Notts County,0-0,0,0,1,1,0,0,D
1906-12-29,1906,Derby County,Sheffield United,3-0,3,0,1,1,3,3,H
1906-12-29,1906,Everton,Middlesbrough,5-1,5,1,1,1,6,4,H
1906-12-29,1906,Manchester United,Bristol City,0-0,0,0,1,1,0,0,D
1906-12-29,1906,Sheffield Wednesday,Bury,1-2,1,2,1,1,3,-1,A
1906-12-31,1906,Sheffield United,Bristol City,1-1,1,1,1,1,2,0,D
1907-01-01,1906,Blackburn Rovers,Preston North End,1-1,1,1,1,1,2,0,D
1907-01-01,1906,Bolton Wanderers,Liverpool,3-0,3,0,1,1,3,3,H
1907-01-01,1906,Everton,Bury,1-0,1,0,1,1,1,1,H
1907-01-01,1906,Manchester United,Aston Villa,1-0,1,0,1,1,1,1,H
1907-01-01,1906,Middlesbrough,Birmingham City,1-0,1,0,1,1,1,1,H
1907-01-01,1906,Newcastle United,Derby County,2-0,2,0,1,1,2,2,H
1907-01-01,1906,Sheffield Wednesday,Arsenal,1-1,1,1,1,1,2,0,D
1907-01-02,1906,Bolton Wanderers,Preston North End,3-0,3,0,1,1,3,3,H
1907-01-02,1906,Manchester City,Middlesbrough,3-1,3,1,1,1,4,2,H
1907-01-05,1906,Aston Villa,Sunderland,2-2,2,2,1,1,4,0,D
1907-01-05,1906,Bristol City,Stoke City,4-0,4,0,1,1,4,4,H
1907-01-05,1906,Bury,Derby County,1-0,1,0,1,1,1,1,H
1907-01-05,1906,Liverpool,Blackburn Rovers,0-2,0,2,1,1,2,-2,A
1907-01-05,1906,Manchester City,Sheffield Wednesday,0-1,0,1,1,1,1,-1,A
1907-01-05,1906,Middlesbrough,Arsenal,5-3,5,3,1,1,8,2,H
1907-01-05,1906,Newcastle United,Birmingham City,2-0,2,0,1,1,2,2,H
1907-01-05,1906,Notts County,Manchester United,3-0,3,0,1,1,3,3,H
1907-01-05,1906,Preston North End,Everton,1-1,1,1,1,1,2,0,D
1907-01-05,1906,Sheffield United,Bolton Wanderers,2-1,2,1,1,1,3,1,H
1907-01-19,1906,Arsenal,Preston North End,1-0,1,0,1,1,1,1,H
1907-01-19,1906,Birmingham City,Aston Villa,3-2,3,2,1,1,5,1,H
1907-01-19,1906,Blackburn Rovers,Bristol City,0-1,0,1,1,1,1,-1,A
1907-01-19,1906,Bury,Manchester City,3-1,3,1,1,1,4,2,H
1907-01-19,1906,Derby County,Bolton Wanderers,0-1,0,1,1,1,1,-1,A
1907-01-19,1906,Everton,Newcastle United,3-0,3,0,1,1,3,3,H
1907-01-19,1906,Manchester United,Sheffield United,2-0,2,0,1,1,2,2,H
1907-01-19,1906,Sheffield Wednesday,Middlesbrough,0-2,0,2,1,1,2,-2,A
1907-01-19,1906,Stoke City,Notts County,1-1,1,1,1,1,2,0,D
1907-01-19,1906,Sunderland,Liverpool,5-5,5,5,1,1,10,0,D
1907-01-26,1906,Aston Villa,Everton,2-1,2,1,1,1,3,1,H
1907-01-26,1906,Bolton Wanderers,Manchester United,0-1,0,1,1,1,1,-1,A
1907-01-26,1906,Bristol City,Sunderland,1-1,1,1,1,1,2,0,D
1907-01-26,1906,Liverpool,Birmingham City,2-0,2,0,1,1,2,2,H
1907-01-26,1906,Manchester City,Derby County,2-2,2,2,1,1,4,0,D
1907-01-26,1906,Middlesbrough,Bury,3-1,3,1,1,1,4,2,H
1907-01-26,1906,Newcastle United,Arsenal,1-0,1,0,1,1,1,1,H
1907-01-26,1906,Notts County,Blackburn Rovers,1-2,1,2,1,1,3,-1,A
1907-01-26,1906,Preston North End,Sheffield Wednesday,1-0,1,0,1,1,1,1,H
1907-01-26,1906,Sheffield United,Stoke City,2-0,2,0,1,1,2,2,H
1907-02-02,1906,Newcastle United,Manchester United,5-0,5,0,1,1,5,5,H
1907-02-02,1906,Sheffield United,Preston North End,3-1,3,1,1,1,4,2,H
1907-02-09,1906,Aston Villa,Sheffield Wednesday,8-1,8,1,1,1,9,7,H
1907-02-09,1906,Bolton Wanderers,Blackburn Rovers,5-2,5,2,1,1,7,3,H
1907-02-09,1906,Bristol City,Everton,2-1,2,1,1,1,3,1,H
1907-02-09,1906,Liverpool,Arsenal,4-0,4,0,1,1,4,4,H
1907-02-09,1906,Manchester United,Stoke City,4-1,4,1,1,1,5,3,H
1907-02-09,1906,Middlesbrough,Derby County,4-1,4,1,1,1,5,3,H
1907-02-09,1906,Newcastle United,Bury,3-2,3,2,1,1,5,1,H
1907-02-09,1906,Notts County,Birmingham City,2-2,2,2,1,1,4,0,D
1907-02-09,1906,Preston North End,Manchester City,1-3,1,3,1,1,4,-2,A
1907-02-09,1906,Sheffield United,Sunderland,3-2,3,2,1,1,5,1,H
1907-02-13,1906,Sunderland,Preston North End,1-0,1,0,1,1,1,1,H
1907-02-16,1906,Arsenal,Bristol City,1-2,1,2,1,1,3,-1,A
1907-02-16,1906,Birmingham City,Sheffield United,0-0,0,0,1,1,0,0,D
1907-02-16,1906,Blackburn Rovers,Manchester United,2-4,2,4,1,1,6,-2,A
1907-02-16,1906,Bury,Aston Villa,0-3,0,3,1,1,3,-3,A
1907-02-16,1906,Derby County,Stoke City,2-1,2,1,1,1,3,1,H
1907-02-16,1906,Manchester City,Newcastle United,1-1,1,1,1,1,2,0,D
1907-02-16,1906,Middlesbrough,Preston North End,2-1,2,1,1,1,3,1,H
1907-02-16,1906,Sheffield Wednesday,Liverpool,2-3,2,3,1,1,5,-1,A
1907-02-16,1906,Sunderland,Bolton Wanderers,1-2,1,2,1,1,3,-1,A
1907-02-23,1906,Aston Villa,Manchester City,4-1,4,1,1,1,5,3,H
1907-02-23,1906,Manchester United,Preston North End,3-0,3,0,1,1,3,3,H
1907-02-23,1906,Newcastle United,Middlesbrough,4-0,4,0,1,1,4,4,H
1907-03-02,1906,Arsenal,Sheffield United,0-1,0,1,1,1,1,-1,A
1907-03-02,1906,Birmingham City,Manchester United,1-1,1,1,1,1,2,0,D
1907-03-02,1906,Bury,Bristol City,1-1,1,1,1,1,2,0,D
1907-03-02,1906,Derby County,Blackburn Rovers,2-3,2,3,1,1,5,-1,A
1907-03-02,1906,Everton,Bolton Wanderers,1-0,1,0,1,1,1,1,H
1907-03-02,1906,Manchester City,Liverpool,1-0,1,0,1,1,1,1,H
1907-03-02,1906,Middlesbrough,Aston Villa,1-0,1,0,1,1,1,1,H
1907-03-02,1906,Preston North End,Newcastle United,2-2,2,2,1,1,4,0,D
1907-03-02,1906,Sheffield Wednesday,Notts County,1-3,1,3,1,1,4,-2,A
1907-03-02,1906,Sunderland,Stoke City,3-1,3,1,1,1,4,2,H
1907-03-04,1906,Sheffield United,Everton,4-1,4,1,1,1,5,3,H
1907-03-09,1906,Blackburn Rovers,Sunderland,2-1,2,1,1,1,3,1,H
1907-03-09,1906,Bolton Wanderers,Bury,1-0,1,0,1,1,1,1,H
1907-03-09,1906,Bristol City,Manchester City,2-0,2,0,1,1,2,2,H
1907-03-09,1906,Preston North End,Derby County,1-0,1,0,1,1,1,1,H
1907-03-09,1906,Stoke City,Birmingham City,3-0,3,0,1,1,3,3,H
1907-03-11,1906,Bolton Wanderers,Birmingham City,2-3,2,3,1,1,5,-1,A
1907-03-11,1906,Stoke City,Liverpool,1-1,1,1,1,1,2,0,D
1907-03-13,1906,Notts County,Bury,1-2,1,2,1,1,3,-1,A
1907-03-16,1906,Arsenal,Manchester United,4-0,4,0,1,1,4,4,H
1907-03-16,1906,Birmingham City,Blackburn Rovers,2-0,2,0,1,1,2,2,H
1907-03-16,1906,Bury,Sheffield United,2-1,2,1,1,1,3,1,H
1907-03-16,1906,Derby County,Sunderland,1-1,1,1,1,1,2,0,D
1907-03-16,1906,Everton,Stoke City,3-0,3,0,1,1,3,3,H
1907-03-16,1906,Manchester City,Notts County,2-1,2,1,1,1,3,1,H
1907-03-16,1906,Middlesbrough,Bristol City,1-0,1,0,1,1,1,1,H
1907-03-16,1906,Newcastle United,Aston Villa,3-2,3,2,1,1,5,1,H
1907-03-16,1906,Preston North End,Liverpool,3-1,3,1,1,1,4,2,H
1907-03-16,1906,Sheffield Wednesday,Bolton Wanderers,2-0,2,0,1,1,2,2,H
1907-03-20,1906,Sunderland,Newcastle United,2-0,2,0,1,1,2,2,H
1907-03-23,1906,Aston Villa,Derby County,2-0,2,0,1,1,2,2,H
1907-03-23,1906,Bristol City,Preston North End,1-0,1,0,1,1,1,1,H
1907-03-23,1906,Liverpool,Newcastle United,4-1,4,1,1,1,5,3,H
1907-03-23,1906,Sheffield United,Manchester City,1-4,1,4,1,1,5,-3,A
1907-03-23,1906,Sunderland,Birmingham City,4-1,4,1,1,1,5,3,H
1907-03-25,1906,Manchester United,Sunderland,2-0,2,0,1,1,2,2,H
1907-03-27,1906,Bolton Wanderers,Arsenal,3-0,3,0,1,1,3,3,H
1907-03-29,1906,Arsenal,Sheffield Wednesday,1-0,1,0,1,1,1,1,H
1907-03-29,1906,Birmingham City,Manchester City,4-0,4,0,1,1,4,4,H
1907-03-29,1906,Blackburn Rovers,Sheffield United,1-1,1,1,1,1,2,0,D
1907-03-29,1906,Bolton Wanderers,Bristol City,1-2,1,2,1,1,3,-1,A
1907-03-29,1906,Everton,Liverpool,0-0,0,0,1,1,0,0,D
1907-03-29,1906,Newcastle United,Stoke City,1-0,1,0,1,1,1,1,H
1907-03-29,1906,Notts County,Derby County,4-0,4,0,1,1,4,4,H
1907-03-29,1906,Preston North End,Sunderland,2-0,2,0,1,1,2,2,H
1907-03-30,1906,Arsenal,Blackburn Rovers,2-0,2,0,1,1,2,2,H
1907-03-30,1906,Aston Villa,Liverpool,4-0,4,0,1,1,4,4,H
1907-03-30,1906,Bury,Manchester United,1-2,1,2,1,1,3,-1,A
1907-03-30,1906,Derby County,Birmingham City,1-1,1,1,1,1,2,0,D
1907-03-30,1906,Everton,Sunderland,4-1,4,1,1,1,5,3,H
1907-03-30,1906,Manchester City,Bolton Wanderers,1-1,1,1,1,1,2,0,D
1907-03-30,1906,Middlesbrough,Sheffield United,0-1,0,1,1,1,1,-1,A
1907-03-30,1906,Newcastle United,Bristol City,3-0,3,0,1,1,3,3,H
1907-03-30,1906,Preston North End,Notts County,0-0,0,0,1,1,0,0,D
1907-03-30,1906,Sheffield Wednesday,Stoke City,0-1,0,1,1,1,1,-1,A
1907-04-01,1906,Arsenal,Aston Villa,3-1,3,1,1,1,4,2,H
1907-04-01,1906,Bury,Preston North End,2-0,2,0,1,1,2,2,H
1907-04-01,1906,Derby County,Sheffield Wednesday,1-0,1,0,1,1,1,1,H
1907-04-01,1906,Liverpool,Manchester United,0-1,0,1,1,1,1,-1,A
1907-04-01,1906,Newcastle United,Blackburn Rovers,3-1,3,1,1,1,4,2,H
1907-04-01,1906,Notts County,Sheffield United,4-0,4,0,1,1,4,4,H
1907-04-01,1906,Sunderland,Middlesbrough,4-2,4,2,1,1,6,2,H
1907-04-02,1906,Bristol City,Bolton Wanderers,1-2,1,2,1,1,3,-1,A
1907-04-04,1906,Sheffield United,Sheffield Wednesday,2-1,2,1,1,1,3,1,H
1907-04-06,1906,Birmingham City,Everton,1-0,1,0,1,1,1,1,H
1907-04-06,1906,Blackburn Rovers,Sheffield Wednesday,0-2,0,2,1,1,2,-2,A
1907-04-06,1906,Bolton Wanderers,Middlesbrough,1-0,1,0,1,1,1,1,H
1907-04-06,1906,Bristol City,Aston Villa,2-4,2,4,1,1,6,-2,A
1907-04-06,1906,Liverpool,Derby County,2-0,2,0,1,1,2,2,H
1907-04-06,1906,Manchester United,Manchester City,1-1,1,1,1,1,2,0,D
1907-04-06,1906,Notts County,Newcastle United,1-0,1,0,1,1,1,1,H
1907-04-06,1906,Stoke City,Bury,3-1,3,1,1,1,4,2,H
1907-04-06,1906,Sunderland,Arsenal,2-3,2,3,1,1,5,-1,A
1907-04-08,1906,Blackburn Rovers,Everton,2-1,2,1,1,1,3,1,H
1907-04-10,1906,Everton,Arsenal,2-1,2,1,1,1,3,1,H
1907-04-10,1906,Manchester United,Sheffield Wednesday,5-0,5,0,1,1,5,5,H
1907-04-10,1906,Notts County,Middlesbrough,2-2,2,2,1,1,4,0,D
1907-04-13,1906,Arsenal,Birmingham City,2-1,2,1,1,1,3,1,H
1907-04-13,1906,Aston Villa,Notts County,0-0,0,0,1,1,0,0,D
1907-04-13,1906,Bury,Blackburn Rovers,0-0,0,0,1,1,0,0,D
1907-04-13,1906,Derby County,Everton,5-2,5,2,1,1,7,3,H
1907-04-13,1906,Liverpool,Bristol City,2-4,2,4,1,1,6,-2,A
1907-04-13,1906,Manchester City,Stoke City,2-2,2,2,1,1,4,0,D
1907-04-13,1906,Middlesbrough,Manchester United,2-0,2,0,1,1,2,2,H
1907-04-13,1906,Newcastle United,Sheffield United,0-0,0,0,1,1,0,0,D
1907-04-13,1906,Sheffield Wednesday,Sunderland,2-1,2,1,1,1,3,1,H
1907-04-15,1906,Stoke City,Arsenal,2-0,2,0,1,1,2,2,H
1907-04-17,1906,Liverpool,Middlesbrough,2-4,2,4,1,1,6,-2,A
1907-04-17,1906,Notts County,Arsenal,4-1,4,1,1,1,5,3,H
1907-04-20,1906,Blackburn Rovers,Manchester City,4-0,4,0,1,1,4,4,H
1907-04-20,1906,Bolton Wanderers,Newcastle United,4-2,4,2,1,1,6,2,H
1907-04-20,1906,Derby County,Bristol City,1-3,1,3,1,1,4,-2,A
1907-04-20,1906,Notts County,Liverpool,2-0,2,0,1,1,2,2,H
1907-04-20,1906,Sheffield United,Aston Villa,0-0,0,0,1,1,0,0,D
1907-04-20,1906,Stoke City,Middlesbrough,0-2,0,2,1,1,2,-2,A
1907-04-20,1906,Sunderland,Bury,3-5,3,5,1,1,8,-2,A
1907-04-22,1906,Manchester United,Everton,3-0,3,0,1,1,3,3,H
1907-04-24,1906,Bristol City,Sheffield Wednesday,2-0,2,0,1,1,2,2,H
1907-04-24,1906,Sunderland,Notts County,3-1,3,1,1,1,4,2,H
1907-04-25,1906,Birmingham City,Sheffield Wednesday,1-1,1,1,1,1,2,0,D
1907-04-27,1906,Arsenal,Derby County,3-2,3,2,1,1,5,1,H
1907-04-27,1906,Aston Villa,Bolton Wanderers,0-2,0,2,1,1,2,-2,A
1907-04-27,1906,Bristol City,Notts County,1-0,1,0,1,1,1,1,H
1907-04-27,1906,Bury,Birmingham City,1-0,1,0,1,1,1,1,H
1907-04-27,1906,Liverpool,Sheffield United,2-2,2,2,1,1,4,0,D
1907-04-27,1906,Manchester City,Sunderland,2-3,2,3,1,1,5,-1,A
1907-04-27,1906,Middlesbrough,Blackburn Rovers,0-1,0,1,1,1,1,-1,A
1907-04-27,1906,Preston North End,Stoke City,2-2,2,2,1,1,4,0,D
1907-04-27,1906,Sheffield Wednesday,Everton,1-1,1,1,1,1,2,0,D
1907-09-02,1907,Arsenal,Notts County,1-1,1,1,1,1,2,0,D
1907-09-02,1907,Aston Villa,Manchester United,1-4,1,4,1,1,5,-3,A
1907-09-02,1907,Blackburn Rovers,Bury,1-0,1,0,1,1,1,1,H
1907-09-02,1907,Bristol City,Everton,3-2,3,2,1,1,5,1,H
1907-09-02,1907,Nottingham Forest,Liverpool,3-1,3,1,1,1,4,2,H
1907-09-02,1907,Preston North End,Sheffield Wednesday,1-1,1,1,1,1,2,0,D
1907-09-02,1907,Sunderland,Manchester City,2-5,2,5,1,1,7,-3,A
1907-09-04,1907,Middlesbrough,Birmingham City,1-0,1,0,1,1,1,1,H
1907-09-04,1907,Newcastle United,Notts County,1-1,1,1,1,1,2,0,D
1907-09-07,1907,Arsenal,Bristol City,0-4,0,4,1,1,4,-4,A
1907-09-07,1907,Birmingham City,Preston North End,2-0,2,0,1,1,2,2,H
1907-09-07,1907,Blackburn Rovers,Aston Villa,2-0,2,0,1,1,2,2,H
1907-09-07,1907,Bolton Wanderers,Bury,3-6,3,6,1,1,9,-3,A
1907-09-07,1907,Chelsea,Sheffield United,2-4,2,4,1,1,6,-2,A
1907-09-07,1907,Everton,Manchester City,3-3,3,3,1,1,6,0,D
1907-09-07,1907,Manchester United,Liverpool,4-0,4,0,1,1,4,4,H
1907-09-07,1907,Nottingham Forest,Middlesbrough,0-3,0,3,1,1,3,-3,A
1907-09-07,1907,Sheffield Wednesday,Newcastle United,3-1,3,1,1,1,4,2,H
1907-09-07,1907,Sunderland,Notts County,4-3,4,3,1,1,7,1,H
1907-09-09,1907,Aston Villa,Sunderland,1-0,1,0,1,1,1,1,H
1907-09-09,1907,Bury,Arsenal,3-2,3,2,1,1,5,1,H
1907-09-09,1907,Everton,Preston North End,2-1,2,1,1,1,3,1,H
1907-09-09,1907,Manchester United,Middlesbrough,2-1,2,1,1,1,3,1,H
1907-09-14,1907,Aston Villa,Bolton Wanderers,2-0,2,0,1,1,2,2,H
1907-09-14,1907,Bristol City,Sheffield Wednesday,0-2,0,2,1,1,2,-2,A
1907-09-14,1907,Bury,Birmingham City,1-0,1,0,1,1,1,1,H
1907-09-14,1907,Liverpool,Blackburn Rovers,2-0,2,0,1,1,2,2,H
1907-09-14,1907,Manchester City,Sunderland,0-0,0,0,1,1,0,0,D
1907-09-14,1907,Middlesbrough,Manchester United,2-1,2,1,1,1,3,1,H
1907-09-14,1907,Newcastle United,Chelsea,1-0,1,0,1,1,1,1,H
1907-09-14,1907,Notts County,Arsenal,2-0,2,0,1,1,2,2,H
1907-09-14,1907,Preston North End,Everton,2-2,2,2,1,1,4,0,D
1907-09-14,1907,Sheffield United,Nottingham Forest,2-2,2,2,1,1,4,0,D
1907-09-16,1907,Birmingham City,Bury,0-1,0,1,1,1,1,-1,A
1907-09-16,1907,Sheffield United,Liverpool,0-0,0,0,1,1,0,0,D
1907-09-21,1907,Arsenal,Manchester City,2-1,2,1,1,1,3,1,H
1907-09-21,1907,Birmingham City,Aston Villa,2-3,2,3,1,1,5,-1,A
1907-09-21,1907,Blackburn Rovers,Middlesbrough,2-0,2,0,1,1,2,2,H
1907-09-21,1907,Bolton Wanderers,Liverpool,0-4,0,4,1,1,4,-4,A
1907-09-21,1907,Bristol City,Newcastle United,1-1,1,1,1,1,2,0,D
1907-09-21,1907,Everton,Bury,6-1,6,1,1,1,7,5,H
1907-09-21,1907,Manchester United,Sheffield United,2-1,2,1,1,1,3,1,H
1907-09-21,1907,Nottingham Forest,Chelsea,6-0,6,0,1,1,6,6,H
1907-09-21,1907,Sheffield Wednesday,Notts County,2-0,2,0,1,1,2,2,H
1907-09-21,1907,Sunderland,Preston North End,4-1,4,1,1,1,5,3,H
1907-09-23,1907,Chelsea,Newcastle United,2-0,2,0,1,1,2,2,H
1907-09-23,1907,Sheffield Wednesday,Bristol City,5-3,5,3,1,1,8,2,H
1907-09-28,1907,Aston Villa,Everton,0-2,0,2,1,1,2,-2,A
1907-09-28,1907,Bury,Sunderland,2-1,2,1,1,1,3,1,H
1907-09-28,1907,Chelsea,Manchester United,1-4,1,4,1,1,5,-3,A
1907-09-28,1907,Liverpool,Birmingham City,3-4,3,4,1,1,7,-1,A
1907-09-28,1907,Manchester City,Sheffield Wednesday,3-2,3,2,1,1,5,1,H
1907-09-28,1907,Middlesbrough,Bolton Wanderers,0-1,0,1,1,1,1,-1,A
1907-09-28,1907,Newcastle United,Nottingham Forest,3-0,3,0,1,1,3,3,H
1907-09-28,1907,Notts County,Bristol City,3-1,3,1,1,1,4,2,H
1907-09-28,1907,Preston North End,Arsenal,3-0,3,0,1,1,3,3,H
1907-09-28,1907,Sheffield United,Blackburn Rovers,4-2,4,2,1,1,6,2,H
1907-10-03,1907,Notts County,Bury,2-1,2,1,1,1,3,1,H
1907-10-05,1907,Arsenal,Bury,0-0,0,0,1,1,0,0,D
1907-10-05,1907,Birmingham City,Middlesbrough,1-4,1,4,1,1,5,-3,A
1907-10-05,1907,Blackburn Rovers,Chelsea,2-0,2,0,1,1,2,2,H
1907-10-05,1907,Bolton Wanderers,Sheffield United,1-1,1,1,1,1,2,0,D
1907-10-05,1907,Bristol City,Manchester City,2-1,2,1,1,1,3,1,H
1907-10-05,1907,Everton,Liverpool,2-4,2,4,1,1,6,-2,A
1907-10-05,1907,Manchester United,Nottingham Forest,4-0,4,0,1,1,4,4,H
1907-10-05,1907,Notts County,Newcastle United,0-1,0,1,1,1,1,-1,A
1907-10-05,1907,Sheffield Wednesday,Preston North End,1-0,1,0,1,1,1,1,H
1907-10-05,1907,Sunderland,Aston Villa,3-0,3,0,1,1,3,3,H
1907-10-12,1907,Aston Villa,Arsenal,0-1,0,1,1,1,1,-1,A
1907-10-12,1907,Bury,Sheffield Wednesday,0-2,0,2,1,1,2,-2,A
1907-10-12,1907,Chelsea,Bolton Wanderers,1-3,1,3,1,1,4,-2,A
1907-10-12,1907,Liverpool,Sunderland,1-0,1,0,1,1,1,1,H
1907-10-12,1907,Manchester City,Notts County,2-1,2,1,1,1,3,1,H
1907-10-12,1907,Middlesbrough,Everton,0-2,0,2,1,1,2,-2,A
1907-10-12,1907,Newcastle United,Manchester United,1-6,1,6,1,1,7,-5,A
1907-10-12,1907,Nottingham Forest,Blackburn Rovers,3-2,3,2,1,1,5,1,H
1907-10-12,1907,Preston North End,Bristol City,3-0,3,0,1,1,3,3,H
1907-10-12,1907,Sheffield United,Birmingham City,1-0,1,0,1,1,1,1,H
1907-10-19,1907,Arsenal,Liverpool,2-1,2,1,1,1,3,1,H
1907-10-19,1907,Birmingham City,Chelsea,1-1,1,1,1,1,2,0,D
1907-10-19,1907,Blackburn Rovers,Manchester United,1-5,1,5,1,1,6,-4,A
1907-10-19,1907,Bolton Wanderers,Nottingham Forest,1-0,1,0,1,1,1,1,H
1907-10-19,1907,Bristol City,Bury,1-1,1,1,1,1,2,0,D
1907-10-19,1907,Everton,Sheffield United,2-1,2,1,1,1,3,1,H
1907-10-19,1907,Manchester City,Newcastle United,1-0,1,0,1,1,1,1,H
1907-10-19,1907,Notts County,Preston North End,0-1,0,1,1,1,1,-1,A
1907-10-19,1907,Sheffield Wednesday,Aston Villa,2-3,2,3,1,1,5,-1,A
1907-10-19,1907,Sunderland,Middlesbrough,0-0,0,0,1,1,0,0,D
1907-10-26,1907,Aston Villa,Bristol City,4-4,4,4,1,1,8,0,D
1907-10-26,1907,Bury,Notts County,0-0,0,0,1,1,0,0,D
1907-10-26,1907,Chelsea,Everton,2-1,2,1,1,1,3,1,H
1907-10-26,1907,Liverpool,Sheffield Wednesday,3-0,3,0,1,1,3,3,H
1907-10-26,1907,Manchester United,Bolton Wanderers,2-1,2,1,1,1,3,1,H
1907-10-26,1907,Middlesbrough,Arsenal,0-0,0,0,1,1,0,0,D
1907-10-26,1907,Newcastle United,Blackburn Rovers,3-0,3,0,1,1,3,3,H
1907-10-26,1907,Nottingham Forest,Birmingham City,1-1,1,1,1,1,2,0,D
1907-10-26,1907,Preston North End,Manchester City,2-4,2,4,1,1,6,-2,A
1907-10-26,1907,Sheffield United,Sunderland,5-3,5,3,1,1,8,2,H
1907-11-02,1907,Arsenal,Sheffield United,5-1,5,1,1,1,6,4,H
1907-11-02,1907,Birmingham City,Manchester United,3-4,3,4,1,1,7,-1,A
1907-11-02,1907,Bolton Wanderers,Blackburn Rovers,3-1,3,1,1,1,4,2,H
1907-11-02,1907,Bristol City,Liverpool,2-0,2,0,1,1,2,2,H
1907-11-02,1907,Everton,Nottingham Forest,1-0,1,0,1,1,1,1,H
1907-11-02,1907,Manchester City,Bury,2-2,2,2,1,1,4,0,D
1907-11-02,1907,Notts County,Aston Villa,0-3,0,3,1,1,3,-3,A
1907-11-02,1907,Preston North End,Newcastle United,2-0,2,0,1,1,2,2,H
1907-11-02,1907,Sheffield Wednesday,Middlesbrough,3-2,3,2,1,1,5,1,H
1907-11-02,1907,Sunderland,Chelsea,3-0,3,0,1,1,3,3,H
1907-11-09,1907,Aston Villa,Manchester City,2-2,2,2,1,1,4,0,D
1907-11-09,1907,Blackburn Rovers,Birmingham City,1-0,1,0,1,1,1,1,H
1907-11-09,1907,Bury,Preston North End,5-1,5,1,1,1,6,4,H
1907-11-09,1907,Chelsea,Arsenal,2-1,2,1,1,1,3,1,H
1907-11-09,1907,Liverpool,Notts County,6-0,6,0,1,1,6,6,H
1907-11-09,1907,Manchester United,Everton,4-3,4,3,1,1,7,1,H
1907-11-09,1907,Middlesbrough,Bristol City,0-2,0,2,1,1,2,-2,A
1907-11-09,1907,Newcastle United,Bolton Wanderers,3-0,3,0,1,1,3,3,H
1907-11-09,1907,Nottingham Forest,Sunderland,4-1,4,1,1,1,5,3,H
1907-11-09,1907,Sheffield United,Sheffield Wednesday,1-3,1,3,1,1,4,-2,A
1907-11-16,1907,Arsenal,Nottingham Forest,3-1,3,1,1,1,4,2,H
1907-11-16,1907,Birmingham City,Bolton Wanderers,2-1,2,1,1,1,3,1,H
1907-11-16,1907,Bristol City,Sheffield United,3-2,3,2,1,1,5,1,H
1907-11-16,1907,Bury,Newcastle United,1-2,1,2,1,1,3,-1,A
1907-11-16,1907,Everton,Blackburn Rovers,4-1,4,1,1,1,5,3,H
1907-11-16,1907,Manchester City,Liverpool,1-1,1,1,1,1,2,0,D
1907-11-16,1907,Notts County,Middlesbrough,2-0,2,0,1,1,2,2,H
1907-11-16,1907,Preston North End,Aston Villa,3-0,3,0,1,1,3,3,H
1907-11-16,1907,Sheffield Wednesday,Chelsea,3-1,3,1,1,1,4,2,H
1907-11-16,1907,Sunderland,Manchester United,1-2,1,2,1,1,3,-1,A
1907-11-23,1907,Aston Villa,Bury,2-2,2,2,1,1,4,0,D
1907-11-23,1907,Blackburn Rovers,Sunderland,4-2,4,2,1,1,6,2,H
1907-11-23,1907,Bolton Wanderers,Everton,3-0,3,0,1,1,3,3,H
1907-11-23,1907,Chelsea,Bristol City,4-1,4,1,1,1,5,3,H
1907-11-23,1907,Liverpool,Preston North End,1-2,1,2,1,1,3,-1,A
1907-11-23,1907,Manchester United,Arsenal,4-2,4,2,1,1,6,2,H
1907-11-23,1907,Middlesbrough,Manchester City,2-0,2,0,1,1,2,2,H
1907-11-23,1907,Newcastle United,Birmingham City,8-0,8,0,1,1,8,8,H
1907-11-23,1907,Nottingham Forest,Sheffield Wednesday,2-2,2,2,1,1,4,0,D
1907-11-23,1907,Sheffield United,Notts County,0-1,0,1,1,1,1,-1,A
1907-11-30,1907,Arsenal,Blackburn Rovers,2-0,2,0,1,1,2,2,H
1907-11-30,1907,Aston Villa,Newcastle United,3-3,3,3,1,1,6,0,D
1907-11-30,1907,Bristol City,Nottingham Forest,3-0,3,0,1,1,3,3,H
1907-11-30,1907,Notts County,Chelsea,2-0,2,0,1,1,2,2,H
1907-11-30,1907,Preston North End,Middlesbrough,1-1,1,1,1,1,2,0,D
1907-11-30,1907,Sheffield Wednesday,Manchester United,2-0,2,0,1,1,2,2,H
1907-11-30,1907,Sunderland,Bolton Wanderers,1-2,1,2,1,1,3,-1,A
1907-12-02,1907,Chelsea,Blackburn Rovers,1-0,1,0,1,1,1,1,H
1907-12-07,1907,Birmingham City,Sunderland,0-2,0,2,1,1,2,-2,A
1907-12-07,1907,Blackburn Rovers,Sheffield Wednesday,2-0,2,0,1,1,2,2,H
1907-12-07,1907,Bolton Wanderers,Arsenal,3-1,3,1,1,1,4,2,H
1907-12-07,1907,Chelsea,Manchester City,2-2,2,2,1,1,4,0,D
1907-12-07,1907,Liverpool,Aston Villa,5-0,5,0,1,1,5,5,H
1907-12-07,1907,Manchester United,Bristol City,2-1,2,1,1,1,3,1,H
1907-12-07,1907,Middlesbrough,Bury,0-2,0,2,1,1,2,-2,A
1907-12-07,1907,Newcastle United,Everton,2-1,2,1,1,1,3,1,H
1907-12-07,1907,Nottingham Forest,Notts County,2-0,2,0,1,1,2,2,H
1907-12-07,1907,Sheffield United,Preston North End,2-0,2,0,1,1,2,2,H
1907-12-14,1907,Arsenal,Birmingham City,1-1,1,1,1,1,2,0,D
1907-12-14,1907,Aston Villa,Middlesbrough,6-0,6,0,1,1,6,6,H
1907-12-14,1907,Bristol City,Blackburn Rovers,2-2,2,2,1,1,4,0,D
1907-12-14,1907,Bury,Sheffield United,3-2,3,2,1,1,5,1,H
1907-12-14,1907,Liverpool,Newcastle United,1-5,1,5,1,1,6,-4,A
1907-12-14,1907,Manchester City,Nottingham Forest,4-2,4,2,1,1,6,2,H
1907-12-14,1907,Notts County,Manchester United,1-1,1,1,1,1,2,0,D
1907-12-14,1907,Preston North End,Chelsea,2-4,2,4,1,1,6,-2,A
1907-12-14,1907,Sheffield Wednesday,Bolton Wanderers,5-2,5,2,1,1,7,3,H
1907-12-14,1907,Sunderland,Everton,1-2,1,2,1,1,3,-1,A
1907-12-21,1907,Birmingham City,Sheffield Wednesday,2-1,2,1,1,1,3,1,H
1907-12-21,1907,Blackburn Rovers,Notts County,1-1,1,1,1,1,2,0,D
1907-12-21,1907,Bolton Wanderers,Bristol City,1-2,1,2,1,1,3,-1,A
1907-12-21,1907,Chelsea,Bury,3-4,3,4,1,1,7,-1,A
1907-12-21,1907,Everton,Arsenal,1-1,1,1,1,1,2,0,D
1907-12-21,1907,Manchester United,Manchester City,3-1,3,1,1,1,4,2,H
1907-12-21,1907,Middlesbrough,Liverpool,3-1,3,1,1,1,4,2,H
1907-12-21,1907,Nottingham Forest,Preston North End,2-2,2,2,1,1,4,0,D
1907-12-21,1907,Sheffield United,Aston Villa,1-1,1,1,1,1,2,0,D
1907-12-21,1907,Sunderland,Newcastle United,2-4,2,4,1,1,6,-2,A
1907-12-25,1907,Arsenal,Newcastle United,2-2,2,2,1,1,4,0,D
1907-12-25,1907,Aston Villa,Nottingham Forest,4-0,4,0,1,1,4,4,H
1907-12-25,1907,Birmingham City,Manchester City,2-1,2,1,1,1,3,1,H
1907-12-25,1907,Liverpool,Chelsea,1-4,1,4,1,1,5,-3,A
1907-12-25,1907,Manchester United,Bury,2-1,2,1,1,1,3,1,H
1907-12-25,1907,Notts County,Everton,2-1,2,1,1,1,3,1,H
1907-12-25,1907,Preston North End,Bolton Wanderers,2-0,2,0,1,1,2,2,H
1907-12-25,1907,Sheffield United,Middlesbrough,0-0,0,0,1,1,0,0,D
1907-12-25,1907,Sunderland,Bristol City,3-3,3,3,1,1,6,0,D
1907-12-26,1907,Birmingham City,Notts County,0-0,0,0,1,1,0,0,D
1907-12-26,1907,Chelsea,Middlesbrough,1-0,1,0,1,1,1,1,H
1907-12-26,1907,Everton,Bristol City,0-0,0,0,1,1,0,0,D
1907-12-26,1907,Manchester City,Bolton Wanderers,1-0,1,0,1,1,1,1,H
1907-12-26,1907,Newcastle United,Sheffield United,2-3,2,3,1,1,5,-1,A
1907-12-26,1907,Nottingham Forest,Aston Villa,2-2,2,2,1,1,4,0,D
1907-12-26,1907,Preston North End,Blackburn Rovers,1-1,1,1,1,1,2,0,D
1907-12-26,1907,Sheffield Wednesday,Sunderland,2-3,2,3,1,1,5,-1,A
1907-12-27,1907,Notts County,Birmingham City,0-0,0,0,1,1,0,0,D
1907-12-28,1907,Arsenal,Sunderland,4-0,4,0,1,1,4,4,H
1907-12-28,1907,Aston Villa,Chelsea,0-0,0,0,1,1,0,0,D
1907-12-28,1907,Bristol City,Birmingham City,0-0,0,0,1,1,0,0,D
1907-12-28,1907,Bury,Nottingham Forest,0-0,0,0,1,1,0,0,D
1907-12-28,1907,Liverpool,Sheffield United,3-0,3,0,1,1,3,3,H
1907-12-28,1907,Manchester City,Blackburn Rovers,2-0,2,0,1,1,2,2,H
1907-12-28,1907,Newcastle United,Middlesbrough,1-1,1,1,1,1,2,0,D
1907-12-28,1907,Notts County,Bolton Wanderers,0-1,0,1,1,1,1,-1,A
1907-12-28,1907,Preston North End,Manchester United,0-0,0,0,1,1,0,0,D
1907-12-28,1907,Sheffield Wednesday,Everton,1-2,1,2,1,1,3,-1,A
1907-12-30,1907,Sheffield United,Bolton Wanderers,1-0,1,0,1,1,1,1,H
1907-12-31,1907,Sheffield Wednesday,Arsenal,6-0,6,0,1,1,6,6,H
1908-01-01,1907,Blackburn Rovers,Preston North End,1-1,1,1,1,1,2,0,D
1908-01-01,1907,Bolton Wanderers,Manchester City,2-0,2,0,1,1,2,2,H
1908-01-01,1907,Bury,Manchester United,0-1,0,1,1,1,1,-1,A
1908-01-01,1907,Liverpool,Nottingham Forest,0-0,0,0,1,1,0,0,D
1908-01-01,1907,Middlesbrough,Chelsea,3-1,3,1,1,1,4,2,H
1908-01-01,1907,Sheffield United,Newcastle United,1-1,1,1,1,1,2,0,D
1908-01-01,1907,Sunderland,Arsenal,5-2,5,2,1,1,7,3,H
1908-01-02,1907,Bolton Wanderers,Preston North End,2-0,2,0,1,1,2,2,H
1908-01-04,1907,Aston Villa,Blackburn Rovers,1-1,1,1,1,1,2,0,D
1908-01-04,1907,Bristol City,Arsenal,1-2,1,2,1,1,3,-1,A
1908-01-04,1907,Bury,Bolton Wanderers,2-2,2,2,1,1,4,0,D
1908-01-04,1907,Manchester City,Everton,4-2,4,2,1,1,6,2,H
1908-01-04,1907,Middlesbrough,Nottingham Forest,1-1,1,1,1,1,2,0,D
1908-01-04,1907,Newcastle United,Sheffield Wednesday,2-1,2,1,1,1,3,1,H
1908-01-04,1907,Notts County,Sunderland,4-0,4,0,1,1,4,4,H
1908-01-04,1907,Preston North End,Birmingham City,1-1,1,1,1,1,2,0,D
1908-01-04,1907,Sheffield United,Chelsea,0-3,0,3,1,1,3,-3,A
1908-01-18,1907,Aston Villa,Birmingham City,2-3,2,3,1,1,5,-1,A
1908-01-18,1907,Bury,Everton,3-0,3,0,1,1,3,3,H
1908-01-18,1907,Chelsea,Nottingham Forest,0-4,0,4,1,1,4,-4,A
1908-01-18,1907,Liverpool,Bolton Wanderers,1-0,1,0,1,1,1,1,H
1908-01-18,1907,Manchester City,Arsenal,4-0,4,0,1,1,4,4,H
1908-01-18,1907,Middlesbrough,Blackburn Rovers,3-0,3,0,1,1,3,3,H
1908-01-18,1907,Newcastle United,Bristol City,2-0,2,0,1,1,2,2,H
1908-01-18,1907,Notts County,Sheffield Wednesday,1-2,1,2,1,1,3,-1,A
1908-01-18,1907,Preston North End,Sunderland,3-2,3,2,1,1,5,1,H
1908-01-18,1907,Sheffield United,Manchester United,2-0,2,0,1,1,2,2,H
1908-01-25,1907,Arsenal,Preston North End,1-1,1,1,1,1,2,0,D
1908-01-25,1907,Birmingham City,Liverpool,1-1,1,1,1,1,2,0,D
1908-01-25,1907,Blackburn Rovers,Sheffield United,3-3,3,3,1,1,6,0,D
1908-01-25,1907,Bolton Wanderers,Middlesbrough,1-1,1,1,1,1,2,0,D
1908-01-25,1907,Bristol City,Notts County,2-1,2,1,1,1,3,1,H
1908-01-25,1907,Everton,Aston Villa,1-0,1,0,1,1,1,1,H
1908-01-25,1907,Manchester United,Chelsea,1-0,1,0,1,1,1,1,H
1908-01-25,1907,Nottingham Forest,Newcastle United,0-0,0,0,1,1,0,0,D
1908-01-25,1907,Sheffield Wednesday,Manchester City,5-1,5,1,1,1,6,4,H
1908-01-25,1907,Sunderland,Bury,6-2,6,2,1,1,8,4,H
1908-02-01,1907,Middlesbrough,Sheffield United,2-0,2,0,1,1,2,2,H
1908-02-08,1907,Arsenal,Aston Villa,0-1,0,1,1,1,1,-1,A
1908-02-08,1907,Birmingham City,Sheffield United,0-0,0,0,1,1,0,0,D
1908-02-08,1907,Blackburn Rovers,Nottingham Forest,3-3,3,3,1,1,6,0,D
1908-02-08,1907,Bolton Wanderers,Chelsea,1-2,1,2,1,1,3,-1,A
1908-02-08,1907,Bristol City,Preston North End,1-3,1,3,1,1,4,-2,A
1908-02-08,1907,Everton,Middlesbrough,2-1,2,1,1,1,3,1,H
1908-02-08,1907,Manchester United,Newcastle United,1-1,1,1,1,1,2,0,D
1908-02-08,1907,Notts County,Manchester City,1-0,1,0,1,1,1,1,H
1908-02-08,1907,Sheffield Wednesday,Bury,2-0,2,0,1,1,2,2,H
1908-02-08,1907,Sunderland,Liverpool,1-0,1,0,1,1,1,1,H
1908-02-15,1907,Aston Villa,Sheffield Wednesday,5-0,5,0,1,1,5,5,H
1908-02-15,1907,Bury,Bristol City,1-1,1,1,1,1,2,0,D
1908-02-15,1907,Chelsea,Birmingham City,2-2,2,2,1,1,4,0,D
1908-02-15,1907,Liverpool,Arsenal,4-1,4,1,1,1,5,3,H
1908-02-15,1907,Manchester United,Blackburn Rovers,1-2,1,2,1,1,3,-1,A
1908-02-15,1907,Middlesbrough,Sunderland,3-1,3,1,1,1,4,2,H
1908-02-15,1907,Newcastle United,Manchester City,1-1,1,1,1,1,2,0,D
1908-02-15,1907,Nottingham Forest,Bolton Wanderers,1-0,1,0,1,1,1,1,H
1908-02-15,1907,Preston North End,Notts County,1-0,1,0,1,1,1,1,H
1908-02-15,1907,Sheffield United,Everton,2-0,2,0,1,1,2,2,H
1908-02-22,1907,Arsenal,Middlesbrough,4-1,4,1,1,1,5,3,H
1908-02-22,1907,Sunderland,Sheffield United,4-1,4,1,1,1,5,3,H
1908-02-29,1907,Blackburn Rovers,Bolton Wanderers,3-2,3,2,1,1,5,1,H
1908-02-29,1907,Bury,Manchester City,0-0,0,0,1,1,0,0,D
1908-02-29,1907,Chelsea,Sunderland,2-1,2,1,1,1,3,1,H
1908-02-29,1907,Liverpool,Bristol City,3-1,3,1,1,1,4,2,H
1908-02-29,1907,Manchester United,Birmingham City,1-0,1,0,1,1,1,1,H
1908-02-29,1907,Nottingham Forest,Everton,5-2,5,2,1,1,7,3,H
1908-02-29,1907,Sheffield United,Arsenal,2-2,2,2,1,1,4,0,D
1908-03-02,1907,Aston Villa,Notts County,5-1,5,1,1,1,6,4,H
1908-03-07,1907,Arsenal,Chelsea,0-0,0,0,1,1,0,0,D
1908-03-07,1907,Birmingham City,Blackburn Rovers,1-1,1,1,1,1,2,0,D
1908-03-07,1907,Bristol City,Middlesbrough,0-1,0,1,1,1,1,-1,A
1908-03-07,1907,Manchester City,Aston Villa,3-2,3,2,1,1,5,1,H
1908-03-07,1907,Notts County,Liverpool,2-2,2,2,1,1,4,0,D
1908-03-07,1907,Preston North End,Bury,3-1,3,1,1,1,4,2,H
1908-03-07,1907,Sheffield Wednesday,Sheffield United,2-0,2,0,1,1,2,2,H
1908-03-07,1907,Sunderland,Nottingham Forest,7-2,7,2,1,1,9,5,H
1908-03-09,1907,Sheffield Wednesday,Liverpool,1-2,1,2,1,1,3,-1,A
1908-03-11,1907,Bristol City,Aston Villa,2-2,2,2,1,1,4,0,D
1908-03-11,1907,Manchester City,Sheffield United,0-2,0,2,1,1,2,-2,A
1908-03-11,1907,Newcastle United,Preston North End,0-0,0,0,1,1,0,0,D
1908-03-14,1907,Aston Villa,Preston North End,3-0,3,0,1,1,3,3,H
1908-03-14,1907,Blackburn Rovers,Everton,2-0,2,0,1,1,2,2,H
1908-03-14,1907,Bolton Wanderers,Birmingham City,1-0,1,0,1,1,1,1,H
1908-03-14,1907,Chelsea,Sheffield Wednesday,3-1,3,1,1,1,4,2,H
1908-03-14,1907,Liverpool,Manchester City,0-1,0,1,1,1,1,-1,A
1908-03-14,1907,Manchester United,Sunderland,3-0,3,0,1,1,3,3,H
1908-03-14,1907,Middlesbrough,Notts County,3-1,3,1,1,1,4,2,H
1908-03-14,1907,Newcastle United,Bury,3-0,3,0,1,1,3,3,H
1908-03-14,1907,Nottingham Forest,Arsenal,1-0,1,0,1,1,1,1,H
1908-03-14,1907,Sheffield United,Bristol City,2-0,2,0,1,1,2,2,H
1908-03-18,1907,Everton,Birmingham City,4-1,4,1,1,1,5,3,H
1908-03-21,1907,Arsenal,Manchester United,1-0,1,0,1,1,1,1,H
1908-03-21,1907,Birmingham City,Newcastle United,1-1,1,1,1,1,2,0,D
1908-03-21,1907,Bristol City,Chelsea,0-0,0,0,1,1,0,0,D
1908-03-21,1907,Bury,Aston Villa,2-1,2,1,1,1,3,1,H
1908-03-21,1907,Everton,Bolton Wanderers,2-1,2,1,1,1,3,1,H
1908-03-21,1907,Manchester City,Middlesbrough,2-1,2,1,1,1,3,1,H
1908-03-21,1907,Notts County,Sheffield United,0-3,0,3,1,1,3,-3,A
1908-03-21,1907,Preston North End,Liverpool,3-0,3,0,1,1,3,3,H
1908-03-21,1907,Sheffield Wednesday,Nottingham Forest,2-1,2,1,1,1,3,1,H
1908-03-21,1907,Sunderland,Blackburn Rovers,4-0,4,0,1,1,4,4,H
1908-03-23,1907,Blackburn Rovers,Newcastle United,1-1,1,1,1,1,2,0,D
1908-03-25,1907,Liverpool,Manchester United,7-4,7,4,1,1,11,3,H
1908-03-28,1907,Birmingham City,Everton,2-1,2,1,1,1,3,1,H
1908-03-28,1907,Blackburn Rovers,Arsenal,1-1,1,1,1,1,2,0,D
1908-03-28,1907,Bolton Wanderers,Sunderland,2-3,2,3,1,1,5,-1,A
1908-03-28,1907,Bury,Liverpool,3-1,3,1,1,1,4,2,H
1908-03-28,1907,Manchester United,Sheffield Wednesday,4-1,4,1,1,1,5,3,H
1908-03-28,1907,Middlesbrough,Preston North End,1-0,1,0,1,1,1,1,H
1908-03-28,1907,Nottingham Forest,Bristol City,3-1,3,1,1,1,4,2,H
1908-03-28,1907,Sheffield United,Manchester City,1-2,1,2,1,1,3,-1,A
1908-03-30,1907,Birmingham City,Nottingham Forest,1-0,1,0,1,1,1,1,H
1908-04-01,1907,Bolton Wanderers,Newcastle United,4-0,4,0,1,1,4,4,H
1908-04-01,1907,Everton,Chelsea,0-3,0,3,1,1,3,-3,A
1908-04-04,1907,Arsenal,Bolton Wanderers,1-1,1,1,1,1,2,0,D
1908-04-04,1907,Aston Villa,Liverpool,5-1,5,1,1,1,6,4,H
1908-04-04,1907,Bristol City,Manchester United,1-1,1,1,1,1,2,0,D
1908-04-04,1907,Bury,Middlesbrough,1-4,1,4,1,1,5,-3,A
1908-04-04,1907,Everton,Newcastle United,2-0,2,0,1,1,2,2,H
1908-04-04,1907,Manchester City,Chelsea,0-3,0,3,1,1,3,-3,A
1908-04-04,1907,Notts County,Nottingham Forest,2-0,2,0,1,1,2,2,H
1908-04-04,1907,Preston North End,Sheffield United,0-0,0,0,1,1,0,0,D
1908-04-04,1907,Sheffield Wednesday,Blackburn Rovers,2-0,2,0,1,1,2,2,H
1908-04-04,1907,Sunderland,Birmingham City,1-0,1,0,1,1,1,1,H
1908-04-06,1907,Blackburn Rovers,Liverpool,1-3,1,3,1,1,4,-2,A
1908-04-06,1907,Manchester City,Preston North End,5-0,5,0,1,1,5,5,H
1908-04-08,1907,Everton,Manchester United,1-3,1,3,1,1,4,-2,A
1908-04-08,1907,Middlesbrough,Sheffield Wednesday,6-1,6,1,1,1,7,5,H
1908-04-08,1907,Newcastle United,Aston Villa,2-5,2,5,1,1,7,-3,A
1908-04-11,1907,Birmingham City,Arsenal,1-2,1,2,1,1,3,-1,A
1908-04-11,1907,Blackburn Rovers,Bristol City,4-1,4,1,1,1,5,3,H
1908-04-11,1907,Bolton Wanderers,Sheffield Wednesday,2-1,2,1,1,1,3,1,H
1908-04-11,1907,Chelsea,Preston North End,0-0,0,0,1,1,0,0,D
1908-04-11,1907,Everton,Sunderland,0-3,0,3,1,1,3,-3,A
1908-04-11,1907,Manchester United,Notts County,0-1,0,1,1,1,1,-1,A
1908-04-11,1907,Middlesbrough,Aston Villa,0-1,0,1,1,1,1,-1,A
1908-04-11,1907,Newcastle United,Liverpool,3-1,3,1,1,1,4,2,H
1908-04-11,1907,Nottingham Forest,Manchester City,3-1,3,1,1,1,4,2,H
1908-04-11,1907,Sheffield United,Bury,0-2,0,2,1,1,2,-2,A
1908-04-17,1907,Bolton Wanderers,Aston Villa,3-1,3,1,1,1,4,2,H
1908-04-17,1907,Bury,Blackburn Rovers,1-1,1,1,1,1,2,0,D
1908-04-17,1907,Liverpool,Everton,0-0,0,0,1,1,0,0,D
1908-04-17,1907,Manchester City,Birmingham City,2-1,2,1,1,1,3,1,H
1908-04-17,1907,Newcastle United,Arsenal,2-1,2,1,1,1,3,1,H
1908-04-17,1907,Nottingham Forest,Manchester United,2-0,2,0,1,1,2,2,H
1908-04-17,1907,Sunderland,Sheffield Wednesday,1-2,1,2,1,1,3,-1,A
1908-04-18,1907,Arsenal,Everton,2-1,2,1,1,1,3,1,H
1908-04-18,1907,Aston Villa,Sheffield United,1-0,1,0,1,1,1,1,H
1908-04-18,1907,Bristol City,Bolton Wanderers,2-0,2,0,1,1,2,2,H
1908-04-18,1907,Bury,Chelsea,1-1,1,1,1,1,2,0,D
1908-04-18,1907,Liverpool,Middlesbrough,0-1,0,1,1,1,1,-1,A
1908-04-18,1907,Manchester City,Manchester United,0-0,0,0,1,1,0,0,D
1908-04-18,1907,Newcastle United,Sunderland,1-3,1,3,1,1,4,-2,A
1908-04-18,1907,Notts County,Blackburn Rovers,0-2,0,2,1,1,2,-2,A
1908-04-18,1907,Preston North End,Nottingham Forest,0-1,0,1,1,1,1,-1,A
1908-04-18,1907,Sheffield Wednesday,Birmingham City,1-4,1,4,1,1,5,-3,A
1908-04-20,1907,Arsenal,Sheffield Wednesday,1-1,1,1,1,1,2,0,D
1908-04-20,1907,Bristol City,Sunderland,3-0,3,0,1,1,3,3,H
1908-04-20,1907,Chelsea,Liverpool,0-2,0,2,1,1,2,-2,A
1908-04-20,1907,Everton,Notts County,1-0,1,0,1,1,1,1,H
1908-04-20,1907,Manchester United,Aston Villa,1-2,1,2,1,1,3,-1,A
1908-04-20,1907,Middlesbrough,Newcastle United,2-1,2,1,1,1,3,1,H
1908-04-20,1907,Nottingham Forest,Sheffield United,1-1,1,1,1,1,2,0,D
1908-04-21,1907,Manchester City,Bristol City,0-0,0,0,1,1,0,0,D
1908-04-22,1907,Bolton Wanderers,Manchester United,2-2,2,2,1,1,4,0,D
1908-04-25,1907,Birmingham City,Bristol City,0-4,0,4,1,1,4,-4,A
1908-04-25,1907,Blackburn Rovers,Manchester City,0-0,0,0,1,1,0,0,D
1908-04-25,1907,Bolton Wanderers,Notts County,0-1,0,1,1,1,1,-1,A
1908-04-25,1907,Chelsea,Aston Villa,1-3,1,3,1,1,4,-2,A
1908-04-25,1907,Everton,Sheffield Wednesday,0-0,0,0,1,1,0,0,D
1908-04-25,1907,Manchester United,Preston North End,2-1,2,1,1,1,3,1,H
1908-04-25,1907,Nottingham Forest,Bury,1-2,1,2,1,1,3,-1,A
1908-04-27,1907,Liverpool,Bury,2-1,2,1,1,1,3,1,H
1908-04-29,1907,Chelsea,Notts County,1-2,1,2,1,1,3,-1,A
1908-09-01,1908,Blackburn Rovers,Bristol City,1-1,1,1,1,1,2,0,D
1908-09-01,1908,Bury,Sheffield United,1-2,1,2,1,1,3,-1,A
1908-09-01,1908,Chelsea,Preston North End,0-0,0,0,1,1,0,0,D
1908-09-01,1908,Leicester City,Sheffield Wednesday,1-1,1,1,1,1,2,0,D
1908-09-01,1908,Liverpool,Aston Villa,3-2,3,2,1,1,5,1,H
1908-09-01,1908,Manchester City,Sunderland,1-0,1,0,1,1,1,1,H
1908-09-02,1908,Arsenal,Everton,0-4,0,4,1,1,4,-4,A
1908-09-02,1908,Newcastle United,Bradford City,1-0,1,0,1,1,1,1,H
1908-09-05,1908,Aston Villa,Sheffield Wednesday,1-1,1,1,1,1,2,0,D
1908-09-05,1908,Bristol City,Everton,0-2,0,2,1,1,2,-2,A
1908-09-05,1908,Bury,Sunderland,4-2,4,2,1,1,6,2,H
1908-09-05,1908,Liverpool,Chelsea,2-1,2,1,1,1,3,1,H
1908-09-05,1908,Manchester City,Blackburn Rovers,3-3,3,3,1,1,6,0,D
1908-09-05,1908,Middlesbrough,Bradford City,1-0,1,0,1,1,1,1,H
1908-09-05,1908,Newcastle United,Leicester City,2-0,2,0,1,1,2,2,H
1908-09-05,1908,Notts County,Arsenal,2-1,2,1,1,1,3,1,H
1908-09-05,1908,Preston North End,Manchester United,0-3,0,3,1,1,3,-3,A
1908-09-05,1908,Sheffield United,Nottingham Forest,1-2,1,2,1,1,3,-1,A
1908-09-07,1908,Everton,Arsenal,0-3,0,3,1,1,3,-3,A
1908-09-07,1908,Manchester United,Bury,2-1,2,1,1,1,3,1,H
1908-09-07,1908,Preston North End,Chelsea,6-0,6,0,1,1,6,6,H
1908-09-09,1908,Middlesbrough,Sunderland,0-3,0,3,1,1,3,-3,A
1908-09-09,1908,Newcastle United,Bristol City,2-1,2,1,1,1,3,1,H
1908-09-12,1908,Arsenal,Newcastle United,1-2,1,2,1,1,3,-1,A
1908-09-12,1908,Blackburn Rovers,Liverpool,1-0,1,0,1,1,1,1,H
1908-09-12,1908,Bradford City,Manchester City,0-0,0,0,1,1,0,0,D
1908-09-12,1908,Chelsea,Bury,4-1,4,1,1,1,5,3,H
1908-09-12,1908,Everton,Preston North End,0-1,0,1,1,1,1,-1,A
1908-09-12,1908,Leicester City,Bristol City,1-1,1,1,1,1,2,0,D
1908-09-12,1908,Manchester United,Middlesbrough,6-3,6,3,1,1,9,3,H
1908-09-12,1908,Nottingham Forest,Aston Villa,1-2,1,2,1,1,3,-1,A
1908-09-12,1908,Sheffield Wednesday,Notts County,2-0,2,0,1,1,2,2,H
1908-09-12,1908,Sunderland,Sheffield United,3-1,3,1,1,1,4,2,H
1908-09-14,1908,Sheffield United,Liverpool,0-2,0,2,1,1,2,-2,A
1908-09-19,1908,Aston Villa,Sunderland,2-0,2,0,1,1,2,2,H
1908-09-19,1908,Bristol City,Arsenal,2-1,2,1,1,1,3,1,H
1908-09-19,1908,Bury,Blackburn Rovers,1-1,1,1,1,1,2,0,D
1908-09-19,1908,Liverpool,Bradford City,4-0,4,0,1,1,4,4,H
1908-09-19,1908,Manchester City,Manchester United,1-2,1,2,1,1,3,-1,A
1908-09-19,1908,Middlesbrough,Everton,2-3,2,3,1,1,5,-1,A
1908-09-19,1908,Newcastle United,Notts County,1-0,1,0,1,1,1,1,H
1908-09-19,1908,Nottingham Forest,Sheffield Wednesday,1-2,1,2,1,1,3,-1,A
1908-09-19,1908,Preston North End,Leicester City,0-1,0,1,1,1,1,-1,A
1908-09-19,1908,Sheffield United,Chelsea,1-3,1,3,1,1,4,-2,A
1908-09-21,1908,Chelsea,Nottingham Forest,2-1,2,1,1,1,3,1,H
1908-09-26,1908,Arsenal,Preston North End,1-0,1,0,1,1,1,1,H
1908-09-26,1908,Blackburn Rovers,Sheffield United,0-1,0,1,1,1,1,-1,A
1908-09-26,1908,Bradford City,Bury,4-1,4,1,1,1,5,3,H
1908-09-26,1908,Chelsea,Aston Villa,0-2,0,2,1,1,2,-2,A
1908-09-26,1908,Everton,Manchester City,6-3,6,3,1,1,9,3,H
1908-09-26,1908,Leicester City,Middlesbrough,1-1,1,1,1,1,2,0,D
1908-09-26,1908,Manchester United,Liverpool,3-2,3,2,1,1,5,1,H
1908-09-26,1908,Notts County,Bristol City,0-1,0,1,1,1,1,-1,A
1908-09-26,1908,Sheffield Wednesday,Newcastle United,2-0,2,0,1,1,2,2,H
1908-09-26,1908,Sunderland,Nottingham Forest,2-1,2,1,1,1,3,1,H
1908-10-01,1908,Nottingham Forest,Liverpool,5-1,5,1,1,1,6,4,H
1908-10-03,1908,Aston Villa,Blackburn Rovers,1-1,1,1,1,1,2,0,D
1908-10-03,1908,Bristol City,Newcastle United,3-3,3,3,1,1,6,0,D
1908-10-03,1908,Bury,Manchester United,2-2,2,2,1,1,4,0,D
1908-10-03,1908,Liverpool,Everton,0-1,0,1,1,1,1,-1,A
1908-10-03,1908,Manchester City,Leicester City,5-2,5,2,1,1,7,3,H
1908-10-03,1908,Middlesbrough,Arsenal,1-1,1,1,1,1,2,0,D
1908-10-03,1908,Nottingham Forest,Chelsea,2-1,2,1,1,1,3,1,H
1908-10-03,1908,Preston North End,Notts County,0-0,0,0,1,1,0,0,D
1908-10-03,1908,Sheffield United,Bradford City,3-0,3,0,1,1,3,3,H
1908-10-03,1908,Sunderland,Sheffield Wednesday,4-2,4,2,1,1,6,2,H
1908-10-10,1908,Arsenal,Manchester City,3-0,3,0,1,1,3,3,H
1908-10-10,1908,Blackburn Rovers,Nottingham Forest,0-3,0,3,1,1,3,-3,A
1908-10-10,1908,Bradford City,Aston Villa,1-1,1,1,1,1,2,0,D
1908-10-10,1908,Chelsea,Sunderland,2-0,2,0,1,1,2,2,H
1908-10-10,1908,Everton,Bury,4-0,4,0,1,1,4,4,H
1908-10-10,1908,Leicester City,Liverpool,3-2,3,2,1,1,5,1,H
1908-10-10,1908,Manchester United,Sheffield United,2-1,2,1,1,1,3,1,H
1908-10-10,1908,Newcastle United,Preston North End,2-0,2,0,1,1,2,2,H
1908-10-10,1908,Notts County,Middlesbrough,3-2,3,2,1,1,5,1,H
1908-10-10,1908,Sheffield Wednesday,Bristol City,2-0,2,0,1,1,2,2,H
1908-10-17,1908,Aston Villa,Manchester United,3-1,3,1,1,1,4,2,H
1908-10-17,1908,Bury,Leicester City,2-2,2,2,1,1,4,0,D
1908-10-17,1908,Chelsea,Sheffield Wednesday,2-2,2,2,1,1,4,0,D
1908-10-17,1908,Liverpool,Arsenal,2-2,2,2,1,1,4,0,D
1908-10-17,1908,Manchester City,Notts County,1-0,1,0,1,1,1,1,H
1908-10-17,1908,Middlesbrough,Newcastle United,0-0,0,0,1,1,0,0,D
1908-10-17,1908,Nottingham Forest,Bradford City,2-1,2,1,1,1,3,1,H
1908-10-17,1908,Preston North End,Bristol City,2-1,2,1,1,1,3,1,H
1908-10-17,1908,Sheffield United,Everton,1-5,1,5,1,1,6,-4,A
1908-10-17,1908,Sunderland,Blackburn Rovers,0-1,0,1,1,1,1,-1,A
1908-10-24,1908,Arsenal,Bury,4-0,4,0,1,1,4,4,H
1908-10-24,1908,Blackburn Rovers,Chelsea,2-0,2,0,1,1,2,2,H
1908-10-24,1908,Bradford City,Sunderland,0-2,0,2,1,1,2,-2,A
1908-10-24,1908,Bristol City,Middlesbrough,1-1,1,1,1,1,2,0,D
1908-10-24,1908,Everton,Aston Villa,3-1,3,1,1,1,4,2,H
1908-10-24,1908,Leicester City,Sheffield United,1-1,1,1,1,1,2,0,D
1908-10-24,1908,Manchester United,Nottingham Forest,2-2,2,2,1,1,4,0,D
1908-10-24,1908,Newcastle United,Manchester City,2-0,2,0,1,1,2,2,H
1908-10-24,1908,Notts County,Liverpool,1-2,1,2,1,1,3,-1,A
1908-10-24,1908,Sheffield Wednesday,Preston North End,1-0,1,0,1,1,1,1,H
1908-10-31,1908,Aston Villa,Leicester City,1-1,1,1,1,1,2,0,D
1908-10-31,1908,Blackburn Rovers,Sheffield Wednesday,2-2,2,2,1,1,4,0,D
1908-10-31,1908,Bury,Notts County,3-1,3,1,1,1,4,2,H
1908-10-31,1908,Chelsea,Bradford City,1-1,1,1,1,1,2,0,D
1908-10-31,1908,Liverpool,Newcastle United,2-1,2,1,1,1,3,1,H
1908-10-31,1908,Manchester City,Bristol City,5-1,5,1,1,1,6,4,H
1908-10-31,1908,Middlesbrough,Preston North End,4-2,4,2,1,1,6,2,H
1908-10-31,1908,Nottingham Forest,Everton,1-2,1,2,1,1,3,-1,A
1908-10-31,1908,Sheffield United,Arsenal,1-1,1,1,1,1,2,0,D
1908-10-31,1908,Sunderland,Manchester United,6-1,6,1,1,1,7,5,H
1908-11-07,1908,Arsenal,Aston Villa,0-1,0,1,1,1,1,-1,A
1908-11-07,1908,Bradford City,Blackburn Rovers,0-2,0,2,1,1,2,-2,A
1908-11-07,1908,Bristol City,Liverpool,1-0,1,0,1,1,1,1,H
1908-11-07,1908,Everton,Sunderland,4-0,4,0,1,1,4,4,H
1908-11-07,1908,Leicester City,Nottingham Forest,0-3,0,3,1,1,3,-3,A
1908-11-07,1908,Manchester United,Chelsea,0-1,0,1,1,1,1,-1,A
1908-11-07,1908,Newcastle United,Bury,3-1,3,1,1,1,4,2,H
1908-11-07,1908,Notts County,Sheffield United,3-1,3,1,1,1,4,2,H
1908-11-07,1908,Preston North End,Manchester City,3-0,3,0,1,1,3,3,H
1908-11-07,1908,Sheffield Wednesday,Middlesbrough,3-2,3,2,1,1,5,1,H
1908-11-14,1908,Aston Villa,Notts County,1-1,1,1,1,1,2,0,D
1908-11-14,1908,Blackburn Rovers,Manchester United,1-3,1,3,1,1,4,-2,A
1908-11-14,1908,Bradford City,Sheffield Wednesday,0-0,0,0,1,1,0,0,D
1908-11-14,1908,Bury,Bristol City,1-2,1,2,1,1,3,-1,A
1908-11-14,1908,Chelsea,Everton,3-3,3,3,1,1,6,0,D
1908-11-14,1908,Liverpool,Preston North End,2-1,2,1,1,1,3,1,H
1908-11-14,1908,Manchester City,Middlesbrough,0-0,0,0,1,1,0,0,D
1908-11-14,1908,Nottingham Forest,Arsenal,0-1,0,1,1,1,1,-1,A
1908-11-14,1908,Sheffield United,Newcastle United,1-1,1,1,1,1,2,0,D
1908-11-14,1908,Sunderland,Leicester City,3-1,3,1,1,1,4,2,H
1908-11-21,1908,Arsenal,Sunderland,0-4,0,4,1,1,4,-4,A
1908-11-21,1908,Bristol City,Sheffield United,1-1,1,1,1,1,2,0,D
1908-11-21,1908,Everton,Blackburn Rovers,4-4,4,4,1,1,8,0,D
1908-11-21,1908,Leicester City,Chelsea,5-2,5,2,1,1,7,3,H
1908-11-21,1908,Manchester United,Bradford City,2-0,2,0,1,1,2,2,H
1908-11-21,1908,Middlesbrough,Liverpool,1-0,1,0,1,1,1,1,H
1908-11-21,1908,Newcastle United,Aston Villa,0-2,0,2,1,1,2,-2,A
1908-11-21,1908,Notts County,Nottingham Forest,3-0,3,0,1,1,3,3,H
1908-11-21,1908,Preston North End,Bury,0-2,0,2,1,1,2,-2,A
1908-11-21,1908,Sheffield Wednesday,Manchester City,3-1,3,1,1,1,4,2,H
1908-11-28,1908,Aston Villa,Bristol City,1-1,1,1,1,1,2,0,D
1908-11-28,1908,Blackburn Rovers,Leicester City,3-0,3,0,1,1,3,3,H
1908-11-28,1908,Bradford City,Everton,1-1,1,1,1,1,2,0,D
1908-11-28,1908,Bury,Middlesbrough,2-1,2,1,1,1,3,1,H
1908-11-28,1908,Chelsea,Arsenal,1-2,1,2,1,1,3,-1,A
1908-11-28,1908,Liverpool,Manchester City,1-3,1,3,1,1,4,-2,A
1908-11-28,1908,Manchester United,Sheffield Wednesday,3-1,3,1,1,1,4,2,H
1908-11-28,1908,Nottingham Forest,Newcastle United,0-4,0,4,1,1,4,-4,A
1908-11-28,1908,Sheffield United,Preston North End,2-1,2,1,1,1,3,1,H
1908-11-28,1908,Sunderland,Notts County,0-1,0,1,1,1,1,-1,A
1908-12-05,1908,Arsenal,Blackburn Rovers,0-1,0,1,1,1,1,-1,A
1908-12-05,1908,Bristol City,Nottingham Forest,2-1,2,1,1,1,3,1,H
1908-12-05,1908,Everton,Manchester United,3-2,3,2,1,1,5,1,H
1908-12-05,1908,Leicester City,Bradford City,1-4,1,4,1,1,5,-3,A
1908-12-05,1908,Manchester City,Bury,6-1,6,1,1,1,7,5,H
1908-12-05,1908,Middlesbrough,Sheffield United,1-2,1,2,1,1,3,-1,A
1908-12-05,1908,Newcastle United,Sunderland,1-9,1,9,1,1,10,-8,A
1908-12-05,1908,Notts County,Chelsea,3-0,3,0,1,1,3,3,H
1908-12-05,1908,Preston North End,Aston Villa,3-2,3,2,1,1,5,1,H
1908-12-05,1908,Sheffield Wednesday,Liverpool,2-3,2,3,1,1,5,-1,A
1908-12-12,1908,Aston Villa,Middlesbrough,0-3,0,3,1,1,3,-3,A
1908-12-12,1908,Blackburn Rovers,Notts County,0-2,0,2,1,1,2,-2,A
1908-12-12,1908,Bradford City,Arsenal,4-1,4,1,1,1,5,3,H
1908-12-12,1908,Bury,Liverpool,2-1,2,1,1,1,3,1,H
1908-12-12,1908,Chelsea,Newcastle United,1-2,1,2,1,1,3,-1,A
1908-12-12,1908,Everton,Sheffield Wednesday,1-0,1,0,1,1,1,1,H
1908-12-12,1908,Manchester United,Leicester City,4-2,4,2,1,1,6,2,H
1908-12-12,1908,Nottingham Forest,Preston North End,1-1,1,1,1,1,2,0,D
1908-12-12,1908,Sheffield United,Manchester City,4-0,4,0,1,1,4,4,H
1908-12-12,1908,Sunderland,Bristol City,0-2,0,2,1,1,2,-2,A
1908-12-19,1908,Arsenal,Manchester United,0-1,0,1,1,1,1,-1,A
1908-12-19,1908,Bristol City,Chelsea,1-0,1,0,1,1,1,1,H
1908-12-19,1908,Leicester City,Everton,0-2,0,2,1,1,2,-2,A
1908-12-19,1908,Liverpool,Sheffield United,2-1,2,1,1,1,3,1,H
1908-12-19,1908,Manchester City,Aston Villa,2-0,2,0,1,1,2,2,H
1908-12-19,1908,Middlesbrough,Nottingham Forest,4-0,4,0,1,1,4,4,H
1908-12-19,1908,Newcastle United,Blackburn Rovers,2-0,2,0,1,1,2,2,H
1908-12-19,1908,Notts County,Bradford City,1-1,1,1,1,1,2,0,D
1908-12-19,1908,Preston North End,Sunderland,1-0,1,0,1,1,1,1,H
1908-12-19,1908,Sheffield Wednesday,Bury,4-3,4,3,1,1,7,1,H
1908-12-25,1908,Aston Villa,Liverpool,1-1,1,1,1,1,2,0,D
1908-12-25,1908,Blackburn Rovers,Middlesbrough,0-0,0,0,1,1,0,0,D
1908-12-25,1908,Bradford City,Bristol City,0-1,0,1,1,1,1,-1,A
1908-12-25,1908,Bury,Nottingham Forest,3-2,3,2,1,1,5,1,H
1908-12-25,1908,Everton,Notts County,0-1,0,1,1,1,1,-1,A
1908-12-25,1908,Leicester City,Arsenal,1-1,1,1,1,1,2,0,D
1908-12-25,1908,Manchester City,Chelsea,1-2,1,2,1,1,3,-1,A
1908-12-25,1908,Newcastle United,Manchester United,2-1,2,1,1,1,3,1,H
1908-12-25,1908,Sheffield Wednesday,Sheffield United,1-0,1,0,1,1,1,1,H
1908-12-26,1908,Arsenal,Leicester City,2-1,2,1,1,1,3,1,H
1908-12-26,1908,Aston Villa,Bury,3-0,3,0,1,1,3,3,H
1908-12-26,1908,Bristol City,Bradford City,0-1,0,1,1,1,1,-1,A
1908-12-26,1908,Chelsea,Manchester City,1-2,1,2,1,1,3,-1,A
1908-12-26,1908,Liverpool,Nottingham Forest,1-1,1,1,1,1,2,0,D
1908-12-26,1908,Manchester United,Newcastle United,1-0,1,0,1,1,1,1,H
1908-12-26,1908,Notts County,Everton,0-0,0,0,1,1,0,0,D
1908-12-26,1908,Preston North End,Blackburn Rovers,2-0,2,0,1,1,2,2,H
1908-12-26,1908,Sheffield United,Sheffield Wednesday,2-1,2,1,1,1,3,1,H
1908-12-26,1908,Sunderland,Middlesbrough,2-0,2,0,1,1,2,2,H
1908-12-28,1908,Nottingham Forest,Manchester City,0-2,0,2,1,1,2,-2,A
1908-12-28,1908,Sheffield Wednesday,Arsenal,6-2,6,2,1,1,8,4,H
1909-01-01,1908,Blackburn Rovers,Preston North End,1-1,1,1,1,1,2,0,D
1909-01-01,1908,Bury,Aston Villa,1-2,1,2,1,1,3,-1,A
1909-01-01,1908,Everton,Newcastle United,0-1,0,1,1,1,1,-1,A
1909-01-01,1908,Manchester United,Notts County,4-3,4,3,1,1,7,1,H
1909-01-01,1908,Middlesbrough,Chelsea,1-4,1,4,1,1,5,-3,A
1909-01-01,1908,Sheffield Wednesday,Leicester City,3-1,3,1,1,1,4,2,H
1909-01-01,1908,Sunderland,Liverpool,1-4,1,4,1,1,5,-3,A
1909-01-02,1908,Arsenal,Notts County,1-0,1,0,1,1,1,1,H
1909-01-02,1908,Blackburn Rovers,Manchester City,3-2,3,2,1,1,5,1,H
1909-01-02,1908,Bradford City,Middlesbrough,0-2,0,2,1,1,2,-2,A
1909-01-02,1908,Chelsea,Liverpool,3-0,3,0,1,1,3,3,H
1909-01-02,1908,Everton,Bristol City,5-2,5,2,1,1,7,3,H
1909-01-02,1908,Leicester City,Newcastle United,0-4,0,4,1,1,4,-4,A
1909-01-02,1908,Manchester United,Preston North End,0-2,0,2,1,1,2,-2,A
1909-01-02,1908,Nottingham Forest,Sheffield United,0-2,0,2,1,1,2,-2,A
1909-01-02,1908,Sheffield Wednesday,Aston Villa,4-2,4,2,1,1,6,2,H
1909-01-02,1908,Sunderland,Bury,3-1,3,1,1,1,4,2,H
1909-01-09,1908,Aston Villa,Nottingham Forest,1-2,1,2,1,1,3,-1,A
1909-01-09,1908,Bristol City,Leicester City,1-1,1,1,1,1,2,0,D
1909-01-09,1908,Liverpool,Blackburn Rovers,1-1,1,1,1,1,2,0,D
1909-01-09,1908,Manchester City,Bradford City,4-3,4,3,1,1,7,1,H
1909-01-09,1908,Middlesbrough,Manchester United,5-0,5,0,1,1,5,5,H
1909-01-09,1908,Newcastle United,Arsenal,3-1,3,1,1,1,4,2,H
1909-01-09,1908,Notts County,Sheffield Wednesday,1-0,1,0,1,1,1,1,H
1909-01-09,1908,Preston North End,Everton,3-3,3,3,1,1,6,0,D
1909-01-09,1908,Sheffield United,Sunderland,0-2,0,2,1,1,2,-2,A
1909-01-23,1908,Arsenal,Bristol City,1-1,1,1,1,1,2,0,D
1909-01-23,1908,Blackburn Rovers,Bury,0-1,0,1,1,1,1,-1,A
1909-01-23,1908,Bradford City,Liverpool,0-2,0,2,1,1,2,-2,A
1909-01-23,1908,Chelsea,Sheffield United,1-1,1,1,1,1,2,0,D
1909-01-23,1908,Everton,Middlesbrough,1-1,1,1,1,1,2,0,D
1909-01-23,1908,Leicester City,Preston North End,0-0,0,0,1,1,0,0,D
1909-01-23,1908,Manchester United,Manchester City,3-1,3,1,1,1,4,2,H
1909-01-23,1908,Notts County,Newcastle United,0-4,0,4,1,1,4,-4,A
1909-01-23,1908,Sheffield Wednesday,Nottingham Forest,3-0,3,0,1,1,3,3,H
1909-01-23,1908,Sunderland,Aston Villa,4-3,4,3,1,1,7,1,H
1909-01-30,1908,Aston Villa,Chelsea,0-0,0,0,1,1,0,0,D
1909-01-30,1908,Bristol City,Notts County,1-0,1,0,1,1,1,1,H
1909-01-30,1908,Bury,Bradford City,2-1,2,1,1,1,3,1,H
1909-01-30,1908,Liverpool,Manchester United,3-1,3,1,1,1,4,2,H
1909-01-30,1908,Manchester City,Everton,4-0,4,0,1,1,4,4,H
1909-01-30,1908,Middlesbrough,Leicester City,6-2,6,2,1,1,8,4,H
1909-01-30,1908,Newcastle United,Sheffield Wednesday,1-0,1,0,1,1,1,1,H
1909-01-30,1908,Nottingham Forest,Sunderland,4-0,4,0,1,1,4,4,H
1909-01-30,1908,Preston North End,Arsenal,0-0,0,0,1,1,0,0,D
1909-01-30,1908,Sheffield United,Blackburn Rovers,0-0,0,0,1,1,0,0,D
1909-02-06,1908,Sheffield United,Aston Villa,3-1,3,1,1,1,4,2,H
1909-02-13,1908,Aston Villa,Bradford City,1-3,1,3,1,1,4,-2,A
1909-02-13,1908,Bristol City,Sheffield Wednesday,1-1,1,1,1,1,2,0,D
1909-02-13,1908,Bury,Everton,2-2,2,2,1,1,4,0,D
1909-02-13,1908,Liverpool,Leicester City,4-1,4,1,1,1,5,3,H
1909-02-13,1908,Manchester City,Arsenal,2-2,2,2,1,1,4,0,D
1909-02-13,1908,Middlesbrough,Notts County,1-2,1,2,1,1,3,-1,A
1909-02-13,1908,Nottingham Forest,Blackburn Rovers,2-1,2,1,1,1,3,1,H
1909-02-13,1908,Preston North End,Newcastle United,0-1,0,1,1,1,1,-1,A
1909-02-13,1908,Sheffield United,Manchester United,0-0,0,0,1,1,0,0,D
1909-02-13,1908,Sunderland,Chelsea,1-2,1,2,1,1,3,-1,A
1909-02-15,1908,Blackburn Rovers,Aston Villa,3-1,3,1,1,1,4,2,H
1909-02-20,1908,Arsenal,Liverpool,5-0,5,0,1,1,5,5,H
1909-02-20,1908,Everton,Sheffield United,5-1,5,1,1,1,6,4,H
1909-02-20,1908,Leicester City,Bury,2-5,2,5,1,1,7,-3,A
1909-02-20,1908,Notts County,Manchester City,5-1,5,1,1,1,6,4,H
1909-02-27,1908,Aston Villa,Everton,3-1,3,1,1,1,4,2,H
1909-02-27,1908,Bury,Arsenal,1-1,1,1,1,1,2,0,D
1909-02-27,1908,Chelsea,Blackburn Rovers,1-1,1,1,1,1,2,0,D
1909-02-27,1908,Liverpool,Notts County,1-1,1,1,1,1,2,0,D
1909-02-27,1908,Manchester City,Newcastle United,0-2,0,2,1,1,2,-2,A
1909-02-27,1908,Middlesbrough,Bristol City,4-0,4,0,1,1,4,4,H
1909-02-27,1908,Nottingham Forest,Manchester United,2-0,2,0,1,1,2,2,H
1909-02-27,1908,Preston North End,Sheffield Wednesday,4-1,4,1,1,1,5,3,H
1909-02-27,1908,Sheffield United,Leicester City,2-1,2,1,1,1,3,1,H
1909-02-27,1908,Sunderland,Bradford City,2-1,2,1,1,1,3,1,H
1909-03-01,1908,Sheffield United,Bury,2-2,2,2,1,1,4,0,D
1909-03-06,1908,Preston North End,Middlesbrough,1-1,1,1,1,1,2,0,D
1909-03-10,1908,Notts County,Preston North End,1-0,1,0,1,1,1,1,H
1909-03-11,1908,Leicester City,Manchester City,3-1,3,1,1,1,4,2,H
1909-03-13,1908,Aston Villa,Arsenal,2-1,2,1,1,1,3,1,H
1909-03-13,1908,Blackburn Rovers,Bradford City,1-1,1,1,1,1,2,0,D
1909-03-13,1908,Bury,Newcastle United,1-1,1,1,1,1,2,0,D
1909-03-13,1908,Chelsea,Manchester United,1-1,1,1,1,1,2,0,D
1909-03-13,1908,Liverpool,Bristol City,1-2,1,2,1,1,3,-1,A
1909-03-13,1908,Manchester City,Preston North End,4-1,4,1,1,1,5,3,H
1909-03-13,1908,Middlesbrough,Sheffield Wednesday,2-1,2,1,1,1,3,1,H
1909-03-13,1908,Sheffield United,Notts County,3-2,3,2,1,1,5,1,H
1909-03-13,1908,Sunderland,Everton,2-0,2,0,1,1,2,2,H
1909-03-15,1908,Manchester United,Sunderland,2-2,2,2,1,1,4,0,D
1909-03-17,1908,Arsenal,Middlesbrough,1-1,1,1,1,1,2,0,D
1909-03-17,1908,Bristol City,Preston North End,2-3,2,3,1,1,5,-1,A
1909-03-20,1908,Arsenal,Nottingham Forest,1-2,1,2,1,1,3,-1,A
1909-03-20,1908,Bristol City,Bury,4-2,4,2,1,1,6,2,H
1909-03-20,1908,Everton,Chelsea,3-2,3,2,1,1,5,1,H
1909-03-20,1908,Leicester City,Sunderland,4-3,4,3,1,1,7,1,H
1909-03-20,1908,Manchester United,Blackburn Rovers,0-3,0,3,1,1,3,-3,A
1909-03-20,1908,Middlesbrough,Manchester City,3-0,3,0,1,1,3,3,H
1909-03-20,1908,Newcastle United,Sheffield United,4-0,4,0,1,1,4,4,H
1909-03-20,1908,Notts County,Aston Villa,1-1,1,1,1,1,2,0,D
1909-03-20,1908,Preston North End,Liverpool,2-0,2,0,1,1,2,2,H
1909-03-20,1908,Sheffield Wednesday,Bradford City,0-2,0,2,1,1,2,-2,A
1909-03-22,1908,Blackburn Rovers,Sunderland,8-1,8,1,1,1,9,7,H
1909-03-22,1908,Sheffield Wednesday,Chelsea,5-1,5,1,1,1,6,4,H
1909-03-23,1908,Bradford City,Newcastle United,1-2,1,2,1,1,3,-1,A
1909-03-24,1908,Everton,Nottingham Forest,3-3,3,3,1,1,6,0,D
1909-03-24,1908,Notts County,Bury,3-2,3,2,1,1,5,1,H
1909-03-27,1908,Blackburn Rovers,Everton,0-0,0,0,1,1,0,0,D
1909-03-27,1908,Bradford City,Sheffield United,3-1,3,1,1,1,4,2,H
1909-03-27,1908,Bury,Preston North End,0-1,0,1,1,1,1,-1,A
1909-03-27,1908,Leicester City,Aston Villa,4-2,4,2,1,1,6,2,H
1909-03-27,1908,Liverpool,Middlesbrough,1-2,1,2,1,1,3,-1,A
1909-03-27,1908,Manchester City,Sheffield Wednesday,4-0,4,0,1,1,4,4,H
1909-03-27,1908,Nottingham Forest,Notts County,1-0,1,0,1,1,1,1,H
1909-03-27,1908,Sunderland,Arsenal,1-0,1,0,1,1,1,1,H
1909-03-29,1908,Sheffield Wednesday,Sunderland,2-5,2,5,1,1,7,-3,A
1909-03-30,1908,Bradford City,Nottingham Forest,1-1,1,1,1,1,2,0,D
1909-03-31,1908,Bury,Chelsea,2-1,2,1,1,1,3,1,H
1909-03-31,1908,Manchester United,Aston Villa,0-2,0,2,1,1,2,-2,A
1909-03-31,1908,Newcastle United,Middlesbrough,1-0,1,0,1,1,1,1,H
1909-04-01,1908,Arsenal,Sheffield United,1-0,1,0,1,1,1,1,H
1909-04-03,1908,Arsenal,Chelsea,0-0,0,0,1,1,0,0,D
1909-04-03,1908,Bristol City,Aston Villa,0-0,0,0,1,1,0,0,D
1909-04-03,1908,Everton,Bradford City,0-1,0,1,1,1,1,-1,A
1909-04-03,1908,Leicester City,Blackburn Rovers,2-4,2,4,1,1,6,-2,A
1909-04-03,1908,Manchester City,Liverpool,4-0,4,0,1,1,4,4,H
1909-04-03,1908,Middlesbrough,Bury,0-1,0,1,1,1,1,-1,A
1909-04-03,1908,Newcastle United,Nottingham Forest,1-1,1,1,1,1,2,0,D
1909-04-03,1908,Notts County,Sunderland,0-0,0,0,1,1,0,0,D
1909-04-03,1908,Preston North End,Sheffield United,1-1,1,1,1,1,2,0,D
1909-04-03,1908,Sheffield Wednesday,Manchester United,2-0,2,0,1,1,2,2,H
1909-04-05,1908,Sheffield United,Bristol City,3-1,3,1,1,1,4,2,H
1909-04-09,1908,Aston Villa,Sheffield United,3-0,3,0,1,1,3,3,H
1909-04-09,1908,Chelsea,Middlesbrough,3-0,3,0,1,1,3,3,H
1909-04-09,1908,Everton,Liverpool,5-0,5,0,1,1,5,5,H
1909-04-09,1908,Manchester United,Bristol City,0-1,0,1,1,1,1,-1,A
1909-04-09,1908,Notts County,Leicester City,2-3,2,3,1,1,5,-1,A
1909-04-09,1908,Preston North End,Bradford City,0-0,0,0,1,1,0,0,D
1909-04-09,1908,Sunderland,Manchester City,2-0,2,0,1,1,2,2,H
1909-04-10,1908,Aston Villa,Preston North End,2-4,2,4,1,1,6,-2,A
1909-04-10,1908,Blackburn Rovers,Arsenal,1-3,1,3,1,1,4,-2,A
1909-04-10,1908,Bradford City,Leicester City,4-1,4,1,1,1,5,3,H
1909-04-10,1908,Bury,Manchester City,1-0,1,0,1,1,1,1,H
1909-04-10,1908,Chelsea,Notts County,3-2,3,2,1,1,5,1,H
1909-04-10,1908,Liverpool,Sheffield Wednesday,1-2,1,2,1,1,3,-1,A
1909-04-10,1908,Manchester United,Everton,2-2,2,2,1,1,4,0,D
1909-04-10,1908,Nottingham Forest,Bristol City,1-1,1,1,1,1,2,0,D
1909-04-10,1908,Sheffield United,Middlesbrough,2-0,2,0,1,1,2,2,H
1909-04-10,1908,Sunderland,Newcastle United,3-1,3,1,1,1,4,2,H
1909-04-12,1908,Arsenal,Sheffield Wednesday,2-0,2,0,1,1,2,2,H
1909-04-12,1908,Bradford City,Preston North End,2-0,2,0,1,1,2,2,H
1909-04-12,1908,Bristol City,Manchester United,0-0,0,0,1,1,0,0,D
1909-04-12,1908,Leicester City,Notts County,0-2,0,2,1,1,2,-2,A
1909-04-12,1908,Liverpool,Sunderland,3-0,3,0,1,1,3,3,H
1909-04-12,1908,Middlesbrough,Blackburn Rovers,1-0,1,0,1,1,1,1,H
1909-04-12,1908,Newcastle United,Everton,3-0,3,0,1,1,3,3,H
1909-04-12,1908,Nottingham Forest,Bury,0-2,0,2,1,1,2,-2,A
1909-04-13,1908,Bristol City,Blackburn Rovers,1-4,1,4,1,1,5,-3,A
1909-04-13,1908,Manchester City,Nottingham Forest,2-1,2,1,1,1,3,1,H
1909-04-13,1908,Notts County,Manchester United,0-1,0,1,1,1,1,-1,A
1909-04-17,1908,Arsenal,Bradford City,1-0,1,0,1,1,1,1,H
1909-04-17,1908,Bristol City,Sunderland,2-4,2,4,1,1,6,-2,A
1909-04-17,1908,Leicester City,Manchester United,3-2,3,2,1,1,5,1,H
1909-04-17,1908,Liverpool,Bury,2-2,2,2,1,1,4,0,D
1909-04-17,1908,Manchester City,Sheffield United,1-3,1,3,1,1,4,-2,A
1909-04-17,1908,Middlesbrough,Aston Villa,1-0,1,0,1,1,1,1,H
1909-04-17,1908,Newcastle United,Chelsea,1-3,1,3,1,1,4,-2,A
1909-04-17,1908,Notts County,Blackburn Rovers,2-3,2,3,1,1,5,-1,A
1909-04-17,1908,Preston North End,Nottingham Forest,1-1,1,1,1,1,2,0,D
1909-04-17,1908,Sheffield Wednesday,Everton,2-0,2,0,1,1,2,2,H
1909-04-19,1908,Sheffield Wednesday,Blackburn Rovers,1-2,1,2,1,1,3,-1,A
1909-04-20,1908,Bradford City,Chelsea,3-0,3,0,1,1,3,3,H
1909-04-21,1908,Nottingham Forest,Leicester City,12-0,12,0,1,1,12,12,H
1909-04-24,1908,Aston Villa,Manchester City,2-1,2,1,1,1,3,1,H
1909-04-24,1908,Blackburn Rovers,Newcastle United,2-4,2,4,1,1,6,-2,A
1909-04-24,1908,Bradford City,Notts County,2-2,2,2,1,1,4,0,D
1909-04-24,1908,Bury,Sheffield Wednesday,4-2,4,2,1,1,6,2,H
1909-04-24,1908,Everton,Leicester City,4-2,4,2,1,1,6,2,H
1909-04-24,1908,Nottingham Forest,Middlesbrough,4-1,4,1,1,1,5,3,H
1909-04-24,1908,Sunderland,Preston North End,2-1,2,1,1,1,3,1,H
1909-04-26,1908,Aston Villa,Newcastle United,3-0,3,0,1,1,3,3,H
1909-04-26,1908,Chelsea,Bristol City,3-1,3,1,1,1,4,2,H
1909-04-27,1908,Manchester United,Arsenal,1-4,1,4,1,1,5,-3,A
1909-04-28,1908,Bristol City,Manchester City,1-0,1,0,1,1,1,1,H
1909-04-29,1908,Bradford City,Manchester United,1-0,1,0,1,1,1,1,H
1909-04-29,1908,Chelsea,Leicester City,1-0,1,0,1,1,1,1,H
1909-04-30,1908,Newcastle United,Liverpool,0-1,0,1,1,1,1,-1,A
1909-09-01,1909,Aston Villa,Arsenal,5-1,5,1,1,1,6,4,H
1909-09-01,1909,Chelsea,Notts County,2-2,2,2,1,1,4,0,D
1909-09-01,1909,Everton,Sheffield Wednesday,1-1,1,1,1,1,2,0,D
1909-09-01,1909,Manchester United,Bradford City,1-0,1,0,1,1,1,1,H
1909-09-01,1909,Middlesbrough,Sheffield United,0-2,0,2,1,1,2,-2,A
1909-09-01,1909,Newcastle United,Bolton Wanderers,1-0,1,0,1,1,1,1,H
1909-09-01,1909,Preston North End,Nottingham Forest,0-1,0,1,1,1,1,-1,A
1909-09-01,1909,Sunderland,Tottenham Hotspur,3-1,3,1,1,1,4,2,H
1909-09-04,1909,Arsenal,Sheffield United,0-0,0,0,1,1,0,0,D
1909-09-04,1909,Blackburn Rovers,Newcastle United,2-0,2,0,1,1,2,2,H
1909-09-04,1909,Bolton Wanderers,Aston Villa,1-2,1,2,1,1,3,-1,A
1909-09-04,1909,Bradford City,Bristol City,3-1,3,1,1,1,4,2,H
1909-09-04,1909,Chelsea,Liverpool,2-1,2,1,1,1,3,1,H
1909-09-04,1909,Everton,Tottenham Hotspur,4-2,4,2,1,1,6,2,H
1909-09-04,1909,Manchester United,Bury,2-0,2,0,1,1,2,2,H
1909-09-04,1909,Nottingham Forest,Notts County,2-1,2,1,1,1,3,1,H
1909-09-04,1909,Sheffield Wednesday,Middlesbrough,1-5,1,5,1,1,6,-4,A
1909-09-04,1909,Sunderland,Preston North End,2-1,2,1,1,1,3,1,H
1909-09-06,1909,Bolton Wanderers,Liverpool,1-2,1,2,1,1,3,-1,A
1909-09-06,1909,Everton,Newcastle United,1-4,1,4,1,1,5,-3,A
1909-09-06,1909,Manchester United,Notts County,2-1,2,1,1,1,3,1,H
1909-09-07,1909,Bolton Wanderers,Newcastle United,0-4,0,4,1,1,4,-4,A
1909-09-08,1909,Bristol City,Bury,1-1,1,1,1,1,2,0,D
1909-09-11,1909,Aston Villa,Chelsea,4-1,4,1,1,1,5,3,H
1909-09-11,1909,Bristol City,Sheffield Wednesday,1-1,1,1,1,1,2,0,D
1909-09-11,1909,Bury,Bradford City,3-4,3,4,1,1,7,-1,A
1909-09-11,1909,Liverpool,Blackburn Rovers,3-1,3,1,1,1,4,2,H
1909-09-11,1909,Middlesbrough,Arsenal,5-2,5,2,1,1,7,3,H
1909-09-11,1909,Newcastle United,Nottingham Forest,1-2,1,2,1,1,3,-1,A
1909-09-11,1909,Notts County,Sunderland,1-1,1,1,1,1,2,0,D
1909-09-11,1909,Preston North End,Everton,0-1,0,1,1,1,1,-1,A
1909-09-11,1909,Sheffield United,Bolton Wanderers,2-2,2,2,1,1,4,0,D
1909-09-11,1909,Tottenham Hotspur,Manchester United,2-2,2,2,1,1,4,0,D
1909-09-13,1909,Blackburn Rovers,Bristol City,5-2,5,2,1,1,7,3,H
1909-09-18,1909,Blackburn Rovers,Aston Villa,3-2,3,2,1,1,5,1,H
1909-09-18,1909,Bolton Wanderers,Arsenal,3-0,3,0,1,1,3,3,H
1909-09-18,1909,Bradford City,Tottenham Hotspur,5-1,5,1,1,1,6,4,H
1909-09-18,1909,Bristol City,Middlesbrough,4-1,4,1,1,1,5,3,H
1909-09-18,1909,Chelsea,Sheffield United,2-2,2,2,1,1,4,0,D
1909-09-18,1909,Everton,Notts County,2-0,2,0,1,1,2,2,H
1909-09-18,1909,Manchester United,Preston North End,1-1,1,1,1,1,2,0,D
1909-09-18,1909,Nottingham Forest,Liverpool,1-4,1,4,1,1,5,-3,A
1909-09-18,1909,Sheffield Wednesday,Bury,1-4,1,4,1,1,5,-3,A
1909-09-18,1909,Sunderland,Newcastle United,0-2,0,2,1,1,2,-2,A
1909-09-20,1909,Sheffield Wednesday,Everton,1-3,1,3,1,1,4,-2,A
1909-09-25,1909,Arsenal,Chelsea,3-2,3,2,1,1,5,1,H
1909-09-25,1909,Aston Villa,Nottingham Forest,0-0,0,0,1,1,0,0,D
1909-09-25,1909,Bury,Bristol City,1-2,1,2,1,1,3,-1,A
1909-09-25,1909,Liverpool,Sunderland,1-4,1,4,1,1,5,-3,A
1909-09-25,1909,Middlesbrough,Bolton Wanderers,1-2,1,2,1,1,3,-1,A
1909-09-25,1909,Newcastle United,Everton,1-2,1,2,1,1,3,-1,A
1909-09-25,1909,Notts County,Manchester United,3-2,3,2,1,1,5,1,H
1909-09-25,1909,Preston North End,Bradford City,2-2,2,2,1,1,4,0,D
1909-09-25,1909,Sheffield United,Blackburn Rovers,3-0,3,0,1,1,3,3,H
1909-09-25,1909,Tottenham Hotspur,Sheffield Wednesday,3-0,3,0,1,1,3,3,H
1909-10-02,1909,Blackburn Rovers,Arsenal,7-0,7,0,1,1,7,7,H
1909-10-02,1909,Bradford City,Notts County,2-1,2,1,1,1,3,1,H
1909-10-02,1909,Bristol City,Tottenham Hotspur,0-0,0,0,1,1,0,0,D
1909-10-02,1909,Bury,Middlesbrough,2-1,2,1,1,1,3,1,H
1909-10-02,1909,Chelsea,Bolton Wanderers,3-2,3,2,1,1,5,1,H
1909-10-02,1909,Everton,Liverpool,2-3,2,3,1,1,5,-1,A
1909-10-02,1909,Manchester United,Newcastle United,1-1,1,1,1,1,2,0,D
1909-10-02,1909,Nottingham Forest,Sheffield United,2-3,2,3,1,1,5,-1,A
1909-10-02,1909,Sheffield Wednesday,Preston North End,4-1,4,1,1,1,5,3,H
1909-10-02,1909,Sunderland,Aston Villa,1-1,1,1,1,1,2,0,D
1909-10-07,1909,Notts County,Arsenal,5-1,5,1,1,1,6,4,H
1909-10-09,1909,Arsenal,Nottingham Forest,0-1,0,1,1,1,1,-1,A
1909-10-09,1909,Aston Villa,Everton,3-1,3,1,1,1,4,2,H
1909-10-09,1909,Bolton Wanderers,Blackburn Rovers,1-2,1,2,1,1,3,-1,A
1909-10-09,1909,Liverpool,Manchester United,3-2,3,2,1,1,5,1,H
1909-10-09,1909,Middlesbrough,Chelsea,0-1,0,1,1,1,1,-1,A
1909-10-09,1909,Newcastle United,Bradford City,1-0,1,0,1,1,1,1,H
1909-10-09,1909,Notts County,Sheffield Wednesday,0-0,0,0,1,1,0,0,D
1909-10-09,1909,Preston North End,Bristol City,3-0,3,0,1,1,3,3,H
1909-10-09,1909,Sheffield United,Sunderland,3-0,3,0,1,1,3,3,H
1909-10-09,1909,Tottenham Hotspur,Bury,1-0,1,0,1,1,1,1,H
1909-10-16,1909,Blackburn Rovers,Chelsea,1-0,1,0,1,1,1,1,H
1909-10-16,1909,Bradford City,Liverpool,1-2,1,2,1,1,3,-1,A
1909-10-16,1909,Bristol City,Notts County,3-1,3,1,1,1,4,2,H
1909-10-16,1909,Bury,Preston North End,3-1,3,1,1,1,4,2,H
1909-10-16,1909,Everton,Sheffield United,1-2,1,2,1,1,3,-1,A
1909-10-16,1909,Manchester United,Aston Villa,2-0,2,0,1,1,2,2,H
1909-10-16,1909,Nottingham Forest,Bolton Wanderers,2-0,2,0,1,1,2,2,H
1909-10-16,1909,Sheffield Wednesday,Newcastle United,3-1,3,1,1,1,4,2,H
1909-10-16,1909,Sunderland,Arsenal,6-2,6,2,1,1,8,4,H
1909-10-16,1909,Tottenham Hotspur,Middlesbrough,1-3,1,3,1,1,4,-2,A
1909-10-18,1909,Sheffield United,Notts County,2-2,2,2,1,1,4,0,D
1909-10-23,1909,Arsenal,Everton,1-0,1,0,1,1,1,1,H
1909-10-23,1909,Aston Villa,Bradford City,3-1,3,1,1,1,4,2,H
1909-10-23,1909,Bolton Wanderers,Sunderland,2-1,2,1,1,1,3,1,H
1909-10-23,1909,Chelsea,Nottingham Forest,0-1,0,1,1,1,1,-1,A
1909-10-23,1909,Liverpool,Sheffield Wednesday,3-1,3,1,1,1,4,2,H
1909-10-23,1909,Middlesbrough,Blackburn Rovers,1-3,1,3,1,1,4,-2,A
1909-10-23,1909,Newcastle United,Bristol City,3-1,3,1,1,1,4,2,H
1909-10-23,1909,Notts County,Bury,3-1,3,1,1,1,4,2,H
1909-10-23,1909,Sheffield United,Manchester United,0-1,0,1,1,1,1,-1,A
1909-10-27,1909,Chelsea,Preston North End,2-0,2,0,1,1,2,2,H
1909-10-30,1909,Bradford City,Sheffield United,2-0,2,0,1,1,2,2,H
1909-10-30,1909,Bristol City,Liverpool,0-1,0,1,1,1,1,-1,A
1909-10-30,1909,Bury,Newcastle United,1-2,1,2,1,1,3,-1,A
1909-10-30,1909,Everton,Bolton Wanderers,3-1,3,1,1,1,4,2,H
1909-10-30,1909,Manchester United,Arsenal,1-0,1,0,1,1,1,1,H
1909-10-30,1909,Nottingham Forest,Blackburn Rovers,0-4,0,4,1,1,4,-4,A
1909-10-30,1909,Preston North End,Middlesbrough,1-0,1,0,1,1,1,1,H
1909-10-30,1909,Sheffield Wednesday,Aston Villa,3-2,3,2,1,1,5,1,H
1909-10-30,1909,Sunderland,Chelsea,4-0,4,0,1,1,4,4,H
1909-10-30,1909,Tottenham Hotspur,Notts County,1-3,1,3,1,1,4,-2,A
1909-11-03,1909,Nottingham Forest,Bury,3-3,3,3,1,1,6,0,D
1909-11-06,1909,Arsenal,Bradford City,0-1,0,1,1,1,1,-1,A
1909-11-06,1909,Aston Villa,Bristol City,1-0,1,0,1,1,1,1,H
1909-11-06,1909,Blackburn Rovers,Sunderland,0-0,0,0,1,1,0,0,D
1909-11-06,1909,Bolton Wanderers,Manchester United,2-3,2,3,1,1,5,-1,A
1909-11-06,1909,Chelsea,Everton,0-1,0,1,1,1,1,-1,A
1909-11-06,1909,Liverpool,Bury,2-2,2,2,1,1,4,0,D
1909-11-06,1909,Middlesbrough,Nottingham Forest,2-1,2,1,1,1,3,1,H
1909-11-06,1909,Newcastle United,Tottenham Hotspur,1-0,1,0,1,1,1,1,H
1909-11-06,1909,Notts County,Preston North End,3-1,3,1,1,1,4,2,H
1909-11-06,1909,Sheffield United,Sheffield Wednesday,3-3,3,3,1,1,6,0,D
1909-11-13,1909,Bradford City,Bolton Wanderers,1-0,1,0,1,1,1,1,H
1909-11-13,1909,Bristol City,Sheffield United,0-2,0,2,1,1,2,-2,A
1909-11-13,1909,Bury,Aston Villa,0-2,0,2,1,1,2,-2,A
1909-11-13,1909,Everton,Blackburn Rovers,0-2,0,2,1,1,2,-2,A
1909-11-13,1909,Manchester United,Chelsea,2-0,2,0,1,1,2,2,H
1909-11-13,1909,Notts County,Middlesbrough,2-1,2,1,1,1,3,1,H
1909-11-13,1909,Preston North End,Newcastle United,4-0,4,0,1,1,4,4,H
1909-11-13,1909,Sheffield Wednesday,Arsenal,1-1,1,1,1,1,2,0,D
1909-11-13,1909,Sunderland,Nottingham Forest,2-1,2,1,1,1,3,1,H
1909-11-13,1909,Tottenham Hotspur,Liverpool,1-0,1,0,1,1,1,1,H
1909-11-20,1909,Arsenal,Bristol City,2-2,2,2,1,1,4,0,D
1909-11-20,1909,Aston Villa,Tottenham Hotspur,3-2,3,2,1,1,5,1,H
1909-11-20,1909,Blackburn Rovers,Manchester United,3-2,3,2,1,1,5,1,H
1909-11-20,1909,Chelsea,Bradford City,0-3,0,3,1,1,3,-3,A
1909-11-20,1909,Liverpool,Preston North End,2-0,2,0,1,1,2,2,H
1909-11-20,1909,Middlesbrough,Sunderland,3-2,3,2,1,1,5,1,H
1909-11-20,1909,Newcastle United,Notts County,1-3,1,3,1,1,4,-2,A
1909-11-20,1909,Nottingham Forest,Everton,1-0,1,0,1,1,1,1,H
1909-11-20,1909,Sheffield United,Bury,2-0,2,0,1,1,2,2,H
1909-11-22,1909,Preston North End,Tottenham Hotspur,4-1,4,1,1,1,5,3,H
1909-11-27,1909,Bradford City,Blackburn Rovers,2-0,2,0,1,1,2,2,H
1909-11-27,1909,Bristol City,Bolton Wanderers,1-0,1,0,1,1,1,1,H
1909-11-27,1909,Bury,Arsenal,1-2,1,2,1,1,3,-1,A
1909-11-27,1909,Everton,Sunderland,2-1,2,1,1,1,3,1,H
1909-11-27,1909,Manchester United,Nottingham Forest,2-6,2,6,1,1,8,-4,A
1909-11-27,1909,Newcastle United,Middlesbrough,2-0,2,0,1,1,2,2,H
1909-11-27,1909,Notts County,Liverpool,3-1,3,1,1,1,4,2,H
1909-11-27,1909,Preston North End,Aston Villa,1-0,1,0,1,1,1,1,H
1909-11-27,1909,Sheffield Wednesday,Chelsea,4-1,4,1,1,1,5,3,H
1909-11-27,1909,Tottenham Hotspur,Sheffield United,2-1,2,1,1,1,3,1,H
1909-12-04,1909,Arsenal,Tottenham Hotspur,1-0,1,0,1,1,1,1,H
1909-12-04,1909,Aston Villa,Notts County,1-1,1,1,1,1,2,0,D
1909-12-04,1909,Blackburn Rovers,Sheffield Wednesday,0-0,0,0,1,1,0,0,D
1909-12-04,1909,Bolton Wanderers,Bury,1-3,1,3,1,1,4,-2,A
1909-12-04,1909,Chelsea,Bristol City,4-1,4,1,1,1,5,3,H
1909-12-04,1909,Liverpool,Newcastle United,6-5,6,5,1,1,11,1,H
1909-12-04,1909,Middlesbrough,Everton,1-1,1,1,1,1,2,0,D
1909-12-04,1909,Nottingham Forest,Bradford City,1-1,1,1,1,1,2,0,D
1909-12-04,1909,Sheffield United,Preston North End,5-1,5,1,1,1,6,4,H
1909-12-04,1909,Sunderland,Manchester United,3-0,3,0,1,1,3,3,H
1909-12-11,1909,Bradford City,Sunderland,3-1,3,1,1,1,4,2,H
1909-12-11,1909,Bristol City,Blackburn Rovers,2-2,2,2,1,1,4,0,D
1909-12-11,1909,Bury,Chelsea,4-2,4,2,1,1,6,2,H
1909-12-11,1909,Liverpool,Middlesbrough,0-0,0,0,1,1,0,0,D
1909-12-11,1909,Newcastle United,Aston Villa,1-0,1,0,1,1,1,1,H
1909-12-11,1909,Notts County,Sheffield United,1-2,1,2,1,1,3,-1,A
1909-12-11,1909,Preston North End,Arsenal,3-4,3,4,1,1,7,-1,A
1909-12-11,1909,Sheffield Wednesday,Nottingham Forest,4-3,4,3,1,1,7,1,H
1909-12-11,1909,Tottenham Hotspur,Bolton Wanderers,1-1,1,1,1,1,2,0,D
1909-12-18,1909,Arsenal,Notts County,1-2,1,2,1,1,3,-1,A
1909-12-18,1909,Aston Villa,Liverpool,3-1,3,1,1,1,4,2,H
1909-12-18,1909,Blackburn Rovers,Bury,5-1,5,1,1,1,6,4,H
1909-12-18,1909,Bolton Wanderers,Preston North End,3-1,3,1,1,1,4,2,H
1909-12-18,1909,Chelsea,Tottenham Hotspur,2-1,2,1,1,1,3,1,H
1909-12-18,1909,Everton,Bradford City,1-1,1,1,1,1,2,0,D
1909-12-18,1909,Middlesbrough,Manchester United,1-2,1,2,1,1,3,-1,A
1909-12-18,1909,Nottingham Forest,Bristol City,0-0,0,0,1,1,0,0,D
1909-12-18,1909,Sheffield United,Newcastle United,4-0,4,0,1,1,4,4,H
1909-12-18,1909,Sunderland,Sheffield Wednesday,2-0,2,0,1,1,2,2,H
1909-12-25,1909,Arsenal,Newcastle United,0-3,0,3,1,1,3,-3,A
1909-12-25,1909,Blackburn Rovers,Preston North End,2-2,2,2,1,1,4,0,D
1909-12-25,1909,Bristol City,Everton,3-1,3,1,1,1,4,2,H
1909-12-25,1909,Bury,Sunderland,0-1,0,1,1,1,1,-1,A
1909-12-25,1909,Liverpool,Bolton Wanderers,3-0,3,0,1,1,3,3,H
1909-12-25,1909,Manchester United,Sheffield Wednesday,0-3,0,3,1,1,3,-3,A
1909-12-25,1909,Middlesbrough,Bradford City,3-7,3,7,1,1,10,-4,A
1909-12-25,1909,Notts County,Chelsea,2-1,2,1,1,1,3,1,H
1909-12-25,1909,Sheffield United,Aston Villa,0-1,0,1,1,1,1,-1,A
1909-12-25,1909,Tottenham Hotspur,Nottingham Forest,2-2,2,2,1,1,4,0,D
1909-12-27,1909,Arsenal,Liverpool,1-1,1,1,1,1,2,0,D
1909-12-27,1909,Aston Villa,Sheffield United,2-1,2,1,1,1,3,1,H
1909-12-27,1909,Bradford City,Middlesbrough,4-1,4,1,1,1,5,3,H
1909-12-27,1909,Chelsea,Newcastle United,2-1,2,1,1,1,3,1,H
1909-12-27,1909,Everton,Bristol City,1-0,1,0,1,1,1,1,H
1909-12-27,1909,Nottingham Forest,Tottenham Hotspur,2-2,2,2,1,1,4,0,D
1909-12-27,1909,Preston North End,Blackburn Rovers,3-2,3,2,1,1,5,1,H
1909-12-27,1909,Sheffield Wednesday,Manchester United,4-1,4,1,1,1,5,3,H
1909-12-27,1909,Sunderland,Bury,2-3,2,3,1,1,5,-1,A
1909-12-28,1909,Bristol City,Sunderland,2-3,2,3,1,1,5,-1,A
1909-12-28,1909,Notts County,Blackburn Rovers,2-2,2,2,1,1,4,0,D
1909-12-28,1909,Sheffield United,Liverpool,4-2,4,2,1,1,6,2,H
1910-01-01,1909,Blackburn Rovers,Tottenham Hotspur,2-0,2,0,1,1,2,2,H
1910-01-01,1909,Bolton Wanderers,Notts County,3-4,3,4,1,1,7,-1,A
1910-01-01,1909,Bradford City,Manchester United,0-2,0,2,1,1,2,-2,A
1910-01-01,1909,Bury,Everton,2-2,2,2,1,1,4,0,D
1910-01-01,1909,Liverpool,Arsenal,5-1,5,1,1,1,6,4,H
1910-01-01,1909,Newcastle United,Chelsea,1-0,1,0,1,1,1,1,H
1910-01-01,1909,Nottingham Forest,Aston Villa,1-4,1,4,1,1,5,-3,A
1910-01-01,1909,Sheffield United,Middlesbrough,2-0,2,0,1,1,2,2,H
1910-01-01,1909,Sunderland,Bristol City,4-0,4,0,1,1,4,4,H
1910-01-03,1909,Bolton Wanderers,Sheffield Wednesday,0-2,0,2,1,1,2,-2,A
1910-01-03,1909,Bury,Nottingham Forest,4-1,4,1,1,1,5,3,H
1910-01-03,1909,Newcastle United,Preston North End,5-2,5,2,1,1,7,3,H
1910-01-08,1909,Aston Villa,Bolton Wanderers,3-1,3,1,1,1,4,2,H
1910-01-08,1909,Bristol City,Bradford City,2-0,2,0,1,1,2,2,H
1910-01-08,1909,Bury,Manchester United,1-1,1,1,1,1,2,0,D
1910-01-08,1909,Liverpool,Chelsea,5-1,5,1,1,1,6,4,H
1910-01-08,1909,Middlesbrough,Sheffield Wednesday,4-0,4,0,1,1,4,4,H
1910-01-08,1909,Newcastle United,Blackburn Rovers,4-1,4,1,1,1,5,3,H
1910-01-08,1909,Notts County,Nottingham Forest,4-1,4,1,1,1,5,3,H
1910-01-08,1909,Preston North End,Sunderland,1-0,1,0,1,1,1,1,H
1910-01-08,1909,Sheffield United,Arsenal,2-0,2,0,1,1,2,2,H
1910-01-08,1909,Tottenham Hotspur,Everton,3-0,3,0,1,1,3,3,H
1910-01-10,1909,Preston North End,Chelsea,2-0,2,0,1,1,2,2,H
1910-01-22,1909,Arsenal,Middlesbrough,3-0,3,0,1,1,3,3,H
1910-01-22,1909,Blackburn Rovers,Liverpool,1-1,1,1,1,1,2,0,D
1910-01-22,1909,Bolton Wanderers,Sheffield United,1-0,1,0,1,1,1,1,H
1910-01-22,1909,Bradford City,Bury,0-0,0,0,1,1,0,0,D
1910-01-22,1909,Chelsea,Aston Villa,0-0,0,0,1,1,0,0,D
1910-01-22,1909,Everton,Preston North End,2-1,2,1,1,1,3,1,H
1910-01-22,1909,Manchester United,Tottenham Hotspur,5-0,5,0,1,1,5,5,H
1910-01-22,1909,Nottingham Forest,Newcastle United,0-1,0,1,1,1,1,-1,A
1910-01-22,1909,Sheffield Wednesday,Bristol City,2-0,2,0,1,1,2,2,H
1910-01-22,1909,Sunderland,Notts County,0-3,0,3,1,1,3,-3,A
1910-01-29,1909,Arsenal,Bolton Wanderers,2-0,2,0,1,1,2,2,H
1910-01-29,1909,Aston Villa,Blackburn Rovers,4-3,4,3,1,1,7,1,H
1910-01-29,1909,Tottenham Hotspur,Bradford City,0-0,0,0,1,1,0,0,D
1910-02-05,1909,Bolton Wanderers,Middlesbrough,1-1,1,1,1,1,2,0,D
1910-02-05,1909,Preston North End,Manchester United,1-0,1,0,1,1,1,1,H
1910-02-12,1909,Arsenal,Blackburn Rovers,0-1,0,1,1,1,1,-1,A
1910-02-12,1909,Aston Villa,Sunderland,3-2,3,2,1,1,5,1,H
1910-02-12,1909,Bolton Wanderers,Chelsea,5-2,5,2,1,1,7,3,H
1910-02-12,1909,Liverpool,Everton,0-1,0,1,1,1,1,-1,A
1910-02-12,1909,Middlesbrough,Bury,0-5,0,5,1,1,5,-5,A
1910-02-12,1909,Newcastle United,Manchester United,3-4,3,4,1,1,7,-1,A
1910-02-12,1909,Notts County,Bradford City,3-2,3,2,1,1,5,1,H
1910-02-12,1909,Preston North End,Sheffield Wednesday,1-0,1,0,1,1,1,1,H
1910-02-12,1909,Sheffield United,Nottingham Forest,1-4,1,4,1,1,5,-3,A
1910-02-12,1909,Tottenham Hotspur,Bristol City,3-2,3,2,1,1,5,1,H
1910-02-19,1909,Bolton Wanderers,Bradford City,1-1,1,1,1,1,2,0,D
1910-02-19,1909,Bristol City,Preston North End,2-0,2,0,1,1,2,2,H
1910-02-19,1909,Chelsea,Middlesbrough,2-1,2,1,1,1,3,1,H
1910-02-19,1909,Manchester United,Liverpool,3-4,3,4,1,1,7,-1,A
1910-02-19,1909,Sheffield Wednesday,Notts County,0-0,0,0,1,1,0,0,D
1910-02-26,1909,Arsenal,Sunderland,1-2,1,2,1,1,3,-1,A
1910-02-26,1909,Aston Villa,Manchester United,7-1,7,1,1,1,8,6,H
1910-02-26,1909,Bolton Wanderers,Nottingham Forest,2-1,2,1,1,1,3,1,H
1910-02-26,1909,Chelsea,Blackburn Rovers,3-1,3,1,1,1,4,2,H
1910-02-26,1909,Liverpool,Bradford City,1-0,1,0,1,1,1,1,H
1910-02-26,1909,Middlesbrough,Tottenham Hotspur,4-3,4,3,1,1,7,1,H
1910-02-26,1909,Newcastle United,Sheffield Wednesday,3-1,3,1,1,1,4,2,H
1910-02-26,1909,Notts County,Bristol City,0-2,0,2,1,1,2,-2,A
1910-02-26,1909,Preston North End,Bury,2-1,2,1,1,1,3,1,H
1910-02-26,1909,Sheffield United,Everton,3-0,3,0,1,1,3,3,H
1910-03-02,1909,Nottingham Forest,Arsenal,1-1,1,1,1,1,2,0,D
1910-03-05,1909,Blackburn Rovers,Middlesbrough,1-1,1,1,1,1,2,0,D
1910-03-05,1909,Bradford City,Aston Villa,1-2,1,2,1,1,3,-1,A
1910-03-05,1909,Bury,Notts County,1-1,1,1,1,1,2,0,D
1910-03-05,1909,Manchester United,Sheffield United,1-0,1,0,1,1,1,1,H
1910-03-05,1909,Nottingham Forest,Chelsea,0-0,0,0,1,1,0,0,D
1910-03-05,1909,Sheffield Wednesday,Liverpool,3-0,3,0,1,1,3,3,H
1910-03-05,1909,Sunderland,Bolton Wanderers,3-0,3,0,1,1,3,3,H
1910-03-05,1909,Tottenham Hotspur,Preston North End,2-1,2,1,1,1,3,1,H
1910-03-07,1909,Everton,Arsenal,1-0,1,0,1,1,1,1,H
1910-03-07,1909,Sheffield United,Chelsea,0-0,0,0,1,1,0,0,D
1910-03-09,1909,Bradford City,Newcastle United,3-3,3,3,1,1,6,0,D
1910-03-09,1909,Bury,Sheffield Wednesday,3-2,3,2,1,1,5,1,H
1910-03-12,1909,Arsenal,Manchester United,0-0,0,0,1,1,0,0,D
1910-03-12,1909,Aston Villa,Sheffield Wednesday,5-0,5,0,1,1,5,5,H
1910-03-12,1909,Blackburn Rovers,Nottingham Forest,2-2,2,2,1,1,4,0,D
1910-03-12,1909,Bolton Wanderers,Everton,0-1,0,1,1,1,1,-1,A
1910-03-12,1909,Chelsea,Sunderland,1-4,1,4,1,1,5,-3,A
1910-03-12,1909,Liverpool,Bristol City,0-1,0,1,1,1,1,-1,A
1910-03-12,1909,Middlesbrough,Preston North End,1-0,1,0,1,1,1,1,H
1910-03-12,1909,Newcastle United,Bury,2-2,2,2,1,1,4,0,D
1910-03-12,1909,Notts County,Tottenham Hotspur,3-0,3,0,1,1,3,3,H
1910-03-12,1909,Sheffield United,Bradford City,1-2,1,2,1,1,3,-1,A
1910-03-14,1909,Everton,Aston Villa,0-0,0,0,1,1,0,0,D
1910-03-14,1909,Sheffield Wednesday,Tottenham Hotspur,1-1,1,1,1,1,2,0,D
1910-03-16,1909,Sunderland,Sheffield United,1-0,1,0,1,1,1,1,H
1910-03-19,1909,Bradford City,Arsenal,0-1,0,1,1,1,1,-1,A
1910-03-19,1909,Bristol City,Aston Villa,0-0,0,0,1,1,0,0,D
1910-03-19,1909,Bury,Liverpool,1-2,1,2,1,1,3,-1,A
1910-03-19,1909,Everton,Chelsea,2-2,2,2,1,1,4,0,D
1910-03-19,1909,Manchester United,Bolton Wanderers,5-0,5,0,1,1,5,5,H
1910-03-19,1909,Nottingham Forest,Middlesbrough,0-1,0,1,1,1,1,-1,A
1910-03-19,1909,Preston North End,Notts County,4-0,4,0,1,1,4,4,H
1910-03-19,1909,Sheffield Wednesday,Sheffield United,1-3,1,3,1,1,4,-2,A
1910-03-19,1909,Sunderland,Blackburn Rovers,0-0,0,0,1,1,0,0,D
1910-03-19,1909,Tottenham Hotspur,Newcastle United,0-4,0,4,1,1,4,-4,A
1910-03-25,1909,Aston Villa,Middlesbrough,4-2,4,2,1,1,6,2,H
1910-03-25,1909,Blackburn Rovers,Notts County,2-0,2,0,1,1,2,2,H
1910-03-25,1909,Bradford City,Sheffield Wednesday,2-0,2,0,1,1,2,2,H
1910-03-25,1909,Liverpool,Sheffield United,0-0,0,0,1,1,0,0,D
1910-03-25,1909,Manchester United,Bristol City,2-1,2,1,1,1,3,1,H
1910-03-25,1909,Newcastle United,Arsenal,1-1,1,1,1,1,2,0,D
1910-03-25,1909,Nottingham Forest,Preston North End,0-0,0,0,1,1,0,0,D
1910-03-25,1909,Tottenham Hotspur,Sunderland,5-1,5,1,1,1,6,4,H
1910-03-26,1909,Arsenal,Sheffield Wednesday,0-1,0,1,1,1,1,-1,A
1910-03-26,1909,Aston Villa,Bury,4-1,4,1,1,1,5,3,H
1910-03-26,1909,Blackburn Rovers,Bolton Wanderers,4-2,4,2,1,1,6,2,H
1910-03-26,1909,Chelsea,Manchester United,1-1,1,1,1,1,2,0,D
1910-03-26,1909,Liverpool,Tottenham Hotspur,2-0,2,0,1,1,2,2,H
1910-03-26,1909,Middlesbrough,Notts County,2-0,2,0,1,1,2,2,H
1910-03-26,1909,Nottingham Forest,Sunderland,1-3,1,3,1,1,4,-2,A
1910-03-26,1909,Sheffield United,Bristol City,4-0,4,0,1,1,4,4,H
1910-03-28,1909,Bristol City,Manchester United,2-1,2,1,1,1,3,1,H
1910-03-28,1909,Chelsea,Arsenal,0-1,0,1,1,1,1,-1,A
1910-03-28,1909,Everton,Bury,3-0,3,0,1,1,3,3,H
1910-03-28,1909,Middlesbrough,Aston Villa,3-2,3,2,1,1,5,1,H
1910-03-28,1909,Notts County,Bolton Wanderers,0-0,0,0,1,1,0,0,D
1910-03-28,1909,Sheffield Wednesday,Bradford City,2-1,2,1,1,1,3,1,H
1910-03-28,1909,Sunderland,Liverpool,2-1,2,1,1,1,3,1,H
1910-03-29,1909,Bradford City,Preston North End,2-0,2,0,1,1,2,2,H
1910-03-29,1909,Tottenham Hotspur,Blackburn Rovers,4-0,4,0,1,1,4,4,H
1910-04-02,1909,Bradford City,Chelsea,4-1,4,1,1,1,5,3,H
1910-04-02,1909,Bristol City,Arsenal,0-1,0,1,1,1,1,-1,A
1910-04-02,1909,Bury,Sheffield United,2-0,2,0,1,1,2,2,H
1910-04-02,1909,Everton,Nottingham Forest,0-4,0,4,1,1,4,-4,A
1910-04-02,1909,Manchester United,Blackburn Rovers,2-0,2,0,1,1,2,2,H
1910-04-02,1909,Notts County,Newcastle United,2-2,2,2,1,1,4,0,D
1910-04-02,1909,Preston North End,Liverpool,2-0,2,0,1,1,2,2,H
1910-04-02,1909,Sheffield Wednesday,Bolton Wanderers,0-0,0,0,1,1,0,0,D
1910-04-02,1909,Sunderland,Middlesbrough,2-2,2,2,1,1,4,0,D
1910-04-02,1909,Tottenham Hotspur,Aston Villa,1-1,1,1,1,1,2,0,D
1910-04-06,1909,Manchester United,Everton,3-2,3,2,1,1,5,1,H
1910-04-09,1909,Arsenal,Bury,0-0,0,0,1,1,0,0,D
1910-04-09,1909,Aston Villa,Preston North End,3-0,3,0,1,1,3,3,H
1910-04-09,1909,Blackburn Rovers,Bradford City,2-0,2,0,1,1,2,2,H
1910-04-09,1909,Bolton Wanderers,Bristol City,4-2,4,2,1,1,6,2,H
1910-04-09,1909,Chelsea,Sheffield Wednesday,4-1,4,1,1,1,5,3,H
1910-04-09,1909,Liverpool,Notts County,2-1,2,1,1,1,3,1,H
1910-04-09,1909,Middlesbrough,Newcastle United,1-1,1,1,1,1,2,0,D
1910-04-09,1909,Nottingham Forest,Manchester United,2-0,2,0,1,1,2,2,H
1910-04-09,1909,Sheffield United,Tottenham Hotspur,1-1,1,1,1,1,2,0,D
1910-04-09,1909,Sunderland,Everton,0-1,0,1,1,1,1,-1,A
1910-04-11,1909,Arsenal,Aston Villa,1-0,1,0,1,1,1,1,H
1910-04-11,1909,Blackburn Rovers,Everton,2-1,2,1,1,1,3,1,H
1910-04-13,1909,Newcastle United,Sunderland,1-0,1,0,1,1,1,1,H
1910-04-13,1909,Notts County,Everton,2-3,2,3,1,1,5,-1,A
1910-04-16,1909,Bradford City,Nottingham Forest,1-1,1,1,1,1,2,0,D
1910-04-16,1909,Bristol City,Chelsea,1-0,1,0,1,1,1,1,H
1910-04-16,1909,Bury,Bolton Wanderers,1-2,1,2,1,1,3,-1,A
1910-04-16,1909,Everton,Middlesbrough,1-1,1,1,1,1,2,0,D
1910-04-16,1909,Manchester United,Sunderland,2-0,2,0,1,1,2,2,H
1910-04-16,1909,Newcastle United,Liverpool,1-3,1,3,1,1,4,-2,A
1910-04-16,1909,Notts County,Aston Villa,2-3,2,3,1,1,5,-1,A
1910-04-16,1909,Preston North End,Sheffield United,1-1,1,1,1,1,2,0,D
1910-04-16,1909,Sheffield Wednesday,Blackburn Rovers,2-1,2,1,1,1,3,1,H
1910-04-16,1909,Tottenham Hotspur,Arsenal,1-1,1,1,1,1,2,0,D
1910-04-20,1909,Bury,Tottenham Hotspur,3-1,3,1,1,1,4,2,H
1910-04-20,1909,Liverpool,Nottingham Forest,7-3,7,3,1,1,10,4,H
1910-04-20,1909,Middlesbrough,Bristol City,0-0,0,0,1,1,0,0,D
1910-04-23,1909,Arsenal,Preston North End,1-3,1,3,1,1,4,-2,A
1910-04-23,1909,Blackburn Rovers,Sheffield United,3-1,3,1,1,1,4,2,H
1910-04-23,1909,Bolton Wanderers,Tottenham Hotspur,0-2,0,2,1,1,2,-2,A
1910-04-23,1909,Chelsea,Bury,2-0,2,0,1,1,2,2,H
1910-04-23,1909,Everton,Manchester United,3-3,3,3,1,1,6,0,D
1910-04-23,1909,Middlesbrough,Liverpool,2-2,2,2,1,1,4,0,D
1910-04-23,1909,Nottingham Forest,Sheffield Wednesday,0-6,0,6,1,1,6,-6,A
1910-04-23,1909,Sunderland,Bradford City,3-0,3,0,1,1,3,3,H
1910-04-25,1909,Bristol City,Newcastle United,0-3,0,3,1,1,3,-3,A
1910-04-27,1909,Aston Villa,Newcastle United,4-0,4,0,1,1,4,4,H
1910-04-30,1909,Bradford City,Everton,2-0,2,0,1,1,2,2,H
1910-04-30,1909,Bristol City,Nottingham Forest,4-0,4,0,1,1,4,4,H
1910-04-30,1909,Bury,Blackburn Rovers,2-1,2,1,1,1,3,1,H
1910-04-30,1909,Liverpool,Aston Villa,2-0,2,0,1,1,2,2,H
1910-04-30,1909,Manchester United,Middlesbrough,4-1,4,1,1,1,5,3,H
1910-04-30,1909,Newcastle United,Sheffield United,0-0,0,0,1,1,0,0,D
1910-04-30,1909,Preston North End,Bolton Wanderers,1-0,1,0,1,1,1,1,H
1910-04-30,1909,Sheffield Wednesday,Sunderland,1-0,1,0,1,1,1,1,H
1910-04-30,1909,Tottenham Hotspur,Chelsea,2-1,2,1,1,1,3,1,H
1910-09-01,1910,Arsenal,Manchester United,1-2,1,2,1,1,3,-1,A
1910-09-01,1910,Blackburn Rovers,Notts County,1-1,1,1,1,1,2,0,D
1910-09-01,1910,Everton,Tottenham Hotspur,2-0,2,0,1,1,2,2,H
1910-09-01,1910,Manchester City,Bury,5-1,5,1,1,1,6,4,H
1910-09-01,1910,Preston North End,Nottingham Forest,0-2,0,2,1,1,2,-2,A
1910-09-01,1910,Sunderland,Newcastle United,2-1,2,1,1,1,3,1,H
1910-09-03,1910,Aston Villa,Oldham Athletic,1-1,1,1,1,1,2,0,D
1910-09-03,1910,Bury,Arsenal,1-1,1,1,1,1,2,0,D
1910-09-03,1910,Liverpool,Bradford City,1-2,1,2,1,1,3,-1,A
1910-09-03,1910,Manchester United,Blackburn Rovers,3-2,3,2,1,1,5,1,H
1910-09-03,1910,Middlesbrough,Everton,1-0,1,0,1,1,1,1,H
1910-09-03,1910,Newcastle United,Bristol City,0-1,0,1,1,1,1,-1,A
1910-09-03,1910,Notts County,Nottingham Forest,1-1,1,1,1,1,2,0,D
1910-09-03,1910,Preston North End,Manchester City,1-1,1,1,1,1,2,0,D
1910-09-03,1910,Sheffield United,Sunderland,1-2,1,2,1,1,3,-1,A
1910-09-03,1910,Tottenham Hotspur,Sheffield Wednesday,3-1,3,1,1,1,4,2,H
1910-09-10,1910,Arsenal,Sheffield United,0-0,0,0,1,1,0,0,D
1910-09-10,1910,Blackburn Rovers,Liverpool,1-2,1,2,1,1,3,-1,A
1910-09-10,1910,Bradford City,Bury,2-2,2,2,1,1,4,0,D
1910-09-10,1910,Bristol City,Tottenham Hotspur,0-2,0,2,1,1,2,-2,A
1910-09-10,1910,Everton,Preston North End,2-0,2,0,1,1,2,2,H
1910-09-10,1910,Manchester City,Notts County,0-1,0,1,1,1,1,-1,A
1910-09-10,1910,Nottingham Forest,Manchester United,2-1,2,1,1,1,3,1,H
1910-09-10,1910,Oldham Athletic,Newcastle United,0-2,0,2,1,1,2,-2,A
1910-09-10,1910,Sheffield Wednesday,Middlesbrough,1-1,1,1,1,1,2,0,D
1910-09-10,1910,Sunderland,Aston Villa,3-2,3,2,1,1,5,1,H
1910-09-17,1910,Aston Villa,Arsenal,3-0,3,0,1,1,3,3,H
1910-09-17,1910,Bury,Blackburn Rovers,2-2,2,2,1,1,4,0,D
1910-09-17,1910,Liverpool,Nottingham Forest,2-3,2,3,1,1,5,-1,A
1910-09-17,1910,Manchester United,Manchester City,2-1,2,1,1,1,3,1,H
1910-09-17,1910,Middlesbrough,Bristol City,3-0,3,0,1,1,3,3,H
1910-09-17,1910,Notts County,Everton,0-0,0,0,1,1,0,0,D
1910-09-17,1910,Preston North End,Sheffield Wednesday,1-3,1,3,1,1,4,-2,A
1910-09-17,1910,Sheffield United,Bradford City,0-1,0,1,1,1,1,-1,A
1910-09-17,1910,Sunderland,Oldham Athletic,2-1,2,1,1,1,3,1,H
1910-09-17,1910,Tottenham Hotspur,Newcastle United,1-2,1,2,1,1,3,-1,A
1910-09-19,1910,Sheffield United,Liverpool,2-0,2,0,1,1,2,2,H
1910-09-24,1910,Arsenal,Sunderland,0-0,0,0,1,1,0,0,D
1910-09-24,1910,Blackburn Rovers,Sheffield United,1-2,1,2,1,1,3,-1,A
1910-09-24,1910,Bradford City,Aston Villa,1-2,1,2,1,1,3,-1,A
1910-09-24,1910,Bristol City,Preston North End,0-0,0,0,1,1,0,0,D
1910-09-24,1910,Everton,Manchester United,0-1,0,1,1,1,1,-1,A
1910-09-24,1910,Manchester City,Liverpool,1-2,1,2,1,1,3,-1,A
1910-09-24,1910,Newcastle United,Middlesbrough,0-0,0,0,1,1,0,0,D
1910-09-24,1910,Nottingham Forest,Bury,1-2,1,2,1,1,3,-1,A
1910-09-24,1910,Oldham Athletic,Tottenham Hotspur,2-0,2,0,1,1,2,2,H
1910-09-24,1910,Sheffield Wednesday,Notts County,1-3,1,3,1,1,4,-2,A
1910-10-01,1910,Arsenal,Oldham Athletic,0-0,0,0,1,1,0,0,D
1910-10-01,1910,Aston Villa,Blackburn Rovers,2-2,2,2,1,1,4,0,D
1910-10-01,1910,Bury,Manchester City,5-2,5,2,1,1,7,3,H
1910-10-01,1910,Liverpool,Everton,0-2,0,2,1,1,2,-2,A
1910-10-01,1910,Manchester United,Sheffield Wednesday,3-2,3,2,1,1,5,1,H
1910-10-01,1910,Middlesbrough,Tottenham Hotspur,2-0,2,0,1,1,2,2,H
1910-10-01,1910,Notts County,Bristol City,2-0,2,0,1,1,2,2,H
1910-10-01,1910,Preston North End,Newcastle United,2-1,2,1,1,1,3,1,H
1910-10-01,1910,Sheffield United,Nottingham Forest,0-1,0,1,1,1,1,-1,A
1910-10-01,1910,Sunderland,Bradford City,1-1,1,1,1,1,2,0,D
1910-10-06,1910,Nottingham Forest,Preston North End,1-3,1,3,1,1,4,-2,A
1910-10-08,1910,Blackburn Rovers,Sunderland,0-1,0,1,1,1,1,-1,A
1910-10-08,1910,Bradford City,Arsenal,3-0,3,0,1,1,3,3,H
1910-10-08,1910,Bristol City,Manchester United,0-1,0,1,1,1,1,-1,A
1910-10-08,1910,Everton,Bury,2-1,2,1,1,1,3,1,H
1910-10-08,1910,Manchester City,Sheffield United,0-4,0,4,1,1,4,-4,A
1910-10-08,1910,Newcastle United,Notts County,2-0,2,0,1,1,2,2,H
1910-10-08,1910,Nottingham Forest,Aston Villa,3-1,3,1,1,1,4,2,H
1910-10-08,1910,Oldham Athletic,Middlesbrough,1-1,1,1,1,1,2,0,D
1910-10-08,1910,Sheffield Wednesday,Liverpool,1-0,1,0,1,1,1,1,H
1910-10-08,1910,Tottenham Hotspur,Preston North End,1-1,1,1,1,1,2,0,D
1910-10-15,1910,Arsenal,Blackburn Rovers,4-1,4,1,1,1,5,3,H
1910-10-15,1910,Aston Villa,Manchester City,2-1,2,1,1,1,3,1,H
1910-10-15,1910,Bradford City,Oldham Athletic,1-2,1,2,1,1,3,-1,A
1910-10-15,1910,Bury,Sheffield Wednesday,1-1,1,1,1,1,2,0,D
1910-10-15,1910,Liverpool,Bristol City,4-0,4,0,1,1,4,4,H
1910-10-15,1910,Manchester United,Newcastle United,2-0,2,0,1,1,2,2,H
1910-10-15,1910,Notts County,Tottenham Hotspur,1-0,1,0,1,1,1,1,H
1910-10-15,1910,Preston North End,Middlesbrough,1-1,1,1,1,1,2,0,D
1910-10-15,1910,Sheffield United,Everton,0-1,0,1,1,1,1,-1,A
1910-10-15,1910,Sunderland,Nottingham Forest,2-2,2,2,1,1,4,0,D
1910-10-22,1910,Blackburn Rovers,Bradford City,3-0,3,0,1,1,3,3,H
1910-10-22,1910,Bristol City,Bury,2-0,2,0,1,1,2,2,H
1910-10-22,1910,Everton,Aston Villa,0-1,0,1,1,1,1,-1,A
1910-10-22,1910,Manchester City,Sunderland,3-3,3,3,1,1,6,0,D
1910-10-22,1910,Middlesbrough,Notts County,4-1,4,1,1,1,5,3,H
1910-10-22,1910,Newcastle United,Liverpool,6-1,6,1,1,1,7,5,H
1910-10-22,1910,Nottingham Forest,Arsenal,2-3,2,3,1,1,5,-1,A
1910-10-22,1910,Oldham Athletic,Preston North End,2-1,2,1,1,1,3,1,H
1910-10-22,1910,Sheffield Wednesday,Sheffield United,2-0,2,0,1,1,2,2,H
1910-10-22,1910,Tottenham Hotspur,Manchester United,2-2,2,2,1,1,4,0,D
1910-10-29,1910,Arsenal,Manchester City,0-1,0,1,1,1,1,-1,A
1910-10-29,1910,Aston Villa,Sheffield Wednesday,2-1,2,1,1,1,3,1,H
1910-10-29,1910,Blackburn Rovers,Oldham Athletic,1-0,1,0,1,1,1,1,H
1910-10-29,1910,Bradford City,Nottingham Forest,2-1,2,1,1,1,3,1,H
1910-10-29,1910,Bury,Newcastle United,1-1,1,1,1,1,2,0,D
1910-10-29,1910,Liverpool,Tottenham Hotspur,1-2,1,2,1,1,3,-1,A
1910-10-29,1910,Manchester United,Middlesbrough,1-2,1,2,1,1,3,-1,A
1910-10-29,1910,Notts County,Preston North End,3-3,3,3,1,1,6,0,D
1910-10-29,1910,Sheffield United,Bristol City,0-4,0,4,1,1,4,-4,A
1910-10-29,1910,Sunderland,Everton,4-0,4,0,1,1,4,4,H
1910-11-05,1910,Bristol City,Aston Villa,1-2,1,2,1,1,3,-1,A
1910-11-05,1910,Everton,Arsenal,2-0,2,0,1,1,2,2,H
1910-11-05,1910,Manchester City,Bradford City,1-3,1,3,1,1,4,-2,A
1910-11-05,1910,Middlesbrough,Liverpool,2-2,2,2,1,1,4,0,D
1910-11-05,1910,Newcastle United,Sheffield United,1-1,1,1,1,1,2,0,D
1910-11-05,1910,Nottingham Forest,Blackburn Rovers,5-2,5,2,1,1,7,3,H
1910-11-05,1910,Oldham Athletic,Notts County,2-1,2,1,1,1,3,1,H
1910-11-05,1910,Preston North End,Manchester United,0-2,0,2,1,1,2,-2,A
1910-11-05,1910,Sheffield Wednesday,Sunderland,1-1,1,1,1,1,2,0,D
1910-11-05,1910,Tottenham Hotspur,Bury,5-0,5,0,1,1,5,5,H
1910-11-12,1910,Arsenal,Sheffield Wednesday,1-0,1,0,1,1,1,1,H
1910-11-12,1910,Aston Villa,Newcastle United,3-2,3,2,1,1,5,1,H
1910-11-12,1910,Blackburn Rovers,Manchester City,2-0,2,0,1,1,2,2,H
1910-11-12,1910,Bradford City,Everton,3-1,3,1,1,1,4,2,H
1910-11-12,1910,Bury,Middlesbrough,4-2,4,2,1,1,6,2,H
1910-11-12,1910,Liverpool,Preston North End,3-0,3,0,1,1,3,3,H
1910-11-12,1910,Manchester United,Notts County,0-0,0,0,1,1,0,0,D
1910-11-12,1910,Nottingham Forest,Oldham Athletic,4-1,4,1,1,1,5,3,H
1910-11-12,1910,Sheffield United,Tottenham Hotspur,3-0,3,0,1,1,3,3,H
1910-11-12,1910,Sunderland,Bristol City,3-1,3,1,1,1,4,2,H
1910-11-19,1910,Bristol City,Arsenal,0-1,0,1,1,1,1,-1,A
1910-11-19,1910,Everton,Blackburn Rovers,6-1,6,1,1,1,7,5,H
1910-11-19,1910,Manchester City,Nottingham Forest,1-0,1,0,1,1,1,1,H
1910-11-19,1910,Middlesbrough,Sheffield United,3-1,3,1,1,1,4,2,H
1910-11-19,1910,Newcastle United,Sunderland,1-1,1,1,1,1,2,0,D
1910-11-19,1910,Notts County,Liverpool,1-0,1,0,1,1,1,1,H
1910-11-19,1910,Oldham Athletic,Manchester United,1-3,1,3,1,1,4,-2,A
1910-11-19,1910,Preston North End,Bury,2-0,2,0,1,1,2,2,H
1910-11-19,1910,Sheffield Wednesday,Bradford City,0-1,0,1,1,1,1,-1,A
1910-11-19,1910,Tottenham Hotspur,Aston Villa,1-2,1,2,1,1,3,-1,A
1910-11-26,1910,Arsenal,Newcastle United,1-2,1,2,1,1,3,-1,A
1910-11-26,1910,Aston Villa,Middlesbrough,5-0,5,0,1,1,5,5,H
1910-11-26,1910,Blackburn Rovers,Sheffield Wednesday,6-1,6,1,1,1,7,5,H
1910-11-26,1910,Bradford City,Bristol City,3-1,3,1,1,1,4,2,H
1910-11-26,1910,Bury,Notts County,0-0,0,0,1,1,0,0,D
1910-11-26,1910,Liverpool,Manchester United,3-2,3,2,1,1,5,1,H
1910-11-26,1910,Manchester City,Oldham Athletic,2-0,2,0,1,1,2,2,H
1910-11-26,1910,Nottingham Forest,Everton,1-1,1,1,1,1,2,0,D
1910-11-26,1910,Sheffield United,Preston North End,5-0,5,0,1,1,5,5,H
1910-11-26,1910,Sunderland,Tottenham Hotspur,4-0,4,0,1,1,4,4,H
1910-12-03,1910,Bristol City,Blackburn Rovers,1-0,1,0,1,1,1,1,H
1910-12-03,1910,Everton,Manchester City,1-0,1,0,1,1,1,1,H
1910-12-03,1910,Manchester United,Bury,3-2,3,2,1,1,5,1,H
1910-12-03,1910,Middlesbrough,Sunderland,1-0,1,0,1,1,1,1,H
1910-12-03,1910,Newcastle United,Bradford City,6-1,6,1,1,1,7,5,H
1910-12-03,1910,Notts County,Sheffield United,0-3,0,3,1,1,3,-3,A
1910-12-03,1910,Oldham Athletic,Liverpool,3-1,3,1,1,1,4,2,H
1910-12-03,1910,Preston North End,Aston Villa,0-1,0,1,1,1,1,-1,A
1910-12-03,1910,Sheffield Wednesday,Nottingham Forest,5-2,5,2,1,1,7,3,H
1910-12-03,1910,Tottenham Hotspur,Arsenal,3-1,3,1,1,1,4,2,H
1910-12-10,1910,Arsenal,Middlesbrough,0-2,0,2,1,1,2,-2,A
1910-12-10,1910,Aston Villa,Notts County,3-1,3,1,1,1,4,2,H
1910-12-10,1910,Blackburn Rovers,Newcastle United,3-1,3,1,1,1,4,2,H
1910-12-10,1910,Bradford City,Tottenham Hotspur,3-0,3,0,1,1,3,3,H
1910-12-10,1910,Bury,Liverpool,3-0,3,0,1,1,3,3,H
1910-12-10,1910,Everton,Oldham Athletic,1-0,1,0,1,1,1,1,H
1910-12-10,1910,Manchester City,Sheffield Wednesday,1-2,1,2,1,1,3,-1,A
1910-12-10,1910,Nottingham Forest,Bristol City,3-3,3,3,1,1,6,0,D
1910-12-10,1910,Sheffield United,Manchester United,2-0,2,0,1,1,2,2,H
1910-12-10,1910,Sunderland,Preston North End,1-1,1,1,1,1,2,0,D
1910-12-17,1910,Bristol City,Manchester City,2-1,2,1,1,1,3,1,H
1910-12-17,1910,Bury,Oldham Athletic,2-2,2,2,1,1,4,0,D
1910-12-17,1910,Liverpool,Sheffield United,2-0,2,0,1,1,2,2,H
1910-12-17,1910,Manchester United,Aston Villa,2-0,2,0,1,1,2,2,H
1910-12-17,1910,Middlesbrough,Bradford City,3-2,3,2,1,1,5,1,H
1910-12-17,1910,Newcastle United,Nottingham Forest,4-1,4,1,1,1,5,3,H
1910-12-17,1910,Notts County,Sunderland,1-1,1,1,1,1,2,0,D
1910-12-17,1910,Preston North End,Arsenal,4-1,4,1,1,1,5,3,H
1910-12-17,1910,Sheffield Wednesday,Everton,0-2,0,2,1,1,2,-2,A
1910-12-17,1910,Tottenham Hotspur,Blackburn Rovers,2-2,2,2,1,1,4,0,D
1910-12-24,1910,Arsenal,Notts County,2-1,2,1,1,1,3,1,H
1910-12-24,1910,Aston Villa,Liverpool,1-1,1,1,1,1,2,0,D
1910-12-24,1910,Blackburn Rovers,Middlesbrough,5-1,5,1,1,1,6,4,H
1910-12-24,1910,Bradford City,Preston North End,1-0,1,0,1,1,1,1,H
1910-12-24,1910,Everton,Bristol City,4-3,4,3,1,1,7,1,H
1910-12-24,1910,Manchester City,Newcastle United,2-0,2,0,1,1,2,2,H
1910-12-24,1910,Nottingham Forest,Tottenham Hotspur,1-2,1,2,1,1,3,-1,A
1910-12-24,1910,Oldham Athletic,Sheffield Wednesday,1-0,1,0,1,1,1,1,H
1910-12-24,1910,Sheffield United,Bury,3-0,3,0,1,1,3,3,H
1910-12-24,1910,Sunderland,Manchester United,1-2,1,2,1,1,3,-1,A
1910-12-26,1910,Aston Villa,Bury,4-1,4,1,1,1,5,3,H
1910-12-26,1910,Bristol City,Sheffield Wednesday,2-2,2,2,1,1,4,0,D
1910-12-26,1910,Liverpool,Sunderland,1-2,1,2,1,1,3,-1,A
1910-12-26,1910,Manchester United,Arsenal,5-0,5,0,1,1,5,5,H
1910-12-26,1910,Middlesbrough,Manchester City,0-0,0,0,1,1,0,0,D
1910-12-26,1910,Newcastle United,Everton,1-0,1,0,1,1,1,1,H
1910-12-26,1910,Notts County,Bradford City,1-1,1,1,1,1,2,0,D
1910-12-26,1910,Preston North End,Blackburn Rovers,0-0,0,0,1,1,0,0,D
1910-12-26,1910,Sheffield United,Oldham Athletic,1-2,1,2,1,1,3,-1,A
1910-12-26,1910,Tottenham Hotspur,Nottingham Forest,1-4,1,4,1,1,5,-3,A
1910-12-27,1910,Bradford City,Manchester United,1-0,1,0,1,1,1,1,H
1910-12-27,1910,Bristol City,Oldham Athletic,3-2,3,2,1,1,5,1,H
1910-12-27,1910,Everton,Liverpool,0-1,0,1,1,1,1,-1,A
1910-12-27,1910,Nottingham Forest,Middlesbrough,1-1,1,1,1,1,2,0,D
1910-12-27,1910,Sheffield Wednesday,Newcastle United,0-2,0,2,1,1,2,-2,A
1910-12-27,1910,Tottenham Hotspur,Manchester City,1-1,1,1,1,1,2,0,D
1910-12-28,1910,Sheffield United,Aston Villa,2-1,2,1,1,1,3,1,H
1910-12-31,1910,Arsenal,Bury,3-2,3,2,1,1,5,1,H
1910-12-31,1910,Blackburn Rovers,Manchester United,1-0,1,0,1,1,1,1,H
1910-12-31,1910,Bradford City,Liverpool,1-3,1,3,1,1,4,-2,A
1910-12-31,1910,Bristol City,Newcastle United,1-0,1,0,1,1,1,1,H
1910-12-31,1910,Everton,Middlesbrough,2-0,2,0,1,1,2,2,H
1910-12-31,1910,Manchester City,Preston North End,0-2,0,2,1,1,2,-2,A
1910-12-31,1910,Nottingham Forest,Notts County,0-2,0,2,1,1,2,-2,A
1910-12-31,1910,Oldham Athletic,Aston Villa,1-1,1,1,1,1,2,0,D
1910-12-31,1910,Sheffield Wednesday,Tottenham Hotspur,2-1,2,1,1,1,3,1,H
1910-12-31,1910,Sunderland,Sheffield United,0-2,0,2,1,1,2,-2,A
1911-01-02,1910,Blackburn Rovers,Preston North End,0-1,0,1,1,1,1,-1,A
1911-01-02,1910,Bury,Aston Villa,1-0,1,0,1,1,1,1,H
1911-01-02,1910,Everton,Newcastle United,1-5,1,5,1,1,6,-4,A
1911-01-02,1910,Manchester United,Bradford City,1-0,1,0,1,1,1,1,H
1911-01-02,1910,Middlesbrough,Nottingham Forest,2-2,2,2,1,1,4,0,D
1911-01-02,1910,Sheffield Wednesday,Bristol City,2-1,2,1,1,1,3,1,H
1911-01-02,1910,Sunderland,Liverpool,4-0,4,0,1,1,4,4,H
1911-01-03,1910,Manchester City,Tottenham Hotspur,2-1,2,1,1,1,3,1,H
1911-01-03,1910,Newcastle United,Preston North End,1-1,1,1,1,1,2,0,D
1911-01-07,1910,Aston Villa,Sunderland,2-1,2,1,1,1,3,1,H
1911-01-07,1910,Bury,Bradford City,0-1,0,1,1,1,1,-1,A
1911-01-07,1910,Liverpool,Blackburn Rovers,2-2,2,2,1,1,4,0,D
1911-01-07,1910,Manchester United,Nottingham Forest,4-2,4,2,1,1,6,2,H
1911-01-07,1910,Middlesbrough,Sheffield Wednesday,0-1,0,1,1,1,1,-1,A
1911-01-07,1910,Newcastle United,Oldham Athletic,3-0,3,0,1,1,3,3,H
1911-01-07,1910,Notts County,Manchester City,0-1,0,1,1,1,1,-1,A
1911-01-07,1910,Preston North End,Everton,0-2,0,2,1,1,2,-2,A
1911-01-07,1910,Sheffield United,Arsenal,3-2,3,2,1,1,5,1,H
1911-01-07,1910,Tottenham Hotspur,Bristol City,3-2,3,2,1,1,5,1,H
1911-01-21,1910,Blackburn Rovers,Bury,6-2,6,2,1,1,8,4,H
1911-01-21,1910,Bradford City,Sheffield United,0-1,0,1,1,1,1,-1,A
1911-01-21,1910,Bristol City,Middlesbrough,3-2,3,2,1,1,5,1,H
1911-01-21,1910,Everton,Notts County,5-0,5,0,1,1,5,5,H
1911-01-21,1910,Manchester City,Manchester United,1-1,1,1,1,1,2,0,D
1911-01-21,1910,Newcastle United,Tottenham Hotspur,1-1,1,1,1,1,2,0,D
1911-01-21,1910,Nottingham Forest,Liverpool,2-0,2,0,1,1,2,2,H
1911-01-21,1910,Oldham Athletic,Sunderland,2-1,2,1,1,1,3,1,H
1911-01-21,1910,Sheffield Wednesday,Preston North End,0-0,0,0,1,1,0,0,D
1911-01-28,1910,Aston Villa,Bradford City,4-1,4,1,1,1,5,3,H
1911-01-28,1910,Bury,Nottingham Forest,1-0,1,0,1,1,1,1,H
1911-01-28,1910,Liverpool,Manchester City,1-1,1,1,1,1,2,0,D
1911-01-28,1910,Manchester United,Everton,2-2,2,2,1,1,4,0,D
1911-01-28,1910,Middlesbrough,Newcastle United,0-2,0,2,1,1,2,-2,A
1911-01-28,1910,Notts County,Sheffield Wednesday,2-0,2,0,1,1,2,2,H
1911-01-28,1910,Preston North End,Bristol City,4-0,4,0,1,1,4,4,H
1911-01-28,1910,Sheffield United,Blackburn Rovers,1-1,1,1,1,1,2,0,D
1911-01-28,1910,Sunderland,Arsenal,2-2,2,2,1,1,4,0,D
1911-02-04,1910,Bristol City,Notts County,1-0,1,0,1,1,1,1,H
1911-02-04,1910,Nottingham Forest,Sheffield United,1-2,1,2,1,1,3,-1,A
1911-02-04,1910,Sunderland,Bury,4-1,4,1,1,1,5,3,H
1911-02-11,1910,Arsenal,Bradford City,0-0,0,0,1,1,0,0,D
1911-02-11,1910,Aston Villa,Nottingham Forest,3-1,3,1,1,1,4,2,H
1911-02-11,1910,Bury,Everton,0-0,0,0,1,1,0,0,D
1911-02-11,1910,Liverpool,Sheffield Wednesday,3-0,3,0,1,1,3,3,H
1911-02-11,1910,Manchester United,Bristol City,3-1,3,1,1,1,4,2,H
1911-02-11,1910,Middlesbrough,Oldham Athletic,1-2,1,2,1,1,3,-1,A
1911-02-11,1910,Notts County,Newcastle United,2-2,2,2,1,1,4,0,D
1911-02-11,1910,Preston North End,Tottenham Hotspur,2-0,2,0,1,1,2,2,H
1911-02-11,1910,Sheffield United,Manchester City,2-2,2,2,1,1,4,0,D
1911-02-11,1910,Sunderland,Blackburn Rovers,2-2,2,2,1,1,4,0,D
1911-02-13,1910,Tottenham Hotspur,Middlesbrough,6-2,6,2,1,1,8,4,H
1911-02-18,1910,Blackburn Rovers,Arsenal,1-0,1,0,1,1,1,1,H
1911-02-18,1910,Bristol City,Liverpool,1-1,1,1,1,1,2,0,D
1911-02-18,1910,Everton,Sheffield United,1-0,1,0,1,1,1,1,H
1911-02-18,1910,Manchester City,Aston Villa,1-1,1,1,1,1,2,0,D
1911-02-18,1910,Middlesbrough,Preston North End,2-0,2,0,1,1,2,2,H
1911-02-18,1910,Newcastle United,Manchester United,0-1,0,1,1,1,1,-1,A
1911-02-18,1910,Nottingham Forest,Sunderland,1-3,1,3,1,1,4,-2,A
1911-02-18,1910,Oldham Athletic,Bradford City,1-0,1,0,1,1,1,1,H
1911-02-18,1910,Sheffield Wednesday,Bury,1-0,1,0,1,1,1,1,H
1911-02-18,1910,Tottenham Hotspur,Notts County,3-0,3,0,1,1,3,3,H
1911-02-25,1910,Arsenal,Nottingham Forest,3-2,3,2,1,1,5,1,H
1911-02-25,1910,Aston Villa,Tottenham Hotspur,4-0,4,0,1,1,4,4,H
1911-02-25,1910,Bury,Bristol City,2-1,2,1,1,1,3,1,H
1911-02-25,1910,Preston North End,Oldham Athletic,1-1,1,1,1,1,2,0,D
1911-02-25,1910,Sheffield United,Sheffield Wednesday,0-1,0,1,1,1,1,-1,A
1911-02-25,1910,Sunderland,Manchester City,4-0,4,0,1,1,4,4,H
1911-02-27,1910,Liverpool,Newcastle United,3-0,3,0,1,1,3,3,H
1911-02-28,1910,Bradford City,Blackburn Rovers,1-0,1,0,1,1,1,1,H
1911-03-04,1910,Bristol City,Sheffield United,0-2,0,2,1,1,2,-2,A
1911-03-04,1910,Everton,Sunderland,2-2,2,2,1,1,4,0,D
1911-03-04,1910,Manchester City,Arsenal,1-1,1,1,1,1,2,0,D
1911-03-04,1910,Middlesbrough,Manchester United,2-2,2,2,1,1,4,0,D
1911-03-04,1910,Newcastle United,Bury,5-1,5,1,1,1,6,4,H
1911-03-04,1910,Nottingham Forest,Bradford City,0-2,0,2,1,1,2,-2,A
1911-03-04,1910,Oldham Athletic,Blackburn Rovers,2-0,2,0,1,1,2,2,H
1911-03-04,1910,Preston North End,Notts County,2-0,2,0,1,1,2,2,H
1911-03-04,1910,Sheffield Wednesday,Aston Villa,1-0,1,0,1,1,1,1,H
1911-03-04,1910,Tottenham Hotspur,Liverpool,1-0,1,0,1,1,1,1,H
1911-03-06,1910,Oldham Athletic,Arsenal,3-0,3,0,1,1,3,3,H
1911-03-11,1910,Arsenal,Everton,1-0,1,0,1,1,1,1,H
1911-03-11,1910,Aston Villa,Bristol City,2-0,2,0,1,1,2,2,H
1911-03-11,1910,Bury,Tottenham Hotspur,2-1,2,1,1,1,3,1,H
1911-03-11,1910,Liverpool,Middlesbrough,3-0,3,0,1,1,3,3,H
1911-03-11,1910,Manchester United,Preston North End,5-0,5,0,1,1,5,5,H
1911-03-11,1910,Notts County,Oldham Athletic,1-0,1,0,1,1,1,1,H
1911-03-11,1910,Sunderland,Sheffield Wednesday,1-2,1,2,1,1,3,-1,A
1911-03-14,1910,Bradford City,Manchester City,1-0,1,0,1,1,1,1,H
1911-03-15,1910,Arsenal,Aston Villa,1-1,1,1,1,1,2,0,D
1911-03-15,1910,Manchester United,Tottenham Hotspur,3-2,3,2,1,1,5,1,H
1911-03-18,1910,Bristol City,Sunderland,1-1,1,1,1,1,2,0,D
1911-03-18,1910,Everton,Bradford City,0-0,0,0,1,1,0,0,D
1911-03-18,1910,Manchester City,Blackburn Rovers,0-0,0,0,1,1,0,0,D
1911-03-18,1910,Middlesbrough,Bury,2-1,2,1,1,1,3,1,H
1911-03-18,1910,Newcastle United,Aston Villa,1-0,1,0,1,1,1,1,H
1911-03-18,1910,Notts County,Manchester United,1-0,1,0,1,1,1,1,H
1911-03-18,1910,Oldham Athletic,Nottingham Forest,2-0,2,0,1,1,2,2,H
1911-03-18,1910,Preston North End,Liverpool,2-1,2,1,1,1,3,1,H
1911-03-18,1910,Sheffield Wednesday,Arsenal,0-0,0,0,1,1,0,0,D
1911-03-18,1910,Tottenham Hotspur,Sheffield United,2-1,2,1,1,1,3,1,H
1911-03-25,1910,Arsenal,Bristol City,3-0,3,0,1,1,3,3,H
1911-03-25,1910,Bury,Preston North End,1-0,1,0,1,1,1,1,H
1911-03-25,1910,Liverpool,Notts County,2-1,2,1,1,1,3,1,H
1911-03-25,1910,Manchester United,Oldham Athletic,0-0,0,0,1,1,0,0,D
1911-03-25,1910,Nottingham Forest,Manchester City,0-0,0,0,1,1,0,0,D
1911-03-27,1910,Aston Villa,Everton,2-1,2,1,1,1,3,1,H
1911-03-27,1910,Blackburn Rovers,Nottingham Forest,4-1,4,1,1,1,5,3,H
1911-03-27,1910,Sheffield United,Middlesbrough,2-1,2,1,1,1,3,1,H
1911-03-27,1910,Tottenham Hotspur,Oldham Athletic,2-0,2,0,1,1,2,2,H
1911-04-01,1910,Bristol City,Bradford City,0-2,0,2,1,1,2,-2,A
1911-04-01,1910,Manchester United,Liverpool,2-0,2,0,1,1,2,2,H
1911-04-01,1910,Middlesbrough,Aston Villa,0-1,0,1,1,1,1,-1,A
1911-04-01,1910,Newcastle United,Arsenal,0-1,0,1,1,1,1,-1,A
1911-04-01,1910,Notts County,Bury,1-0,1,0,1,1,1,1,H
1911-04-01,1910,Oldham Athletic,Manchester City,1-1,1,1,1,1,2,0,D
1911-04-01,1910,Preston North End,Sheffield United,1-1,1,1,1,1,2,0,D
1911-04-01,1910,Sheffield Wednesday,Blackburn Rovers,1-0,1,0,1,1,1,1,H
1911-04-01,1910,Tottenham Hotspur,Sunderland,1-1,1,1,1,1,2,0,D
1911-04-03,1910,Sheffield United,Newcastle United,0-0,0,0,1,1,0,0,D
1911-04-04,1910,Bradford City,Sheffield Wednesday,5-2,5,2,1,1,7,3,H
1911-04-05,1910,Nottingham Forest,Newcastle United,0-1,0,1,1,1,1,-1,A
1911-04-06,1910,Blackburn Rovers,Everton,0-1,0,1,1,1,1,-1,A
1911-04-08,1910,Arsenal,Tottenham Hotspur,2-0,2,0,1,1,2,2,H
1911-04-08,1910,Aston Villa,Preston North End,0-2,0,2,1,1,2,-2,A
1911-04-08,1910,Blackburn Rovers,Bristol City,2-0,2,0,1,1,2,2,H
1911-04-08,1910,Bradford City,Newcastle United,1-0,1,0,1,1,1,1,H
1911-04-08,1910,Bury,Manchester United,0-3,0,3,1,1,3,-3,A
1911-04-08,1910,Liverpool,Oldham Athletic,1-0,1,0,1,1,1,1,H
1911-04-08,1910,Manchester City,Everton,2-1,2,1,1,1,3,1,H
1911-04-08,1910,Nottingham Forest,Sheffield Wednesday,0-1,0,1,1,1,1,-1,A
1911-04-08,1910,Sheffield United,Notts County,0-2,0,2,1,1,2,-2,A
1911-04-08,1910,Sunderland,Middlesbrough,3-1,3,1,1,1,4,2,H
1911-04-11,1910,Bradford City,Sunderland,3-0,3,0,1,1,3,3,H
1911-04-14,1910,Arsenal,Liverpool,0-0,0,0,1,1,0,0,D
1911-04-14,1910,Aston Villa,Sheffield United,3-0,3,0,1,1,3,3,H
1911-04-14,1910,Bury,Sunderland,0-0,0,0,1,1,0,0,D
1911-04-14,1910,Everton,Nottingham Forest,2-1,2,1,1,1,3,1,H
1911-04-14,1910,Manchester City,Middlesbrough,2-1,2,1,1,1,3,1,H
1911-04-14,1910,Newcastle United,Sheffield Wednesday,0-2,0,2,1,1,2,-2,A
1911-04-14,1910,Notts County,Blackburn Rovers,2-0,2,0,1,1,2,2,H
1911-04-14,1910,Oldham Athletic,Bristol City,1-0,1,0,1,1,1,1,H
1911-04-15,1910,Bristol City,Nottingham Forest,5-1,5,1,1,1,6,4,H
1911-04-15,1910,Liverpool,Bury,2-0,2,0,1,1,2,2,H
1911-04-15,1910,Manchester United,Sheffield United,1-1,1,1,1,1,2,0,D
1911-04-15,1910,Middlesbrough,Arsenal,1-1,1,1,1,1,2,0,D
1911-04-15,1910,Newcastle United,Blackburn Rovers,2-2,2,2,1,1,4,0,D
1911-04-15,1910,Notts County,Aston Villa,1-2,1,2,1,1,3,-1,A
1911-04-15,1910,Oldham Athletic,Everton,2-0,2,0,1,1,2,2,H
1911-04-15,1910,Preston North End,Sunderland,0-2,0,2,1,1,2,-2,A
1911-04-15,1910,Sheffield Wednesday,Manchester City,4-1,4,1,1,1,5,3,H
1911-04-15,1910,Tottenham Hotspur,Bradford City,2-0,2,0,1,1,2,2,H
1911-04-17,1910,Bradford City,Notts County,0-1,0,1,1,1,1,-1,A
1911-04-17,1910,Liverpool,Arsenal,1-1,1,1,1,1,2,0,D
1911-04-17,1910,Oldham Athletic,Sheffield United,3-0,3,0,1,1,3,3,H
1911-04-17,1910,Sheffield Wednesday,Manchester United,0-0,0,0,1,1,0,0,D
1911-04-17,1910,Tottenham Hotspur,Everton,0-1,0,1,1,1,1,-1,A
1911-04-18,1910,Notts County,Middlesbrough,1-0,1,0,1,1,1,1,H
1911-04-22,1910,Arsenal,Preston North End,2-0,2,0,1,1,2,2,H
1911-04-22,1910,Aston Villa,Manchester United,4-2,4,2,1,1,6,2,H
1911-04-22,1910,Blackburn Rovers,Tottenham Hotspur,3-0,3,0,1,1,3,3,H
1911-04-22,1910,Everton,Sheffield Wednesday,1-1,1,1,1,1,2,0,D
1911-04-22,1910,Manchester City,Bristol City,1-2,1,2,1,1,3,-1,A
1911-04-22,1910,Oldham Athletic,Bury,0-0,0,0,1,1,0,0,D
1911-04-22,1910,Sunderland,Notts County,1-1,1,1,1,1,2,0,D
1911-04-24,1910,Blackburn Rovers,Aston Villa,0-0,0,0,1,1,0,0,D
1911-04-27,1910,Bradford City,Middlesbrough,1-0,1,0,1,1,1,1,H
1911-04-29,1910,Bristol City,Everton,0-1,0,1,1,1,1,-1,A
1911-04-29,1910,Bury,Sheffield United,1-1,1,1,1,1,2,0,D
1911-04-29,1910,Liverpool,Aston Villa,3-1,3,1,1,1,4,2,H
1911-04-29,1910,Manchester United,Sunderland,5-1,5,1,1,1,6,4,H
1911-04-29,1910,Middlesbrough,Blackburn Rovers,2-3,2,3,1,1,5,-1,A
1911-04-29,1910,Newcastle United,Manchester City,3-3,3,3,1,1,6,0,D
1911-04-29,1910,Notts County,Arsenal,0-2,0,2,1,1,2,-2,A
1911-04-29,1910,Preston North End,Bradford City,2-0,2,0,1,1,2,2,H
1911-04-29,1910,Sheffield Wednesday,Oldham Athletic,2-0,2,0,1,1,2,2,H
1911-09-02,1911,Arsenal,Liverpool,2-2,2,2,1,1,4,0,D
1911-09-02,1911,Blackburn Rovers,Bury,2-0,2,0,1,1,2,2,H
1911-09-02,1911,Bolton Wanderers,Newcastle United,0-2,0,2,1,1,2,-2,A
1911-09-02,1911,Bradford City,Aston Villa,2-1,2,1,1,1,3,1,H
1911-09-02,1911,Everton,Tottenham Hotspur,2-2,2,2,1,1,4,0,D
1911-09-02,1911,Manchester City,Manchester United,0-0,0,0,1,1,0,0,D
1911-09-02,1911,Oldham Athletic,Sheffield United,2-3,2,3,1,1,5,-1,A
1911-09-02,1911,Sheffield Wednesday,Preston North End,0-1,0,1,1,1,1,-1,A
1911-09-02,1911,Sunderland,Middlesbrough,1-0,1,0,1,1,1,1,H
1911-09-02,1911,West Bromwich Albion,Notts County,2-1,2,1,1,1,3,1,H
1911-09-04,1911,Aston Villa,West Bromwich Albion,0-3,0,3,1,1,3,-3,A
1911-09-04,1911,Bolton Wanderers,Liverpool,2-1,2,1,1,1,3,1,H
1911-09-04,1911,Tottenham Hotspur,Sheffield Wednesday,3-1,3,1,1,1,4,2,H
1911-09-06,1911,Newcastle United,Everton,2-0,2,0,1,1,2,2,H
1911-09-06,1911,Sunderland,Blackburn Rovers,3-0,3,0,1,1,3,3,H
1911-09-09,1911,Aston Villa,Arsenal,4-1,4,1,1,1,5,3,H
1911-09-09,1911,Bury,Sheffield Wednesday,2-2,2,2,1,1,4,0,D
1911-09-09,1911,Liverpool,Manchester City,2-2,2,2,1,1,4,0,D
1911-09-09,1911,Manchester United,Everton,2-1,2,1,1,1,3,1,H
1911-09-09,1911,Middlesbrough,Blackburn Rovers,2-1,2,1,1,1,3,1,H
1911-09-09,1911,Newcastle United,Bradford City,0-2,0,2,1,1,2,-2,A
1911-09-09,1911,Notts County,Sunderland,3-1,3,1,1,1,4,2,H
1911-09-09,1911,Preston North End,Oldham Athletic,0-1,0,1,1,1,1,-1,A
1911-09-09,1911,Sheffield United,Bolton Wanderers,0-5,0,5,1,1,5,-5,A
1911-09-09,1911,Tottenham Hotspur,West Bromwich Albion,1-0,1,0,1,1,1,1,H
1911-09-16,1911,Arsenal,Newcastle United,2-0,2,0,1,1,2,2,H
1911-09-16,1911,Blackburn Rovers,Notts County,0-0,0,0,1,1,0,0,D
1911-09-16,1911,Bolton Wanderers,Oldham Athletic,2-1,2,1,1,1,3,1,H
1911-09-16,1911,Bradford City,Sheffield United,1-0,1,0,1,1,1,1,H
1911-09-16,1911,Bury,Preston North End,0-0,0,0,1,1,0,0,D
1911-09-16,1911,Everton,Liverpool,2-1,2,1,1,1,3,1,H
1911-09-16,1911,Manchester City,Aston Villa,2-6,2,6,1,1,8,-4,A
1911-09-16,1911,Sheffield Wednesday,Middlesbrough,0-2,0,2,1,1,2,-2,A
1911-09-16,1911,Sunderland,Tottenham Hotspur,1-1,1,1,1,1,2,0,D
1911-09-16,1911,West Bromwich Albion,Manchester United,1-0,1,0,1,1,1,1,H
1911-09-23,1911,Aston Villa,Everton,3-0,3,0,1,1,3,3,H
1911-09-23,1911,Liverpool,West Bromwich Albion,1-3,1,3,1,1,4,-2,A
1911-09-23,1911,Manchester United,Sunderland,2-2,2,2,1,1,4,0,D
1911-09-23,1911,Middlesbrough,Bury,1-1,1,1,1,1,2,0,D
1911-09-23,1911,Newcastle United,Manchester City,1-0,1,0,1,1,1,1,H
1911-09-23,1911,Notts County,Sheffield Wednesday,1-0,1,0,1,1,1,1,H
1911-09-23,1911,Oldham Athletic,Bradford City,3-0,3,0,1,1,3,3,H
1911-09-23,1911,Preston North End,Bolton Wanderers,1-2,1,2,1,1,3,-1,A
1911-09-23,1911,Sheffield United,Arsenal,2-1,2,1,1,1,3,1,H
1911-09-23,1911,Tottenham Hotspur,Blackburn Rovers,0-2,0,2,1,1,2,-2,A
1911-09-30,1911,Arsenal,Oldham Athletic,1-1,1,1,1,1,2,0,D
1911-09-30,1911,Blackburn Rovers,Manchester United,2-2,2,2,1,1,4,0,D
1911-09-30,1911,Bradford City,Bolton Wanderers,1-0,1,0,1,1,1,1,H
1911-09-30,1911,Bury,Notts County,0-1,0,1,1,1,1,-1,A
1911-09-30,1911,Everton,Newcastle United,2-0,2,0,1,1,2,2,H
1911-09-30,1911,Manchester City,Sheffield United,0-0,0,0,1,1,0,0,D
1911-09-30,1911,Middlesbrough,Preston North End,4-2,4,2,1,1,6,2,H
1911-09-30,1911,Sheffield Wednesday,Tottenham Hotspur,4-0,4,0,1,1,4,4,H
1911-09-30,1911,Sunderland,Liverpool,1-2,1,2,1,1,3,-1,A
1911-09-30,1911,West Bromwich Albion,Aston Villa,2-2,2,2,1,1,4,0,D
1911-10-05,1911,Notts County,Bradford City,0-0,0,0,1,1,0,0,D
1911-10-07,1911,Aston Villa,Sunderland,1-3,1,3,1,1,4,-2,A
1911-10-07,1911,Bolton Wanderers,Arsenal,2-2,2,2,1,1,4,0,D
1911-10-07,1911,Liverpool,Blackburn Rovers,1-2,1,2,1,1,3,-1,A
1911-10-07,1911,Manchester United,Sheffield Wednesday,3-1,3,1,1,1,4,2,H
1911-10-07,1911,Newcastle United,West Bromwich Albion,0-0,0,0,1,1,0,0,D
1911-10-07,1911,Notts County,Middlesbrough,2-1,2,1,1,1,3,1,H
1911-10-07,1911,Oldham Athletic,Manchester City,4-1,4,1,1,1,5,3,H
1911-10-07,1911,Preston North End,Bradford City,2-2,2,2,1,1,4,0,D
1911-10-07,1911,Sheffield United,Everton,2-1,2,1,1,1,3,1,H
1911-10-07,1911,Tottenham Hotspur,Bury,2-1,2,1,1,1,3,1,H
1911-10-14,1911,Arsenal,Bradford City,2-0,2,0,1,1,2,2,H
1911-10-14,1911,Blackburn Rovers,Aston Villa,3-1,3,1,1,1,4,2,H
1911-10-14,1911,Bury,Manchester United,0-1,0,1,1,1,1,-1,A
1911-10-14,1911,Everton,Oldham Athletic,1-1,1,1,1,1,2,0,D
1911-10-14,1911,Manchester City,Bolton Wanderers,3-1,3,1,1,1,4,2,H
1911-10-14,1911,Middlesbrough,Tottenham Hotspur,2-0,2,0,1,1,2,2,H
1911-10-14,1911,Notts County,Preston North End,1-2,1,2,1,1,3,-1,A
1911-10-14,1911,Sheffield Wednesday,Liverpool,2-2,2,2,1,1,4,0,D
1911-10-14,1911,Sunderland,Newcastle United,1-2,1,2,1,1,3,-1,A
1911-10-14,1911,West Bromwich Albion,Sheffield United,0-1,0,1,1,1,1,-1,A
1911-10-21,1911,Aston Villa,Sheffield Wednesday,2-3,2,3,1,1,5,-1,A
1911-10-21,1911,Bolton Wanderers,Everton,1-2,1,2,1,1,3,-1,A
1911-10-21,1911,Bradford City,Manchester City,4-1,4,1,1,1,5,3,H
1911-10-21,1911,Liverpool,Bury,1-1,1,1,1,1,2,0,D
1911-10-21,1911,Manchester United,Middlesbrough,3-4,3,4,1,1,7,-1,A
1911-10-21,1911,Newcastle United,Blackburn Rovers,4-2,4,2,1,1,6,2,H
1911-10-21,1911,Oldham Athletic,West Bromwich Albion,3-1,3,1,1,1,4,2,H
1911-10-21,1911,Preston North End,Arsenal,0-1,0,1,1,1,1,-1,A
1911-10-21,1911,Sheffield United,Sunderland,1-2,1,2,1,1,3,-1,A
1911-10-21,1911,Tottenham Hotspur,Notts County,2-2,2,2,1,1,4,0,D
1911-10-23,1911,Sheffield United,Aston Villa,0-1,0,1,1,1,1,-1,A
1911-10-28,1911,Blackburn Rovers,Sheffield United,1-0,1,0,1,1,1,1,H
1911-10-28,1911,Bury,Aston Villa,1-1,1,1,1,1,2,0,D
1911-10-28,1911,Everton,Bradford City,1-0,1,0,1,1,1,1,H
1911-10-28,1911,Manchester City,Arsenal,3-3,3,3,1,1,6,0,D
1911-10-28,1911,Middlesbrough,Liverpool,3-2,3,2,1,1,5,1,H
1911-10-28,1911,Notts County,Manchester United,0-1,0,1,1,1,1,-1,A
1911-10-28,1911,Sheffield Wednesday,Newcastle United,1-2,1,2,1,1,3,-1,A
1911-10-28,1911,Sunderland,Oldham Athletic,4-2,4,2,1,1,6,2,H
1911-10-28,1911,Tottenham Hotspur,Preston North End,6-2,6,2,1,1,8,4,H
1911-10-28,1911,West Bromwich Albion,Bolton Wanderers,0-0,0,0,1,1,0,0,D
1911-11-04,1911,Arsenal,Everton,0-1,0,1,1,1,1,-1,A
1911-11-04,1911,Aston Villa,Middlesbrough,2-1,2,1,1,1,3,1,H
1911-11-04,1911,Bolton Wanderers,Sunderland,3-0,3,0,1,1,3,3,H
1911-11-04,1911,Bradford City,West Bromwich Albion,4-1,4,1,1,1,5,3,H
1911-11-04,1911,Liverpool,Notts County,3-0,3,0,1,1,3,3,H
1911-11-04,1911,Manchester United,Tottenham Hotspur,1-2,1,2,1,1,3,-1,A
1911-11-04,1911,Newcastle United,Bury,3-2,3,2,1,1,5,1,H
1911-11-04,1911,Oldham Athletic,Blackburn Rovers,0-1,0,1,1,1,1,-1,A
1911-11-04,1911,Preston North End,Manchester City,2-1,2,1,1,1,3,1,H
1911-11-04,1911,Sheffield United,Sheffield Wednesday,1-1,1,1,1,1,2,0,D
1911-11-11,1911,Blackburn Rovers,Bolton Wanderers,2-0,2,0,1,1,2,2,H
1911-11-11,1911,Everton,Manchester City,1-0,1,0,1,1,1,1,H
1911-11-11,1911,Manchester United,Preston North End,0-0,0,0,1,1,0,0,D
1911-11-11,1911,Middlesbrough,Newcastle United,1-1,1,1,1,1,2,0,D
1911-11-11,1911,Sheffield Wednesday,Oldham Athletic,1-0,1,0,1,1,1,1,H
1911-11-11,1911,Sunderland,Bradford City,1-1,1,1,1,1,2,0,D
1911-11-11,1911,Tottenham Hotspur,Liverpool,2-0,2,0,1,1,2,2,H
1911-11-11,1911,West Bromwich Albion,Arsenal,1-1,1,1,1,1,2,0,D
1911-11-18,1911,Arsenal,Sunderland,3-0,3,0,1,1,3,3,H
1911-11-18,1911,Aston Villa,Tottenham Hotspur,2-2,2,2,1,1,4,0,D
1911-11-18,1911,Bolton Wanderers,Sheffield Wednesday,4-2,4,2,1,1,6,2,H
1911-11-18,1911,Bradford City,Blackburn Rovers,1-0,1,0,1,1,1,1,H
1911-11-18,1911,Liverpool,Manchester United,3-2,3,2,1,1,5,1,H
1911-11-18,1911,Manchester City,West Bromwich Albion,0-2,0,2,1,1,2,-2,A
1911-11-18,1911,Newcastle United,Notts County,3-2,3,2,1,1,5,1,H
1911-11-18,1911,Oldham Athletic,Bury,2-0,2,0,1,1,2,2,H
1911-11-18,1911,Preston North End,Everton,2-1,2,1,1,1,3,1,H
1911-11-18,1911,Sheffield United,Middlesbrough,1-1,1,1,1,1,2,0,D
1911-11-25,1911,Blackburn Rovers,Arsenal,4-0,4,0,1,1,4,4,H
1911-11-25,1911,Bury,Bolton Wanderers,1-3,1,3,1,1,4,-2,A
1911-11-25,1911,Liverpool,Preston North End,0-1,0,1,1,1,1,-1,A
1911-11-25,1911,Manchester United,Aston Villa,3-1,3,1,1,1,4,2,H
1911-11-25,1911,Middlesbrough,Oldham Athletic,3-0,3,0,1,1,3,3,H
1911-11-25,1911,Notts County,Sheffield United,2-0,2,0,1,1,2,2,H
1911-11-25,1911,Sheffield Wednesday,Bradford City,4-2,4,2,1,1,6,2,H
1911-11-25,1911,Sunderland,Manchester City,1-1,1,1,1,1,2,0,D
1911-11-25,1911,Tottenham Hotspur,Newcastle United,1-2,1,2,1,1,3,-1,A
1911-11-25,1911,West Bromwich Albion,Everton,1-0,1,0,1,1,1,1,H
1911-12-02,1911,Arsenal,Sheffield Wednesday,0-2,0,2,1,1,2,-2,A
1911-12-02,1911,Aston Villa,Liverpool,5-0,5,0,1,1,5,5,H
1911-12-02,1911,Bolton Wanderers,Middlesbrough,1-0,1,0,1,1,1,1,H
1911-12-02,1911,Bradford City,Bury,1-0,1,0,1,1,1,1,H
1911-12-02,1911,Everton,Sunderland,1-0,1,0,1,1,1,1,H
1911-12-02,1911,Manchester City,Blackburn Rovers,3-0,3,0,1,1,3,3,H
1911-12-02,1911,Newcastle United,Manchester United,2-3,2,3,1,1,5,-1,A
1911-12-02,1911,Oldham Athletic,Notts County,1-2,1,2,1,1,3,-1,A
1911-12-02,1911,Preston North End,West Bromwich Albion,1-1,1,1,1,1,2,0,D
1911-12-02,1911,Sheffield United,Tottenham Hotspur,1-2,1,2,1,1,3,-1,A
1911-12-09,1911,Aston Villa,Preston North End,1-0,1,0,1,1,1,1,H
1911-12-09,1911,Blackburn Rovers,Everton,2-1,2,1,1,1,3,1,H
1911-12-09,1911,Bury,Arsenal,3-1,3,1,1,1,4,2,H
1911-12-09,1911,Liverpool,Newcastle United,0-1,0,1,1,1,1,-1,A
1911-12-09,1911,Manchester United,Sheffield United,1-0,1,0,1,1,1,1,H
1911-12-09,1911,Middlesbrough,Bradford City,1-0,1,0,1,1,1,1,H
1911-12-09,1911,Notts County,Bolton Wanderers,3-2,3,2,1,1,5,1,H
1911-12-09,1911,Sheffield Wednesday,Manchester City,3-0,3,0,1,1,3,3,H
1911-12-09,1911,Sunderland,West Bromwich Albion,3-2,3,2,1,1,5,1,H
1911-12-09,1911,Tottenham Hotspur,Oldham Athletic,4-0,4,0,1,1,4,4,H
1911-12-16,1911,Arsenal,Middlesbrough,3-1,3,1,1,1,4,2,H
1911-12-16,1911,Bolton Wanderers,Tottenham Hotspur,1-0,1,0,1,1,1,1,H
1911-12-16,1911,Bradford City,Notts County,2-3,2,3,1,1,5,-1,A
1911-12-16,1911,Everton,Sheffield Wednesday,1-0,1,0,1,1,1,1,H
1911-12-16,1911,Manchester City,Bury,2-0,2,0,1,1,2,2,H
1911-12-16,1911,Newcastle United,Aston Villa,6-2,6,2,1,1,8,4,H
1911-12-16,1911,Oldham Athletic,Manchester United,2-2,2,2,1,1,4,0,D
1911-12-16,1911,Sheffield United,Liverpool,3-1,3,1,1,1,4,2,H
1911-12-16,1911,Sunderland,Preston North End,3-0,3,0,1,1,3,3,H
1911-12-16,1911,West Bromwich Albion,Blackburn Rovers,2-0,2,0,1,1,2,2,H
1911-12-23,1911,Aston Villa,Sheffield United,1-0,1,0,1,1,1,1,H
1911-12-23,1911,Blackburn Rovers,Sunderland,2-2,2,2,1,1,4,0,D
1911-12-23,1911,Bury,Everton,1-2,1,2,1,1,3,-1,A
1911-12-23,1911,Liverpool,Oldham Athletic,1-0,1,0,1,1,1,1,H
1911-12-23,1911,Manchester United,Bolton Wanderers,2-0,2,0,1,1,2,2,H
1911-12-23,1911,Middlesbrough,Manchester City,3-1,3,1,1,1,4,2,H
1911-12-23,1911,Notts County,Arsenal,3-1,3,1,1,1,4,2,H
1911-12-23,1911,Preston North End,Newcastle United,2-1,2,1,1,1,3,1,H
1911-12-23,1911,Sheffield Wednesday,West Bromwich Albion,4-1,4,1,1,1,5,3,H
1911-12-23,1911,Tottenham Hotspur,Bradford City,2-3,2,3,1,1,5,-1,A
1911-12-25,1911,Blackburn Rovers,Sheffield Wednesday,0-0,0,0,1,1,0,0,D
1911-12-25,1911,Bury,Sunderland,0-2,0,2,1,1,2,-2,A
1911-12-25,1911,Liverpool,Bolton Wanderers,1-0,1,0,1,1,1,1,H
1911-12-25,1911,Manchester United,Bradford City,0-1,0,1,1,1,1,-1,A
1911-12-25,1911,Middlesbrough,Everton,0-0,0,0,1,1,0,0,D
1911-12-25,1911,Notts County,Manchester City,0-1,0,1,1,1,1,-1,A
1911-12-25,1911,Oldham Athletic,Newcastle United,2-4,2,4,1,1,6,-2,A
1911-12-25,1911,Tottenham Hotspur,Arsenal,5-0,5,0,1,1,5,5,H
1911-12-26,1911,Arsenal,Tottenham Hotspur,3-1,3,1,1,1,4,2,H
1911-12-26,1911,Aston Villa,Oldham Athletic,6-1,6,1,1,1,7,5,H
1911-12-26,1911,Bradford City,Manchester United,0-1,0,1,1,1,1,-1,A
1911-12-26,1911,Everton,Middlesbrough,1-0,1,0,1,1,1,1,H
1911-12-26,1911,Manchester City,Notts County,4-0,4,0,1,1,4,4,H
1911-12-26,1911,Newcastle United,Sheffield United,2-2,2,2,1,1,4,0,D
1911-12-26,1911,Preston North End,Blackburn Rovers,2-2,2,2,1,1,4,0,D
1911-12-26,1911,Sheffield Wednesday,Sunderland,8-0,8,0,1,1,8,8,H
1911-12-26,1911,West Bromwich Albion,Bury,2-0,2,0,1,1,2,2,H
1911-12-28,1911,Sheffield United,Preston North End,4-2,4,2,1,1,6,2,H
1911-12-30,1911,Aston Villa,Bradford City,0-0,0,0,1,1,0,0,D
1911-12-30,1911,Bury,Blackburn Rovers,1-2,1,2,1,1,3,-1,A
1911-12-30,1911,Liverpool,Arsenal,4-1,4,1,1,1,5,3,H
1911-12-30,1911,Manchester United,Manchester City,0-0,0,0,1,1,0,0,D
1911-12-30,1911,Middlesbrough,Sunderland,3-3,3,3,1,1,6,0,D
1911-12-30,1911,Newcastle United,Bolton Wanderers,5-2,5,2,1,1,7,3,H
1911-12-30,1911,Notts County,West Bromwich Albion,2-0,2,0,1,1,2,2,H
1911-12-30,1911,Preston North End,Sheffield Wednesday,2-3,2,3,1,1,5,-1,A
1911-12-30,1911,Sheffield United,Oldham Athletic,4-0,4,0,1,1,4,4,H
1911-12-30,1911,Tottenham Hotspur,Everton,0-1,0,1,1,1,1,-1,A
1912-01-01,1911,Blackburn Rovers,Preston North End,3-0,3,0,1,1,3,3,H
1912-01-01,1911,Bolton Wanderers,Aston Villa,3-0,3,0,1,1,3,3,H
1912-01-01,1911,Bury,West Bromwich Albion,1-0,1,0,1,1,1,1,H
1912-01-01,1911,Liverpool,Bradford City,1-0,1,0,1,1,1,1,H
1912-01-01,1911,Manchester United,Arsenal,2-0,2,0,1,1,2,2,H
1912-01-01,1911,Sheffield United,Newcastle United,2-1,2,1,1,1,3,1,H
1912-01-01,1911,Sunderland,Sheffield Wednesday,0-0,0,0,1,1,0,0,D
1912-01-06,1911,Arsenal,Aston Villa,2-2,2,2,1,1,4,0,D
1912-01-06,1911,Blackburn Rovers,Middlesbrough,2-1,2,1,1,1,3,1,H
1912-01-06,1911,Bolton Wanderers,Sheffield United,0-3,0,3,1,1,3,-3,A
1912-01-06,1911,Everton,Manchester United,4-0,4,0,1,1,4,4,H
1912-01-06,1911,Manchester City,Liverpool,2-3,2,3,1,1,5,-1,A
1912-01-06,1911,Oldham Athletic,Preston North End,1-0,1,0,1,1,1,1,H
1912-01-06,1911,Sunderland,Notts County,5-0,5,0,1,1,5,5,H
1912-01-20,1911,Aston Villa,Manchester City,3-1,3,1,1,1,4,2,H
1912-01-20,1911,Liverpool,Everton,1-3,1,3,1,1,4,-2,A
1912-01-20,1911,Manchester United,West Bromwich Albion,1-2,1,2,1,1,3,-1,A
1912-01-20,1911,Middlesbrough,Sheffield Wednesday,1-1,1,1,1,1,2,0,D
1912-01-20,1911,Newcastle United,Arsenal,1-2,1,2,1,1,3,-1,A
1912-01-20,1911,Notts County,Blackburn Rovers,1-3,1,3,1,1,4,-2,A
1912-01-20,1911,Oldham Athletic,Bolton Wanderers,3-1,3,1,1,1,4,2,H
1912-01-20,1911,Preston North End,Bury,1-0,1,0,1,1,1,1,H
1912-01-20,1911,Tottenham Hotspur,Sunderland,0-0,0,0,1,1,0,0,D
1912-01-27,1911,Arsenal,Sheffield United,3-1,3,1,1,1,4,2,H
1912-01-27,1911,Blackburn Rovers,Tottenham Hotspur,0-0,0,0,1,1,0,0,D
1912-01-27,1911,Bolton Wanderers,Preston North End,3-0,3,0,1,1,3,3,H
1912-01-27,1911,Bradford City,Oldham Athletic,0-0,0,0,1,1,0,0,D
1912-01-27,1911,Bury,Middlesbrough,0-2,0,2,1,1,2,-2,A
1912-01-27,1911,Everton,Aston Villa,1-1,1,1,1,1,2,0,D
1912-01-27,1911,Manchester City,Newcastle United,1-1,1,1,1,1,2,0,D
1912-01-27,1911,Sheffield Wednesday,Notts County,3-0,3,0,1,1,3,3,H
1912-01-27,1911,Sunderland,Manchester United,5-0,5,0,1,1,5,5,H
1912-01-27,1911,West Bromwich Albion,Liverpool,1-0,1,0,1,1,1,1,H
1912-02-10,1911,Arsenal,Bolton Wanderers,3-0,3,0,1,1,3,3,H
1912-02-10,1911,Blackburn Rovers,Liverpool,1-0,1,0,1,1,1,1,H
1912-02-10,1911,Bradford City,Preston North End,0-1,0,1,1,1,1,-1,A
1912-02-10,1911,Bury,Tottenham Hotspur,2-1,2,1,1,1,3,1,H
1912-02-10,1911,Everton,Sheffield United,3-2,3,2,1,1,5,1,H
1912-02-10,1911,Manchester City,Oldham Athletic,1-3,1,3,1,1,4,-2,A
1912-02-10,1911,Middlesbrough,Notts County,4-0,4,0,1,1,4,4,H
1912-02-10,1911,Sheffield Wednesday,Manchester United,3-0,3,0,1,1,3,3,H
1912-02-10,1911,Sunderland,Aston Villa,2-2,2,2,1,1,4,0,D
1912-02-10,1911,West Bromwich Albion,Newcastle United,3-1,3,1,1,1,4,2,H
1912-02-14,1911,Bolton Wanderers,Bradford City,2-0,2,0,1,1,2,2,H
1912-02-14,1911,Notts County,Bury,2-0,2,0,1,1,2,2,H
1912-02-17,1911,Aston Villa,Blackburn Rovers,0-3,0,3,1,1,3,-3,A
1912-02-17,1911,Bolton Wanderers,Manchester City,2-1,2,1,1,1,3,1,H
1912-02-17,1911,Bradford City,Arsenal,1-1,1,1,1,1,2,0,D
1912-02-17,1911,Liverpool,Sheffield Wednesday,1-1,1,1,1,1,2,0,D
1912-02-17,1911,Manchester United,Bury,0-0,0,0,1,1,0,0,D
1912-02-17,1911,Newcastle United,Sunderland,3-1,3,1,1,1,4,2,H
1912-02-17,1911,Oldham Athletic,Everton,3-0,3,0,1,1,3,3,H
1912-02-17,1911,Preston North End,Notts County,2-1,2,1,1,1,3,1,H
1912-02-17,1911,Sheffield United,West Bromwich Albion,1-1,1,1,1,1,2,0,D
1912-02-17,1911,Tottenham Hotspur,Middlesbrough,2-1,2,1,1,1,3,1,H
1912-02-20,1911,Bury,Sheffield United,3-1,3,1,1,1,4,2,H
1912-02-24,1911,Bury,Liverpool,2-2,2,2,1,1,4,0,D
1912-02-24,1911,Middlesbrough,Arsenal,0-2,0,2,1,1,2,-2,A
1912-02-24,1911,Newcastle United,Preston North End,1-0,1,0,1,1,1,1,H
1912-02-24,1911,Notts County,Tottenham Hotspur,2-2,2,2,1,1,4,0,D
1912-02-24,1911,Sheffield Wednesday,Aston Villa,3-0,3,0,1,1,3,3,H
1912-02-26,1911,Sheffield United,Manchester City,6-2,6,2,1,1,8,4,H
1912-02-28,1911,Everton,Bolton Wanderers,1-0,1,0,1,1,1,1,H
1912-02-28,1911,Sunderland,Sheffield United,0-0,0,0,1,1,0,0,D
1912-03-02,1911,Arsenal,Manchester City,2-0,2,0,1,1,2,2,H
1912-03-02,1911,Aston Villa,Bury,5-2,5,2,1,1,7,3,H
1912-03-02,1911,Bolton Wanderers,West Bromwich Albion,2-0,2,0,1,1,2,2,H
1912-03-02,1911,Bradford City,Everton,1-0,1,0,1,1,1,1,H
1912-03-02,1911,Liverpool,Middlesbrough,1-1,1,1,1,1,2,0,D
1912-03-02,1911,Manchester United,Notts County,2-0,2,0,1,1,2,2,H
1912-03-02,1911,Newcastle United,Sheffield Wednesday,0-2,0,2,1,1,2,-2,A
1912-03-02,1911,Oldham Athletic,Sunderland,0-0,0,0,1,1,0,0,D
1912-03-02,1911,Preston North End,Tottenham Hotspur,0-1,0,1,1,1,1,-1,A
1912-03-02,1911,Sheffield United,Blackburn Rovers,1-1,1,1,1,1,2,0,D
1912-03-04,1911,Sheffield United,Bradford City,7-3,7,3,1,1,10,4,H
1912-03-09,1911,Bury,Newcastle United,2-1,2,1,1,1,3,1,H
1912-03-09,1911,Manchester City,Preston North End,0-0,0,0,1,1,0,0,D
1912-03-09,1911,Middlesbrough,Aston Villa,1-2,1,2,1,1,3,-1,A
1912-03-09,1911,Notts County,Liverpool,0-0,0,0,1,1,0,0,D
1912-03-09,1911,Oldham Athletic,Arsenal,0-0,0,0,1,1,0,0,D
1912-03-09,1911,Sheffield Wednesday,Sheffield United,1-1,1,1,1,1,2,0,D
1912-03-09,1911,Sunderland,Bolton Wanderers,0-1,0,1,1,1,1,-1,A
1912-03-13,1911,Notts County,Aston Villa,2-0,2,0,1,1,2,2,H
1912-03-13,1911,West Bromwich Albion,Tottenham Hotspur,2-0,2,0,1,1,2,2,H
1912-03-16,1911,Arsenal,West Bromwich Albion,0-2,0,2,1,1,2,-2,A
1912-03-16,1911,Aston Villa,Notts County,5-1,5,1,1,1,6,4,H
1912-03-16,1911,Bolton Wanderers,Blackburn Rovers,2-0,2,0,1,1,2,2,H
1912-03-16,1911,Bradford City,Sunderland,2-1,2,1,1,1,3,1,H
1912-03-16,1911,Liverpool,Tottenham Hotspur,1-2,1,2,1,1,3,-1,A
1912-03-16,1911,Manchester City,Everton,4-0,4,0,1,1,4,4,H
1912-03-16,1911,Newcastle United,Middlesbrough,0-1,0,1,1,1,1,-1,A
1912-03-16,1911,Oldham Athletic,Sheffield Wednesday,1-0,1,0,1,1,1,1,H
1912-03-16,1911,Preston North End,Manchester United,0-0,0,0,1,1,0,0,D
1912-03-16,1911,Sheffield United,Bury,4-0,4,0,1,1,4,4,H
1912-03-18,1911,Sheffield Wednesday,Bury,2-1,2,1,1,1,3,1,H
1912-03-23,1911,Blackburn Rovers,Bradford City,3-1,3,1,1,1,4,2,H
1912-03-23,1911,Bury,Oldham Athletic,1-1,1,1,1,1,2,0,D
1912-03-23,1911,Everton,Preston North End,1-0,1,0,1,1,1,1,H
1912-03-23,1911,Manchester United,Liverpool,1-1,1,1,1,1,2,0,D
1912-03-23,1911,Middlesbrough,Sheffield United,1-1,1,1,1,1,2,0,D
1912-03-23,1911,Notts County,Newcastle United,1-4,1,4,1,1,5,-3,A
1912-03-23,1911,Sheffield Wednesday,Bolton Wanderers,0-1,0,1,1,1,1,-1,A
1912-03-23,1911,Sunderland,Arsenal,1-0,1,0,1,1,1,1,H
1912-03-23,1911,Tottenham Hotspur,Aston Villa,2-1,2,1,1,1,3,1,H
1912-03-23,1911,West Bromwich Albion,Manchester City,1-1,1,1,1,1,2,0,D
1912-03-27,1911,Everton,Arsenal,1-0,1,0,1,1,1,1,H
1912-03-28,1911,Manchester City,Bradford City,4-0,4,0,1,1,4,4,H
1912-03-30,1911,Aston Villa,Manchester United,6-0,6,0,1,1,6,6,H
1912-03-30,1911,Bolton Wanderers,Bury,1-0,1,0,1,1,1,1,H
1912-03-30,1911,Bradford City,Sheffield Wednesday,5-1,5,1,1,1,6,4,H
1912-03-30,1911,Manchester City,Sunderland,2-0,2,0,1,1,2,2,H
1912-03-30,1911,Newcastle United,Tottenham Hotspur,2-0,2,0,1,1,2,2,H
1912-03-30,1911,Oldham Athletic,Middlesbrough,2-0,2,0,1,1,2,2,H
1912-03-30,1911,Preston North End,Liverpool,2-1,2,1,1,1,3,1,H
1912-03-30,1911,Sheffield United,Notts County,1-3,1,3,1,1,4,-2,A
1912-04-05,1911,Arsenal,Manchester United,2-1,2,1,1,1,3,1,H
1912-04-05,1911,Aston Villa,Bolton Wanderers,0-1,0,1,1,1,1,-1,A
1912-04-05,1911,Liverpool,Sunderland,2-1,2,1,1,1,3,1,H
1912-04-05,1911,Manchester City,Tottenham Hotspur,2-1,2,1,1,1,3,1,H
1912-04-05,1911,Middlesbrough,West Bromwich Albion,1-0,1,0,1,1,1,1,H
1912-04-05,1911,Newcastle United,Oldham Athletic,1-1,1,1,1,1,2,0,D
1912-04-05,1911,Notts County,Everton,0-1,0,1,1,1,1,-1,A
1912-04-05,1911,Preston North End,Sheffield United,3-0,3,0,1,1,3,3,H
1912-04-06,1911,Blackburn Rovers,Manchester City,2-0,2,0,1,1,2,2,H
1912-04-06,1911,Bury,Bradford City,2-0,2,0,1,1,2,2,H
1912-04-06,1911,Liverpool,Aston Villa,1-2,1,2,1,1,3,-1,A
1912-04-06,1911,Manchester United,Newcastle United,0-2,0,2,1,1,2,-2,A
1912-04-06,1911,Middlesbrough,Bolton Wanderers,1-0,1,0,1,1,1,1,H
1912-04-06,1911,Notts County,Oldham Athletic,1-1,1,1,1,1,2,0,D
1912-04-06,1911,Sheffield Wednesday,Arsenal,3-0,3,0,1,1,3,3,H
1912-04-06,1911,Sunderland,Everton,4-0,4,0,1,1,4,4,H
1912-04-06,1911,Tottenham Hotspur,Sheffield United,1-1,1,1,1,1,2,0,D
1912-04-08,1911,Arsenal,Preston North End,4-1,4,1,1,1,5,3,H
1912-04-08,1911,Bradford City,Liverpool,0-2,0,2,1,1,2,-2,A
1912-04-08,1911,Everton,Notts County,1-1,1,1,1,1,2,0,D
1912-04-08,1911,Oldham Athletic,Aston Villa,1-2,1,2,1,1,3,-1,A
1912-04-08,1911,Sheffield Wednesday,Blackburn Rovers,1-1,1,1,1,1,2,0,D
1912-04-08,1911,Sunderland,Bury,1-0,1,0,1,1,1,1,H
1912-04-08,1911,Tottenham Hotspur,Manchester City,0-2,0,2,1,1,2,-2,A
1912-04-08,1911,West Bromwich Albion,Middlesbrough,3-1,3,1,1,1,4,2,H
1912-04-09,1911,Bradford City,Newcastle United,1-1,1,1,1,1,2,0,D
1912-04-09,1911,Tottenham Hotspur,Manchester United,1-1,1,1,1,1,2,0,D
1912-04-09,1911,West Bromwich Albion,Preston North End,0-2,0,2,1,1,2,-2,A
1912-04-13,1911,Arsenal,Bury,1-0,1,0,1,1,1,1,H
1912-04-13,1911,Bolton Wanderers,Notts County,3-0,3,0,1,1,3,3,H
1912-04-13,1911,Bradford City,Middlesbrough,2-1,2,1,1,1,3,1,H
1912-04-13,1911,Everton,Blackburn Rovers,1-3,1,3,1,1,4,-2,A
1912-04-13,1911,Manchester City,Sheffield Wednesday,4-0,4,0,1,1,4,4,H
1912-04-13,1911,Newcastle United,Liverpool,1-1,1,1,1,1,2,0,D
1912-04-13,1911,Oldham Athletic,Tottenham Hotspur,2-1,2,1,1,1,3,1,H
1912-04-13,1911,Preston North End,Aston Villa,4-1,4,1,1,1,5,3,H
1912-04-13,1911,Sheffield United,Manchester United,6-1,6,1,1,1,7,5,H
1912-04-13,1911,West Bromwich Albion,Sunderland,1-0,1,0,1,1,1,1,H
1912-04-15,1911,Blackburn Rovers,Oldham Athletic,1-0,1,0,1,1,1,1,H
1912-04-17,1911,Middlesbrough,Manchester United,3-0,3,0,1,1,3,3,H
1912-04-20,1911,Aston Villa,Newcastle United,2-0,2,0,1,1,2,2,H
1912-04-20,1911,Bury,Manchester City,1-2,1,2,1,1,3,-1,A
1912-04-20,1911,Liverpool,Sheffield United,2-0,2,0,1,1,2,2,H
1912-04-20,1911,Manchester United,Oldham Athletic,3-1,3,1,1,1,4,2,H
1912-04-20,1911,Preston North End,Sunderland,0-3,0,3,1,1,3,-3,A
1912-04-20,1911,Sheffield Wednesday,Everton,1-3,1,3,1,1,4,-2,A
1912-04-20,1911,Tottenham Hotspur,Bolton Wanderers,1-0,1,0,1,1,1,1,H
1912-04-22,1911,Arsenal,Blackburn Rovers,5-1,5,1,1,1,6,4,H
1912-04-22,1911,Everton,West Bromwich Albion,3-0,3,0,1,1,3,3,H
1912-04-22,1911,Preston North End,Middlesbrough,0-3,0,3,1,1,3,-3,A
1912-04-25,1911,Blackburn Rovers,West Bromwich Albion,4-1,4,1,1,1,5,3,H
1912-04-26,1911,West Bromwich Albion,Bradford City,0-0,0,0,1,1,0,0,D
1912-04-27,1911,Arsenal,Notts County,0-3,0,3,1,1,3,-3,A
1912-04-27,1911,Blackburn Rovers,Newcastle United,1-1,1,1,1,1,2,0,D
1912-04-27,1911,Bolton Wanderers,Manchester United,1-1,1,1,1,1,2,0,D
1912-04-27,1911,Bradford City,Tottenham Hotspur,3-0,3,0,1,1,3,3,H
1912-04-27,1911,Everton,Bury,1-1,1,1,1,1,2,0,D
1912-04-27,1911,Manchester City,Middlesbrough,2-0,2,0,1,1,2,2,H
1912-04-27,1911,Oldham Athletic,Liverpool,0-1,0,1,1,1,1,-1,A
1912-04-27,1911,West Bromwich Albion,Sheffield Wednesday,1-5,1,5,1,1,6,-4,A
1912-04-29,1911,Manchester United,Blackburn Rovers,3-1,3,1,1,1,4,2,H
1912-04-29,1911,West Bromwich Albion,Oldham Athletic,0-0,0,0,1,1,0,0,D
1912-09-02,1912,Arsenal,Manchester United,0-0,0,0,1,1,0,0,D
1912-09-02,1912,Aston Villa,Chelsea,1-0,1,0,1,1,1,1,H
1912-09-02,1912,Bolton Wanderers,Newcastle United,1-2,1,2,1,1,3,-1,A
1912-09-02,1912,Notts County,Manchester City,0-1,0,1,1,1,1,-1,A
1912-09-02,1912,Sheffield Wednesday,Blackburn Rovers,2-1,2,1,1,1,3,1,H
1912-09-02,1912,Tottenham Hotspur,Everton,0-2,0,2,1,1,2,-2,A
1912-09-04,1912,Liverpool,Oldham Athletic,2-0,2,0,1,1,2,2,H
1912-09-04,1912,West Bromwich Albion,Middlesbrough,2-0,2,0,1,1,2,2,H
1912-09-07,1912,Aston Villa,Bradford City,3-1,3,1,1,1,4,2,H
1912-09-07,1912,Bolton Wanderers,Chelsea,1-0,1,0,1,1,1,1,H
1912-09-07,1912,Derby County,Blackburn Rovers,1-1,1,1,1,1,2,0,D
1912-09-07,1912,Liverpool,Arsenal,3-0,3,0,1,1,3,3,H
1912-09-07,1912,Manchester United,Manchester City,0-1,0,1,1,1,1,-1,A
1912-09-07,1912,Middlesbrough,Everton,0-0,0,0,1,1,0,0,D
1912-09-07,1912,Newcastle United,Sunderland,1-1,1,1,1,1,2,0,D
1912-09-07,1912,Notts County,West Bromwich Albion,1-1,1,1,1,1,2,0,D
1912-09-07,1912,Sheffield United,Oldham Athletic,1-1,1,1,1,1,2,0,D
1912-09-07,1912,Tottenham Hotspur,Sheffield Wednesday,2-4,2,4,1,1,6,-2,A
1912-09-09,1912,Blackburn Rovers,Sunderland,4-0,4,0,1,1,4,4,H
1912-09-09,1912,Chelsea,Liverpool,1-2,1,2,1,1,3,-1,A
1912-09-09,1912,Oldham Athletic,Aston Villa,2-2,2,2,1,1,4,0,D
1912-09-11,1912,Newcastle United,Bolton Wanderers,2-1,2,1,1,1,3,1,H
1912-09-14,1912,Arsenal,Bolton Wanderers,1-2,1,2,1,1,3,-1,A
1912-09-14,1912,Blackburn Rovers,Tottenham Hotspur,6-1,6,1,1,1,7,5,H
1912-09-14,1912,Bradford City,Liverpool,2-0,2,0,1,1,2,2,H
1912-09-14,1912,Chelsea,Sheffield United,4-2,4,2,1,1,6,2,H
1912-09-14,1912,Everton,Notts County,4-0,4,0,1,1,4,4,H
1912-09-14,1912,Manchester City,Aston Villa,1-0,1,0,1,1,1,1,H
1912-09-14,1912,Oldham Athletic,Newcastle United,1-0,1,0,1,1,1,1,H
1912-09-14,1912,Sheffield Wednesday,Middlesbrough,3-1,3,1,1,1,4,2,H
1912-09-14,1912,Sunderland,Derby County,0-2,0,2,1,1,2,-2,A
1912-09-14,1912,West Bromwich Albion,Manchester United,1-2,1,2,1,1,3,-1,A
1912-09-16,1912,Arsenal,Aston Villa,0-3,0,3,1,1,3,-3,A
1912-09-18,1912,Derby County,Everton,1-4,1,4,1,1,5,-3,A
1912-09-18,1912,Sunderland,Blackburn Rovers,2-4,2,4,1,1,6,-2,A
1912-09-21,1912,Aston Villa,West Bromwich Albion,2-4,2,4,1,1,6,-2,A
1912-09-21,1912,Bolton Wanderers,Bradford City,2-0,2,0,1,1,2,2,H
1912-09-21,1912,Liverpool,Manchester City,1-2,1,2,1,1,3,-1,A
1912-09-21,1912,Manchester United,Everton,2-0,2,0,1,1,2,2,H
1912-09-21,1912,Middlesbrough,Blackburn Rovers,0-0,0,0,1,1,0,0,D
1912-09-21,1912,Newcastle United,Chelsea,3-2,3,2,1,1,5,1,H
1912-09-21,1912,Notts County,Sheffield Wednesday,1-2,1,2,1,1,3,-1,A
1912-09-21,1912,Oldham Athletic,Sunderland,3-0,3,0,1,1,3,3,H
1912-09-21,1912,Sheffield United,Arsenal,1-3,1,3,1,1,4,-2,A
1912-09-21,1912,Tottenham Hotspur,Derby County,1-2,1,2,1,1,3,-1,A
1912-09-28,1912,Arsenal,Newcastle United,1-1,1,1,1,1,2,0,D
1912-09-28,1912,Blackburn Rovers,Notts County,2-1,2,1,1,1,3,1,H
1912-09-28,1912,Bradford City,Sheffield United,3-1,3,1,1,1,4,2,H
1912-09-28,1912,Chelsea,Oldham Athletic,1-1,1,1,1,1,2,0,D
1912-09-28,1912,Derby County,Middlesbrough,0-2,0,2,1,1,2,-2,A
1912-09-28,1912,Everton,Aston Villa,0-1,0,1,1,1,1,-1,A
1912-09-28,1912,Manchester City,Bolton Wanderers,2-0,2,0,1,1,2,2,H
1912-09-28,1912,Sheffield Wednesday,Manchester United,3-3,3,3,1,1,6,0,D
1912-09-28,1912,Sunderland,Tottenham Hotspur,2-2,2,2,1,1,4,0,D
1912-09-28,1912,West Bromwich Albion,Liverpool,3-1,3,1,1,1,4,2,H
1912-10-05,1912,Aston Villa,Sheffield Wednesday,10-0,10,0,1,1,10,10,H
1912-10-05,1912,Bolton Wanderers,West Bromwich Albion,2-1,2,1,1,1,3,1,H
1912-10-05,1912,Chelsea,Sunderland,2-0,2,0,1,1,2,2,H
1912-10-05,1912,Liverpool,Everton,0-2,0,2,1,1,2,-2,A
1912-10-05,1912,Manchester United,Blackburn Rovers,1-1,1,1,1,1,2,0,D
1912-10-05,1912,Middlesbrough,Tottenham Hotspur,1-1,1,1,1,1,2,0,D
1912-10-05,1912,Newcastle United,Bradford City,1-1,1,1,1,1,2,0,D
1912-10-05,1912,Notts County,Derby County,0-1,0,1,1,1,1,-1,A
1912-10-05,1912,Oldham Athletic,Arsenal,0-0,0,0,1,1,0,0,D
1912-10-05,1912,Sheffield United,Manchester City,1-1,1,1,1,1,2,0,D
1912-10-12,1912,Arsenal,Chelsea,0-1,0,1,1,1,1,-1,A
1912-10-12,1912,Blackburn Rovers,Aston Villa,2-2,2,2,1,1,4,0,D
1912-10-12,1912,Bradford City,Oldham Athletic,0-0,0,0,1,1,0,0,D
1912-10-12,1912,Derby County,Manchester United,2-1,2,1,1,1,3,1,H
1912-10-12,1912,Everton,Bolton Wanderers,2-3,2,3,1,1,5,-1,A
1912-10-12,1912,Manchester City,Newcastle United,0-1,0,1,1,1,1,-1,A
1912-10-12,1912,Sheffield Wednesday,Liverpool,1-0,1,0,1,1,1,1,H
1912-10-12,1912,Sunderland,Middlesbrough,4-0,4,0,1,1,4,4,H
1912-10-12,1912,West Bromwich Albion,Sheffield United,3-1,3,1,1,1,4,2,H
1912-10-14,1912,Sheffield United,Liverpool,4-1,4,1,1,1,5,3,H
1912-10-19,1912,Arsenal,Sunderland,1-3,1,3,1,1,4,-2,A
1912-10-19,1912,Aston Villa,Derby County,5-1,5,1,1,1,6,4,H
1912-10-19,1912,Bolton Wanderers,Sheffield Wednesday,3-0,3,0,1,1,3,3,H
1912-10-19,1912,Chelsea,Bradford City,0-3,0,3,1,1,3,-3,A
1912-10-19,1912,Liverpool,Blackburn Rovers,4-1,4,1,1,1,5,3,H
1912-10-19,1912,Manchester United,Tottenham Hotspur,2-0,2,0,1,1,2,2,H
1912-10-19,1912,Newcastle United,West Bromwich Albion,1-1,1,1,1,1,2,0,D
1912-10-19,1912,Notts County,Middlesbrough,1-3,1,3,1,1,4,-2,A
1912-10-19,1912,Oldham Athletic,Manchester City,2-1,2,1,1,1,3,1,H
1912-10-19,1912,Sheffield United,Everton,4-1,4,1,1,1,5,3,H
1912-10-26,1912,Blackburn Rovers,Bolton Wanderers,6-0,6,0,1,1,6,6,H
1912-10-26,1912,Bradford City,Arsenal,3-1,3,1,1,1,4,2,H
1912-10-26,1912,Derby County,Liverpool,4-2,4,2,1,1,6,2,H
1912-10-26,1912,Everton,Newcastle United,0-6,0,6,1,1,6,-6,A
1912-10-26,1912,Manchester City,Chelsea,2-0,2,0,1,1,2,2,H
1912-10-26,1912,Middlesbrough,Manchester United,3-2,3,2,1,1,5,1,H
1912-10-26,1912,Sheffield Wednesday,Sheffield United,1-0,1,0,1,1,1,1,H
1912-10-26,1912,Sunderland,Notts County,4-0,4,0,1,1,4,4,H
1912-10-26,1912,Tottenham Hotspur,Aston Villa,3-3,3,3,1,1,6,0,D
1912-10-26,1912,West Bromwich Albion,Oldham Athletic,2-3,2,3,1,1,5,-1,A
1912-11-02,1912,Arsenal,Manchester City,0-4,0,4,1,1,4,-4,A
1912-11-02,1912,Aston Villa,Middlesbrough,5-1,5,1,1,1,6,4,H
1912-11-02,1912,Bolton Wanderers,Derby County,1-1,1,1,1,1,2,0,D
1912-11-02,1912,Bradford City,Sunderland,1-5,1,5,1,1,6,-4,A
1912-11-02,1912,Chelsea,West Bromwich Albion,0-2,0,2,1,1,2,-2,A
1912-11-02,1912,Liverpool,Tottenham Hotspur,4-1,4,1,1,1,5,3,H
1912-11-02,1912,Manchester United,Notts County,2-1,2,1,1,1,3,1,H
1912-11-02,1912,Newcastle United,Sheffield Wednesday,1-0,1,0,1,1,1,1,H
1912-11-02,1912,Oldham Athletic,Everton,2-0,2,0,1,1,2,2,H
1912-11-02,1912,Sheffield United,Blackburn Rovers,0-0,0,0,1,1,0,0,D
1912-11-04,1912,Tottenham Hotspur,Notts County,0-3,0,3,1,1,3,-3,A
1912-11-09,1912,Blackburn Rovers,Newcastle United,2-0,2,0,1,1,2,2,H
1912-11-09,1912,Derby County,Sheffield United,5-1,5,1,1,1,6,4,H
1912-11-09,1912,Everton,Chelsea,1-0,1,0,1,1,1,1,H
1912-11-09,1912,Manchester City,Bradford City,1-3,1,3,1,1,4,-2,A
1912-11-09,1912,Middlesbrough,Liverpool,3-4,3,4,1,1,7,-1,A
1912-11-09,1912,Notts County,Aston Villa,1-1,1,1,1,1,2,0,D
1912-11-09,1912,Sheffield Wednesday,Oldham Athletic,5-0,5,0,1,1,5,5,H
1912-11-09,1912,Sunderland,Manchester United,3-1,3,1,1,1,4,2,H
1912-11-09,1912,Tottenham Hotspur,Bolton Wanderers,0-1,0,1,1,1,1,-1,A
1912-11-09,1912,West Bromwich Albion,Arsenal,2-1,2,1,1,1,3,1,H
1912-11-16,1912,Arsenal,Everton,0-0,0,0,1,1,0,0,D
1912-11-16,1912,Aston Villa,Manchester United,4-2,4,2,1,1,6,2,H
1912-11-16,1912,Bolton Wanderers,Middlesbrough,3-2,3,2,1,1,5,1,H
1912-11-16,1912,Bradford City,West Bromwich Albion,1-1,1,1,1,1,2,0,D
1912-11-16,1912,Chelsea,Sheffield Wednesday,0-4,0,4,1,1,4,-4,A
1912-11-16,1912,Liverpool,Notts County,0-0,0,0,1,1,0,0,D
1912-11-16,1912,Manchester City,Sunderland,1-0,1,0,1,1,1,1,H
1912-11-16,1912,Newcastle United,Derby County,2-4,2,4,1,1,6,-2,A
1912-11-16,1912,Sheffield United,Tottenham Hotspur,4-0,4,0,1,1,4,4,H
1912-11-23,1912,Blackburn Rovers,Chelsea,1-1,1,1,1,1,2,0,D
1912-11-23,1912,Derby County,Oldham Athletic,1-2,1,2,1,1,3,-1,A
1912-11-23,1912,Everton,Bradford City,2-1,2,1,1,1,3,1,H
1912-11-23,1912,Manchester United,Liverpool,3-1,3,1,1,1,4,2,H
1912-11-23,1912,Middlesbrough,Sheffield United,4-1,4,1,1,1,5,3,H
1912-11-23,1912,Notts County,Bolton Wanderers,1-0,1,0,1,1,1,1,H
1912-11-23,1912,Sheffield Wednesday,Arsenal,2-0,2,0,1,1,2,2,H
1912-11-23,1912,Sunderland,Aston Villa,3-1,3,1,1,1,4,2,H
1912-11-23,1912,Tottenham Hotspur,Newcastle United,1-0,1,0,1,1,1,1,H
1912-11-23,1912,West Bromwich Albion,Manchester City,0-2,0,2,1,1,2,-2,A
1912-11-30,1912,Arsenal,Blackburn Rovers,0-1,0,1,1,1,1,-1,A
1912-11-30,1912,Bolton Wanderers,Manchester United,2-1,2,1,1,1,3,1,H
1912-11-30,1912,Bradford City,Sheffield Wednesday,0-0,0,0,1,1,0,0,D
1912-11-30,1912,Chelsea,Derby County,3-1,3,1,1,1,4,2,H
1912-11-30,1912,Liverpool,Aston Villa,2-0,2,0,1,1,2,2,H
1912-11-30,1912,Manchester City,Everton,1-0,1,0,1,1,1,1,H
1912-11-30,1912,Newcastle United,Middlesbrough,3-1,3,1,1,1,4,2,H
1912-11-30,1912,Oldham Athletic,Tottenham Hotspur,4-1,4,1,1,1,5,3,H
1912-11-30,1912,Sheffield United,Notts County,2-0,2,0,1,1,2,2,H
1912-11-30,1912,West Bromwich Albion,Sunderland,3-1,3,1,1,1,4,2,H
1912-12-07,1912,Aston Villa,Bolton Wanderers,1-1,1,1,1,1,2,0,D
1912-12-07,1912,Blackburn Rovers,Bradford City,5-0,5,0,1,1,5,5,H
1912-12-07,1912,Derby County,Arsenal,4-1,4,1,1,1,5,3,H
1912-12-07,1912,Everton,West Bromwich Albion,1-3,1,3,1,1,4,-2,A
1912-12-07,1912,Manchester United,Sheffield United,4-0,4,0,1,1,4,4,H
1912-12-07,1912,Middlesbrough,Oldham Athletic,2-2,2,2,1,1,4,0,D
1912-12-07,1912,Notts County,Newcastle United,0-1,0,1,1,1,1,-1,A
1912-12-07,1912,Sheffield Wednesday,Manchester City,1-0,1,0,1,1,1,1,H
1912-12-07,1912,Sunderland,Liverpool,7-0,7,0,1,1,7,7,H
1912-12-07,1912,Tottenham Hotspur,Chelsea,1-0,1,0,1,1,1,1,H
1912-12-14,1912,Arsenal,Tottenham Hotspur,0-3,0,3,1,1,3,-3,A
1912-12-14,1912,Bolton Wanderers,Liverpool,1-1,1,1,1,1,2,0,D
1912-12-14,1912,Bradford City,Derby County,2-3,2,3,1,1,5,-1,A
1912-12-14,1912,Chelsea,Middlesbrough,2-3,2,3,1,1,5,-1,A
1912-12-14,1912,Everton,Sunderland,0-4,0,4,1,1,4,-4,A
1912-12-14,1912,Manchester City,Blackburn Rovers,3-1,3,1,1,1,4,2,H
1912-12-14,1912,Newcastle United,Manchester United,1-3,1,3,1,1,4,-2,A
1912-12-14,1912,Oldham Athletic,Notts County,4-0,4,0,1,1,4,4,H
1912-12-14,1912,Sheffield United,Aston Villa,3-2,3,2,1,1,5,1,H
1912-12-14,1912,West Bromwich Albion,Sheffield Wednesday,1-1,1,1,1,1,2,0,D
1912-12-21,1912,Aston Villa,Newcastle United,3-1,3,1,1,1,4,2,H
1912-12-21,1912,Blackburn Rovers,West Bromwich Albion,2-4,2,4,1,1,6,-2,A
1912-12-21,1912,Derby County,Manchester City,2-0,2,0,1,1,2,2,H
1912-12-21,1912,Liverpool,Sheffield United,2-2,2,2,1,1,4,0,D
1912-12-21,1912,Manchester United,Oldham Athletic,0-0,0,0,1,1,0,0,D
1912-12-21,1912,Middlesbrough,Arsenal,2-0,2,0,1,1,2,2,H
1912-12-21,1912,Notts County,Chelsea,0-0,0,0,1,1,0,0,D
1912-12-21,1912,Sheffield Wednesday,Everton,1-2,1,2,1,1,3,-1,A
1912-12-21,1912,Sunderland,Bolton Wanderers,2-1,2,1,1,1,3,1,H
1912-12-21,1912,Tottenham Hotspur,Bradford City,2-1,2,1,1,1,3,1,H
1912-12-25,1912,Arsenal,Notts County,0-0,0,0,1,1,0,0,D
1912-12-25,1912,Chelsea,Manchester United,1-4,1,4,1,1,5,-3,A
1912-12-25,1912,Derby County,West Bromwich Albion,1-2,1,2,1,1,3,-1,A
1912-12-25,1912,Everton,Blackburn Rovers,2-1,2,1,1,1,3,1,H
1912-12-25,1912,Manchester City,Tottenham Hotspur,2-2,2,2,1,1,4,0,D
1912-12-25,1912,Newcastle United,Sheffield United,1-2,1,2,1,1,3,-1,A
1912-12-25,1912,Sheffield Wednesday,Sunderland,1-2,1,2,1,1,3,-1,A
1912-12-26,1912,Aston Villa,Oldham Athletic,7-1,7,1,1,1,8,6,H
1912-12-26,1912,Blackburn Rovers,Everton,1-2,1,2,1,1,3,-1,A
1912-12-26,1912,Liverpool,Newcastle United,2-1,2,1,1,1,3,1,H
1912-12-26,1912,Manchester United,Chelsea,4-2,4,2,1,1,6,2,H
1912-12-26,1912,Middlesbrough,Bradford City,1-1,1,1,1,1,2,0,D
1912-12-26,1912,Notts County,Arsenal,2-1,2,1,1,1,3,1,H
1912-12-26,1912,Sheffield United,Bolton Wanderers,0-2,0,2,1,1,2,-2,A
1912-12-26,1912,Sunderland,Sheffield Wednesday,0-2,0,2,1,1,2,-2,A
1912-12-26,1912,Tottenham Hotspur,Manchester City,4-0,4,0,1,1,4,4,H
1912-12-26,1912,West Bromwich Albion,Derby County,0-0,0,0,1,1,0,0,D
1912-12-28,1912,Arsenal,Liverpool,1-1,1,1,1,1,2,0,D
1912-12-28,1912,Blackburn Rovers,Derby County,0-1,0,1,1,1,1,-1,A
1912-12-28,1912,Bradford City,Aston Villa,1-1,1,1,1,1,2,0,D
1912-12-28,1912,Chelsea,Bolton Wanderers,2-3,2,3,1,1,5,-1,A
1912-12-28,1912,Everton,Middlesbrough,1-0,1,0,1,1,1,1,H
1912-12-28,1912,Manchester City,Manchester United,0-2,0,2,1,1,2,-2,A
1912-12-28,1912,Oldham Athletic,Sheffield United,2-0,2,0,1,1,2,2,H
1912-12-28,1912,Sheffield Wednesday,Tottenham Hotspur,2-1,2,1,1,1,3,1,H
1912-12-28,1912,Sunderland,Newcastle United,2-0,2,0,1,1,2,2,H
1912-12-28,1912,West Bromwich Albion,Notts County,2-0,2,0,1,1,2,2,H
1912-12-30,1912,Sheffield United,Newcastle United,1-1,1,1,1,1,2,0,D
1913-01-01,1912,Bolton Wanderers,Sheffield United,4-2,4,2,1,1,6,2,H
1913-01-01,1912,Everton,Tottenham Hotspur,1-2,1,2,1,1,3,-1,A
1913-01-01,1912,Manchester United,Bradford City,2-0,2,0,1,1,2,2,H
1913-01-01,1912,Middlesbrough,West Bromwich Albion,3-1,3,1,1,1,4,2,H
1913-01-01,1912,Newcastle United,Liverpool,0-0,0,0,1,1,0,0,D
1913-01-01,1912,Oldham Athletic,Blackburn Rovers,0-0,0,0,1,1,0,0,D
1913-01-01,1912,Sheffield Wednesday,Derby County,3-3,3,3,1,1,6,0,D
1913-01-01,1912,Sunderland,Arsenal,4-1,4,1,1,1,5,3,H
1913-01-02,1912,Manchester City,Notts County,4-0,4,0,1,1,4,4,H
1913-01-04,1912,Aston Villa,Manchester City,2-0,2,0,1,1,2,2,H
1913-01-04,1912,Bolton Wanderers,Arsenal,5-1,5,1,1,1,6,4,H
1913-01-04,1912,Liverpool,Bradford City,2-1,2,1,1,1,3,1,H
1913-01-04,1912,Manchester United,West Bromwich Albion,1-1,1,1,1,1,2,0,D
1913-01-04,1912,Middlesbrough,Sheffield Wednesday,0-2,0,2,1,1,2,-2,A
1913-01-04,1912,Newcastle United,Oldham Athletic,4-1,4,1,1,1,5,3,H
1913-01-04,1912,Notts County,Everton,0-1,0,1,1,1,1,-1,A
1913-01-04,1912,Sheffield United,Chelsea,3-3,3,3,1,1,6,0,D
1913-01-04,1912,Tottenham Hotspur,Blackburn Rovers,0-1,0,1,1,1,1,-1,A
1913-01-18,1912,Arsenal,Sheffield United,1-3,1,3,1,1,4,-2,A
1913-01-18,1912,Bradford City,Bolton Wanderers,4-1,4,1,1,1,5,3,H
1913-01-18,1912,Chelsea,Newcastle United,1-0,1,0,1,1,1,1,H
1913-01-18,1912,Derby County,Tottenham Hotspur,5-0,5,0,1,1,5,5,H
1913-01-18,1912,Everton,Manchester United,4-1,4,1,1,1,5,3,H
1913-01-18,1912,Manchester City,Liverpool,4-1,4,1,1,1,5,3,H
1913-01-18,1912,Sheffield Wednesday,Notts County,3-1,3,1,1,1,4,2,H
1913-01-18,1912,Sunderland,Oldham Athletic,1-1,1,1,1,1,2,0,D
1913-01-18,1912,West Bromwich Albion,Aston Villa,2-2,2,2,1,1,4,0,D
1913-01-25,1912,Aston Villa,Everton,1-1,1,1,1,1,2,0,D
1913-01-25,1912,Bolton Wanderers,Manchester City,2-2,2,2,1,1,4,0,D
1913-01-25,1912,Liverpool,West Bromwich Albion,2-1,2,1,1,1,3,1,H
1913-01-25,1912,Manchester United,Sheffield Wednesday,2-0,2,0,1,1,2,2,H
1913-01-25,1912,Middlesbrough,Derby County,4-1,4,1,1,1,5,3,H
1913-01-25,1912,Newcastle United,Arsenal,3-1,3,1,1,1,4,2,H
1913-01-25,1912,Notts County,Blackburn Rovers,3-1,3,1,1,1,4,2,H
1913-01-25,1912,Oldham Athletic,Chelsea,3-2,3,2,1,1,5,1,H
1913-01-25,1912,Sheffield United,Bradford City,3-2,3,2,1,1,5,1,H
1913-01-25,1912,Tottenham Hotspur,Sunderland,1-2,1,2,1,1,3,-1,A
1913-02-04,1912,Bradford City,Middlesbrough,1-2,1,2,1,1,3,-1,A
1913-02-08,1912,Arsenal,Oldham Athletic,0-0,0,0,1,1,0,0,D
1913-02-08,1912,Blackburn Rovers,Manchester United,0-0,0,0,1,1,0,0,D
1913-02-08,1912,Bradford City,Newcastle United,2-0,2,0,1,1,2,2,H
1913-02-08,1912,Derby County,Notts County,1-0,1,0,1,1,1,1,H
1913-02-08,1912,Everton,Liverpool,0-2,0,2,1,1,2,-2,A
1913-02-08,1912,Manchester City,Sheffield United,3-0,3,0,1,1,3,3,H
1913-02-08,1912,Sheffield Wednesday,Aston Villa,1-1,1,1,1,1,2,0,D
1913-02-08,1912,Sunderland,Chelsea,4-0,4,0,1,1,4,4,H
1913-02-08,1912,Tottenham Hotspur,Middlesbrough,5-3,5,3,1,1,8,2,H
1913-02-08,1912,West Bromwich Albion,Bolton Wanderers,2-2,2,2,1,1,4,0,D
1913-02-10,1912,Blackburn Rovers,Middlesbrough,5-2,5,2,1,1,7,3,H
1913-02-10,1912,Oldham Athletic,Liverpool,3-1,3,1,1,1,4,2,H
1913-02-15,1912,Aston Villa,Blackburn Rovers,1-1,1,1,1,1,2,0,D
1913-02-15,1912,Bolton Wanderers,Everton,0-0,0,0,1,1,0,0,D
1913-02-15,1912,Chelsea,Arsenal,1-1,1,1,1,1,2,0,D
1913-02-15,1912,Liverpool,Sheffield Wednesday,2-1,2,1,1,1,3,1,H
1913-02-15,1912,Manchester United,Derby County,4-0,4,0,1,1,4,4,H
1913-02-15,1912,Middlesbrough,Sunderland,0-2,0,2,1,1,2,-2,A
1913-02-15,1912,Newcastle United,Manchester City,0-1,0,1,1,1,1,-1,A
1913-02-15,1912,Notts County,Tottenham Hotspur,0-1,0,1,1,1,1,-1,A
1913-02-15,1912,Oldham Athletic,Bradford City,0-0,0,0,1,1,0,0,D
1913-02-15,1912,Sheffield United,West Bromwich Albion,1-0,1,0,1,1,1,1,H
1913-02-22,1912,Bradford City,Chelsea,2-2,2,2,1,1,4,0,D
1913-02-22,1912,Tottenham Hotspur,Sheffield United,1-0,1,0,1,1,1,1,H
1913-02-24,1912,Sheffield Wednesday,Bolton Wanderers,2-2,2,2,1,1,4,0,D
1913-02-26,1912,Derby County,Sunderland,0-3,0,3,1,1,3,-3,A
1913-03-01,1912,Arsenal,Bradford City,1-1,1,1,1,1,2,0,D
1913-03-01,1912,Aston Villa,Tottenham Hotspur,1-0,1,0,1,1,1,1,H
1913-03-01,1912,Bolton Wanderers,Blackburn Rovers,1-1,1,1,1,1,2,0,D
1913-03-01,1912,Chelsea,Manchester City,2-1,2,1,1,1,3,1,H
1913-03-01,1912,Liverpool,Derby County,2-1,2,1,1,1,3,1,H
1913-03-01,1912,Manchester United,Middlesbrough,2-3,2,3,1,1,5,-1,A
1913-03-01,1912,Newcastle United,Everton,2-0,2,0,1,1,2,2,H
1913-03-01,1912,Notts County,Sunderland,2-1,2,1,1,1,3,1,H
1913-03-01,1912,Oldham Athletic,West Bromwich Albion,0-0,0,0,1,1,0,0,D
1913-03-01,1912,Sheffield United,Sheffield Wednesday,0-2,0,2,1,1,2,-2,A
1913-03-08,1912,Derby County,Bolton Wanderers,3-3,3,3,1,1,6,0,D
1913-03-08,1912,Manchester City,Arsenal,0-1,0,1,1,1,1,-1,A
1913-03-08,1912,Notts County,Manchester United,1-2,1,2,1,1,3,-1,A
1913-03-08,1912,Tottenham Hotspur,Liverpool,1-0,1,0,1,1,1,1,H
1913-03-08,1912,West Bromwich Albion,Chelsea,0-1,0,1,1,1,1,-1,A
1913-03-10,1912,Blackburn Rovers,Liverpool,5-1,5,1,1,1,6,4,H
1913-03-12,1912,Derby County,Aston Villa,0-1,0,1,1,1,1,-1,A
1913-03-12,1912,Everton,Sheffield United,0-1,0,1,1,1,1,-1,A
1913-03-12,1912,Manchester City,Oldham Athletic,2-0,2,0,1,1,2,2,H
1913-03-15,1912,Arsenal,West Bromwich Albion,1-0,1,0,1,1,1,1,H
1913-03-15,1912,Aston Villa,Notts County,1-0,1,0,1,1,1,1,H
1913-03-15,1912,Bolton Wanderers,Tottenham Hotspur,2-0,2,0,1,1,2,2,H
1913-03-15,1912,Bradford City,Manchester City,2-1,2,1,1,1,3,1,H
1913-03-15,1912,Chelsea,Everton,1-3,1,3,1,1,4,-2,A
1913-03-15,1912,Liverpool,Middlesbrough,4-2,4,2,1,1,6,2,H
1913-03-15,1912,Manchester United,Sunderland,1-3,1,3,1,1,4,-2,A
1913-03-15,1912,Newcastle United,Blackburn Rovers,0-1,0,1,1,1,1,-1,A
1913-03-15,1912,Oldham Athletic,Sheffield Wednesday,2-0,2,0,1,1,2,2,H
1913-03-15,1912,Sheffield United,Derby County,4-1,4,1,1,1,5,3,H
1913-03-21,1912,Blackburn Rovers,Sheffield Wednesday,0-1,0,1,1,1,1,-1,A
1913-03-21,1912,Bolton Wanderers,Oldham Athletic,3-0,3,0,1,1,3,3,H
1913-03-21,1912,Bradford City,Notts County,1-0,1,0,1,1,1,1,H
1913-03-21,1912,Chelsea,Aston Villa,1-2,1,2,1,1,3,-1,A
1913-03-21,1912,Everton,Derby County,2-2,2,2,1,1,4,0,D
1913-03-21,1912,Manchester United,Arsenal,2-0,2,0,1,1,2,2,H
1913-03-21,1912,Middlesbrough,Manchester City,0-0,0,0,1,1,0,0,D
1913-03-21,1912,Sunderland,Sheffield United,1-0,1,0,1,1,1,1,H
1913-03-21,1912,Tottenham Hotspur,West Bromwich Albion,3-1,3,1,1,1,4,2,H
1913-03-22,1912,Blackburn Rovers,Oldham Athletic,7-1,7,1,1,1,8,6,H
1913-03-22,1912,Derby County,Newcastle United,2-1,2,1,1,1,3,1,H
1913-03-22,1912,Everton,Arsenal,3-0,3,0,1,1,3,3,H
1913-03-22,1912,Manchester United,Aston Villa,4-0,4,0,1,1,4,4,H
1913-03-22,1912,Middlesbrough,Bolton Wanderers,4-0,4,0,1,1,4,4,H
1913-03-22,1912,Notts County,Liverpool,3-0,3,0,1,1,3,3,H
1913-03-22,1912,Sheffield Wednesday,Chelsea,3-2,3,2,1,1,5,1,H
1913-03-22,1912,Sunderland,Manchester City,1-0,1,0,1,1,1,1,H
1913-03-22,1912,West Bromwich Albion,Bradford City,1-1,1,1,1,1,2,0,D
1913-03-24,1912,Aston Villa,Arsenal,4-1,4,1,1,1,5,3,H
1913-03-24,1912,Derby County,Sheffield Wednesday,1-4,1,4,1,1,5,-3,A
1913-03-24,1912,Liverpool,Chelsea,1-2,1,2,1,1,3,-1,A
1913-03-24,1912,Manchester City,Middlesbrough,3-0,3,0,1,1,3,3,H
1913-03-24,1912,Notts County,Bradford City,1-1,1,1,1,1,2,0,D
1913-03-24,1912,Sheffield United,Sunderland,1-3,1,3,1,1,4,-2,A
1913-03-24,1912,West Bromwich Albion,Tottenham Hotspur,4-1,4,1,1,1,5,3,H
1913-03-25,1912,Bradford City,Manchester United,1-0,1,0,1,1,1,1,H
1913-03-25,1912,Oldham Athletic,Bolton Wanderers,2-3,2,3,1,1,5,-1,A
1913-03-29,1912,Arsenal,Sheffield Wednesday,2-5,2,5,1,1,7,-3,A
1913-03-29,1912,Bolton Wanderers,Notts County,0-0,0,0,1,1,0,0,D
1913-03-29,1912,Bradford City,Everton,4-1,4,1,1,1,5,3,H
1913-03-29,1912,Chelsea,Blackburn Rovers,1-6,1,6,1,1,7,-5,A
1913-03-29,1912,Liverpool,Manchester United,0-2,0,2,1,1,2,-2,A
1913-03-29,1912,Manchester City,West Bromwich Albion,2-1,2,1,1,1,3,1,H
1913-03-29,1912,Newcastle United,Tottenham Hotspur,3-0,3,0,1,1,3,3,H
1913-03-31,1912,Sheffield United,Middlesbrough,1-0,1,0,1,1,1,1,H
1913-03-31,1912,Tottenham Hotspur,Manchester United,1-1,1,1,1,1,2,0,D
1913-04-02,1912,Everton,Oldham Athletic,2-3,2,3,1,1,5,-1,A
1913-04-02,1912,Middlesbrough,Notts County,1-1,1,1,1,1,2,0,D
1913-04-05,1912,Aston Villa,Liverpool,1-3,1,3,1,1,4,-2,A
1913-04-05,1912,Blackburn Rovers,Arsenal,1-1,1,1,1,1,2,0,D
1913-04-05,1912,Derby County,Chelsea,3-1,3,1,1,1,4,2,H
1913-04-05,1912,Everton,Manchester City,0-0,0,0,1,1,0,0,D
1913-04-05,1912,Manchester United,Bolton Wanderers,2-1,2,1,1,1,3,1,H
1913-04-05,1912,Middlesbrough,Newcastle United,0-0,0,0,1,1,0,0,D
1913-04-05,1912,Notts County,Sheffield United,0-1,0,1,1,1,1,-1,A
1913-04-05,1912,Sheffield Wednesday,Bradford City,6-0,6,0,1,1,6,6,H
1913-04-05,1912,Sunderland,West Bromwich Albion,3-1,3,1,1,1,4,2,H
1913-04-05,1912,Tottenham Hotspur,Oldham Athletic,1-0,1,0,1,1,1,1,H
1913-04-07,1912,Blackburn Rovers,Sheffield United,3-1,3,1,1,1,4,2,H
1913-04-09,1912,Middlesbrough,Aston Villa,1-1,1,1,1,1,2,0,D
1913-04-09,1912,Sunderland,Everton,3-1,3,1,1,1,4,2,H
1913-04-09,1912,West Bromwich Albion,Newcastle United,1-0,1,0,1,1,1,1,H
1913-04-12,1912,Arsenal,Derby County,1-2,1,2,1,1,3,-1,A
1913-04-12,1912,Bolton Wanderers,Aston Villa,2-3,2,3,1,1,5,-1,A
1913-04-12,1912,Bradford City,Blackburn Rovers,0-2,0,2,1,1,2,-2,A
1913-04-12,1912,Chelsea,Tottenham Hotspur,1-0,1,0,1,1,1,1,H
1913-04-12,1912,Liverpool,Sunderland,2-5,2,5,1,1,7,-3,A
1913-04-12,1912,Manchester City,Sheffield Wednesday,2-2,2,2,1,1,4,0,D
1913-04-12,1912,Newcastle United,Notts County,0-0,0,0,1,1,0,0,D
1913-04-12,1912,Oldham Athletic,Middlesbrough,1-0,1,0,1,1,1,1,H
1913-04-12,1912,Sheffield United,Manchester United,2-1,2,1,1,1,3,1,H
1913-04-12,1912,West Bromwich Albion,Everton,0-0,0,0,1,1,0,0,D
1913-04-14,1912,Sheffield Wednesday,Newcastle United,1-2,1,2,1,1,3,-1,A
1913-04-15,1912,Oldham Athletic,Derby County,2-2,2,2,1,1,4,0,D
1913-04-19,1912,Blackburn Rovers,Manchester City,2-2,2,2,1,1,4,0,D
1913-04-19,1912,Derby County,Bradford City,4-0,4,0,1,1,4,4,H
1913-04-19,1912,Liverpool,Bolton Wanderers,5-0,5,0,1,1,5,5,H
1913-04-19,1912,Manchester United,Newcastle United,3-0,3,0,1,1,3,3,H
1913-04-19,1912,Middlesbrough,Chelsea,0-3,0,3,1,1,3,-3,A
1913-04-19,1912,Notts County,Oldham Athletic,2-1,2,1,1,1,3,1,H
1913-04-19,1912,Sheffield Wednesday,West Bromwich Albion,3-2,3,2,1,1,5,1,H
1913-04-19,1912,Tottenham Hotspur,Arsenal,1-1,1,1,1,1,2,0,D
1913-04-23,1912,Aston Villa,Sunderland,1-1,1,1,1,1,2,0,D
1913-04-26,1912,Arsenal,Middlesbrough,1-1,1,1,1,1,2,0,D
1913-04-26,1912,Bolton Wanderers,Sunderland,1-3,1,3,1,1,4,-2,A
1913-04-26,1912,Bradford City,Tottenham Hotspur,3-1,3,1,1,1,4,2,H
1913-04-26,1912,Chelsea,Notts County,5-2,5,2,1,1,7,3,H
1913-04-26,1912,Everton,Sheffield Wednesday,3-1,3,1,1,1,4,2,H
1913-04-26,1912,Manchester City,Derby County,1-1,1,1,1,1,2,0,D
1913-04-26,1912,Newcastle United,Aston Villa,2-3,2,3,1,1,5,-1,A
1913-04-26,1912,Oldham Athletic,Manchester United,0-0,0,0,1,1,0,0,D
1913-04-26,1912,West Bromwich Albion,Blackburn Rovers,1-1,1,1,1,1,2,0,D
1913-04-28,1912,Aston Villa,Sheffield United,4-2,4,2,1,1,6,2,H
1913-04-30,1912,Sunderland,Bradford City,1-0,1,0,1,1,1,1,H